布雷金里奇 | 布雷肯里奇 | breckinridge
塞德 | 切德 | cedd
梅莉 | 马利 | maly
阿西尼埃 | 阿西涅加 | arciniega
西恩 | 西根 | seaghan
斯特拉瑟恩 | 斯特拉森 | strathearn
皮内 | 皮奈 | pinay
梅雷斯曼 | 米尔斯曼 | meresman
伊兹比吉 | 伊兹比茨基 | izbicky
埃凯韦斯特 | 埃沙韦斯特 | echaveste
费尔伯恩 | 费尔贝恩 | fairbairn
舒普 | 肖普 | shoupp
普安 | 普汉 | puhan
沃塞尔 | 瓦塞尔 | wassell
西金特 | 萨金特 | seargent
亨巴克 | 亨巴赫 | heimbach
基布勒 | 库布勒 | kuebler
纳尔迪 | 纳迪 | nardi
杰米马 | 杰迈玛 | jemima
莫杜埃特 | 莫德维 | mauduit
惠塔克 | 惠特克 | whitacre
伊埃特 | 艾厄特 | eyet
博比 | 鲍比 | bobbie
麦基尔维纳 | 麦基尔温纳 | macilvenna
莱因斯 | 赖恩斯 | rines
麦克费伦 | 麦克弗伦 | mcpherren
埃德尔霍赫 | 埃德尔霍克 | edelhoch
博策尔 | 博索尔 | botsal
科尔莱 | 科尔雷因 | coleraine
韦格尼 | 韦恩 | wagne
多德特曼 | 多伊特曼 | deutermann
埃德曼 | 厄尔德曼 | erdman
戈伦比夫斯基 | 戈伦别夫斯基 | golembiewski
雷丝塔 | 雷斯塔 | resta
格雷戈伊 | 格雷瓜尔 | gregoire
米卡亚 | 迈凯亚 | micajah
佐格 | 索格 | sorg
莱德洛 | 莱德劳 | laidlaw
科姆萨罗夫 | 科梅萨罗夫 | komesaroff
雷马克斯 | 拉马克斯 | raemakers
皮凯弗 | 皮卡弗 | piccaver
苏布林 | 萨布林 | subrin
斯克拉顿 | 斯克鲁顿 | scrutton
桑德勒 | 坦德勒 | tandler
费尔本 | 费尔伯恩 | fairburn
津嫩 | 津宁 | zinnen
费登 | 法登 | faden
布加兹 | 布尔盖兹 | bourgaize
科尔纳基 | 科尔纳吉 | colnaghi
佩利特 | 佩尔蒂埃 | pelletier
帕塞尔 | 帕斯尔 | parcel
霍诺里 | 霍诺丽 | honori
艾梅希 | 伊梅施 | imesch
埃尔顿内德 | 埃尔顿黑德 | eltonhead
西明顿 | 赛明顿 | symington
布龙海姆 | 布朗海姆 | bronheim
马豪 | 玛奥 | mahault
法克 | 菲克 | fike
奥达斯 | 奥杜斯 | audus
韦克特尔 | 瓦赫特尔 | wachtel
塔利亚罗罗 | 塔利亚费罗 | tagliaferro
马基恩 | 马基嫩 | makinen
拉切斯 | 拉雪兹 | lachaise
麦科瑙希 | 麦康瑙希 | mcconaughy
格肯斯 | 格尔肯斯 | gehrkens
达维格多 | 达维多尔 | d'avigdor
哈巴德 | 哈伯德 | hubbard
曼纳韦 | 马纳韦 | mannaway
梅恩 | 米恩 | meighen
维迪斯科 | 弗迪斯科 | verdisco
特贝因 | 特贝恩 | turbayne
伊索德 | 伊佐德 | izod
图穆马 | 托伊马 | teuma
奥夫 | 奥 | ough
斯帕阿尔 | 斯帕尔 | spahr
吉杰 | 吉格 | gieger
阿富特 | 阿富尔蒂特 | affourtit
米泽尔 | 米赛尔 | misael
赫默里希 | 亨默里克 | hemmerich
黑伍德 | 希伍德 | heawood
詹宁斯 | 杰宁斯 | jenyns
斯塔姆斯 | 斯泰姆斯 | stames
塔伦斯 | 塔兰斯 | tarrance
谢诺韦思 | 切诺韦思 | chenoweth
安瓦里尔 | 安瓦里普尔 | anvaripour
比布 | 毕比 | beebe
考尔德尔 | 考德尔 | caldell
博查特 | 博哈特 | borchardt
卡明 | 卡迈恩 | carmine
巴特伦 | 巴特拉姆 | bartram
派尔 | 皮尔 | peile
麦康 | 麦肯 | mccon
麦卡里 | 麦凯里 | mccarey
布罗克 | 布勒克 | broecker
凯利奥 | 卡利奥 | calio
英芬特 | 因方特 | infant
卡赫 | 卡尔 | karrh
杰罗尔 | 杰拉尔 | gerall
亨内肯斯 | 亨尼肯斯 | hennekens
贾弗 | 贾埃弗 | giaever
贾米 | 杰米 | jamie
鲍尔霍恩 | 巴尔霍恩 | ballhorn
斯廷菲尔德 | 斯廷奇菲尔德 | stinchfield
斯特吉斯 | 斯特奇斯 | sturges
莫克萨姆 | 莫克塞姆 | moxam
阿什敦 | 阿什当 | ashdown
卡姆 | 卡尔姆 | culme
比克姆 | 比卡姆 | bickham
夏尔曼 | 沙伊尔曼 | shireman
梅索利 | 梅索伊 | meszoly
福伊希特豪 | 福伊希特万格 | feuchtwanger
格格拉德 | 古格拉德 | ghugrad
埃森斯 | 埃森丝 | essence
格思梅 | 格瓦思米 | gwathmey
巴比罗利 | 巴尔比罗利 | barbirolli
利布 | 利比 | luebbe
阿什林 | 阿什琳 | ashlyn
奥迪恩 | 奥迪翁 | audion
施蒂宁 | 斯蒂宁 | stiening
克莱农 | 克勒农 | clernon
金德雷德 | 金德里德 | kindred
纽索尔 | 纳托尔 | nuthall
戴 | 戴伊 | daigh
埃坦 | 埃泰恩 | etain
德尔蒂戈 | 德尔列戈 | delriego
巴策 | 巴策尔 | batzer
廷肯 | 廷康 | tinkon
德弗雷茨 | 迪弗雷特斯 | defrates
阿文厄姆 | 阿尔文厄姆 | alvingham
昂德哈尔 | 昂德达尔 | underdahl
达劳 | 达罗 | darraugh
罗巴逊 | 罗巴森 | robathan
迪多 | 德多 | dedow
米恩斯 | 默恩斯 | mearns
蒂利 | 泰利 | tiley
格罗布 | 格罗比 | grobe
塔塔利诺 | 塔尔塔利诺 | tartaglino
兰布 | 拉姆 | lambe
卡德韦尔 | 考德威尔 | caldwell
泽米娜 | 泽米纳 | zemina
坎特伯里 | 坎特伯雷 | canterbury
斯蒂克 | 斯特克 | stirk
塔肯 | 泰肯 | tacon
基尔施 | 基尔希 | kirsch
古特穆特 | 古特穆思 | gutermuth
托皮 | 托毕 | torpey
洛多维克 | 洛多威克 | lodowicke
泰奇曼 | 泰克曼 | teichmann
普鲁杜姆 | 普鲁多姆 | prudhomme
基斯纳纳西 | 基斯特纳萨米 | kistnasamy
坎比 | 坎贝 | cumbey
赫姆尔 | 赫姆利 | hermle
蒙冈 | 蒙贡 | mongon
泰蒂尔 | 泰特尔 | tytell
马歇尔 | 马塞尔 | mussehl
亨佩尔 | 亨普尔 | hempel
艾罗 | 艾罗尔特 | ayrault
赖蒂娜 | 赖蒂纳 | rytina
里亚 | 雷 | rea
布赖登索尔 | 布赖登塔尔 | breidenthal
罗林格 | 罗林杰 | rollinger
德卢吉 | 德路易吉 | deluigi
科奇雷斯 | 科克里斯 | cocheres
鲁拉德 | 鲁阿兹 | ruadh
格里瑟德 | 格雷特黑德 | greathead
巴斯基特 | 巴斯克特 | baskette
埃塞莉达 | 埃塞丽达 | ethelreda
巴伦斯 | 巴兰斯 | barans
迪安娜 | 迪恩纳 | dienna
博里尔 | 博雷尔 | boreel
布雷恩 | 布里恩 | brehon
吉尔 | 圭尔 | guire
厄彻克 | 尤尔丘克 | yurchuck
坦尼肯 | 滕尼肯 | tennican
科佩斯蒂克 | 科普斯蒂克 | copestick
加勒特 | 加雷特 | garrette
利文 | 莱文 | levene
克拉特 | 克鲁特 | krutter
克拉里斯 | 克拉雷斯 | clares
朱林科 | 祖林科 | dzurinko
林利斯戈 | 林利思戈 | linlithgow
索茹纳 | 索杰纳 | sojourner
纳贝尔 | 努贝尔 | knubel
卡诺肯 | 卡诺坎 | carnochan
罗克辛 | 罗克西娜 | roxinne
伊登斯 | 埃登斯 | edens
比哈里尔 | 贝哈里尔 | beharriell
朗查普 | 朗香 | longchamp
贝德纳斯基 | 贝德纳尔斯基 | bednarski
舒尔金德 | 舒尔坎德 | schulkind
佩奇 | 佩什 | peche
威尔怀特 | 威尔海特 | willhite
洛伦兹 | 洛伦茨 | lorenz
特波尔 | 蒂普尔 | tepoel
贾莫 | 贾伊莫 | giaimo
库尔吉安 | 库尔金 | kuljian
哈米利恩 | 哈米里恩 | hamilyon
利恩 | 利安娜 | leanne
格拉伯 | 格雷伯 | graber
基尔恰西 | 基尔科西 | kilcoursie
特伯特 | 特贝特 | turbett
里索诺沃 | 里曾诺弗 | reasonover
雷布萨门 | 里布萨门 | rebsamen
霍尼戈尔德 | 霍尼奥尔德 | hornyold
托菲琴 | 托菲肯 | torphichen
布利肯斯弗纳 | 布利肯斯德弗 | blickensderfer
哈鲁普 | 哈勒普 | harrup
瓦斯塔夫 | 瓦格斯塔夫 | wagstaffe
戈萨尔斯 | 戈瑟尔斯 | goethals
海特姆 | 哈特姆 | hatem
古尔蒂里 | 瓜尔蒂耶里 | gualtieri
泽兰 | 齐伦 | zeran
比贝尔 | 比布尔 | biebel
奥尔兹泰尔 | 奥尔德斯泰尔 | oldstyle
西门斯 | 西门子 | siemens
普莱本 | 普利邦 | plybon
帕伊夫 | 帕耶夫 | payeff
斯温斯鲁德 | 斯温斯拉德 | swensrud
恩格尔姆 | 恩格霍姆 | engholm
赛登纳姆 | 西德纳姆 | sydenham
惠特洛 | 怀特洛 | whytlaw
杜亚斯 | 德瓦斯 | dewas
兰内伯格 | 兰恩伯格 | ranneberger
桑德威克 | 桑威克 | sandwick
威思 | 韦思 | wyeth
施魏菲尔德 | 施韦柴尔德 | schweichild
斯坦霍普 | 斯坦诺普 | stanhope
英沃尔德塔德 | 英沃斯塔德 | ingvoldstad
森霍 | 桑戈尔 | senghor
布赖格豪斯 | 布里格豪斯 | brighouse
克伦霍尔 | 克伦巴尔 | krumbhaar
莫拉尔 | 莫勒 | morar
格莱纳策 | 格莱纳瑟 | glenarthur
弗里利 | 弗赖利 | friley
赖兰斯 | 赖伦斯 | rylance
吉尔斯利弗 | 吉尔德斯利夫 | gildersleeve
赫斯勒普 | 赫斯利普 | heslep
鲍托尔 | 鲍塔尔 | boutall
哈勒尔 | 哈拉尔 | harral
达梅舍克 | 达梅谢克 | dameshek
马谢特 | 马希特 | mushet
布鲁姆利 | 布伦利 | brumley
海耶 | 海尔 | hyer
比尔特 | 伯特 | birt
菲金杰 | 菲金格 | fickinger
明 | 米恩 | min
菲格雷斯 | 菲格斯 | figures
埃格 | 埃加 | eggar
特库姆什 | 特库姆塞 | tecumseh
伊万贾斯塔 | 埃万杰利斯塔 | evangelista
韦布利 | 韦伯利 | webley
帕门蒂尔 | 帕尔芒捷 | parmentier
迪杰利斯 | 迪安杰利斯 | deangelis
格里诺尔特 | 格里纳沃尔特 | greenawalt
麦格拉斯里奇 | 麦格拉斯里克 | macglasrich
索恩顿 | 桑顿 | thornton
芭布 | 巴布 | baab
巴洛克 | 巴洛赫 | balloch
切斯基 | 切尔涅斯基 | chernesky
贝列夫 | 贝尔维 | bellevue
里塞伯格 | 赖斯伯格 | riseberg
布劳恩 | 布朗 | braun
赫里恰尼克 | 赫雷查尼克 | hrechanyk
特里利文 | 特里莱文 | treleaven
阿文特 | 埃文特 | avent
比斯内尔 | 比尤内尔 | buesnel
阿迪 | 埃迪 | adye
安曾拉 | 安泽拉 | annzella
哈格迈耶 | 哈格迈尔 | hagemeyer
凯蒂亚 | 凯蒂娅 | katia
西米恩 | 西明 | siemien
罗恩 | 罗安德 | rowand
普里亚尔 | 普赖尔 | prial
布利萨克 | 布利萨茨 | blisac
马尼斯 | 马内斯 | maness
阿鲍德 | 阿布德 | abboud
比德斯 | 比德兹 | bidez
厄威尔 | 厄维尔 | irwil
威尔米特 | 薇尔梅特 | wilmett
尼迪 | 内迪 | neddy
纳伦乔 | 纳兰霍 | naranjo
布雷兰 | 布里兰 | breland
阿马纳西 | 阿马纳齐 | armanazi
麦卡特 | 麦卡泰尔 | macartair
卡尔 | 卡利 | karle
斯特尔特 | 斯泰尔特 | stelter
米韦尔 | 米恩韦尔 | meanwell
舒克伯格 | 沙克伯勒 | shuckburgh
特雷费西斯 | 特里富西斯 | trefusis
亚历克森森 | 亚历山德森 | alexanderson
科克伦 | 科克兰 | cockran
格尔 | 瓜尔 | guare
朱皮特 | 丘辟特 | jupiter
多格里希 | 多伊特里希 | deutrich
陶厄里 | 托尔里 | towery
威舍 | 维舍 | wischer
卡基尔 | 卡利尔 | kalil
弗劳 | 弗劳德 | furlaud
戴加 | 迪格 | dygard
巴利希 | 巴利奇 | balich
库比特 | 丘比特 | cubitt
福尔迪西 | 福尔德西 | foldessy
西克雷斯特 | 西克里斯特 | secrest
拉扎 | 拉扎尔 | lazar
佩茨 | 皮特斯 | petes
皮克斯 | 皮尔克斯 | pearkes
费尔哈文 | 费尔黑文 | fairhaven
扎洛夫 | 扎斯洛夫 | zaslove
索恩伯格 | 索恩伯勒 | thornburgh
特雷德加 | 特里迪加 | tredegar
阿蒂盖尔 | 阿蒂格尔 | attygalle
马西娅 | 玛西娅 | mathea
费布勒 | 法布勒 | fabler
彼得拉斯卡 | 彼特鲁斯卡 | petruska
弗恩 | 维恩 | verne
尤迪切洛 | 尤迪塞洛 | iudicello
布兰德福 | 布兰福德 | blandford
韦姆 | 瓦伊姆 | waim
鲁兰 | 鲁伦 | ruellan
拉赫特 | 拉克特 | lachter
拉哈布 | 雷哈布 | rahab
麦金纳尼 | 麦基纳尼 | macinerney
埃根 | 伊根 | egan
斯蒂格勒 | 施蒂格勒 | stigler
特威宁 | 特文宁 | twining
乌尔夫 | 厄尔夫 | ulph
西达罗斯 | 西达劳斯 | sidarouss
弗洛厄迪尤 | 弗劳尔迪 | flowerdew
盖兰 | 格兰 | gellan
吉梅内斯 | 希门尼斯 | jimenez
普勒 | 普拉 | pullar
韦尔纳 | 沃尔纳 | woellner
杜伊特 | 德温特 | dewint
布拉德劳夫 | 布拉德洛 | bradlaugh
尼斯克伦 | 尼斯肯 | kniskern
布鲁因 | 布勒因 | bruyn
塔米赫尔 | 塔米希尔 | tamihere
库劳 | 库罗 | courau
贝尼迪克斯 | 贝内迪克斯 | benedicus
拉弗莱奇 | 拉弗莱什 | lafleche
柯蒂尼厄斯 | 柯特纽斯 | curtenius
柯索伊斯 | 柯托伊斯 | curthoys
阿斯凯思 | 阿斯奎思 | asquith
赫利纳 | 赫莉娜 | helina
伊蒂拉格 | 伊泰拉格 | itteilag
阿尔托斯塔 | 阿尔博斯塔 | albosta
斯特朗奇 | 斯特朗 | stronge
戴伦福思 | 迪伦弗思 | dyhrenfurth
坦吉 | 坦圭 | tanguay
杜布拉斯 | 杜布拉 | dubras
亚兹明 | 亚斯明 | yazmin
劳德代尔 | 劳德戴尔 | lauderdale
拉瑟姆 | 拉萨姆 | russum
伯贝奇 | 伯比奇 | burbage
哈斯卢普 | 哈斯勒普 | haslup
科尔尼特 | 科尔内特 | collnette
奇索托利尼 | 奇斯托利尼 | chistolini
波洛斯 | 普洛斯 | poulos
卢万多 | 柳安多 | lewando
麦克沃尼什 | 麦克瓦尼什 | macvarnish
施尼特 | 施奈特 | schneiter
弗里岑 | 弗里曾 | fritzen
特佩瓦 | 特佩卡 | tepaika
麦克米歇尔 | 麦克迈克尔 | mcmichael
布劳科 | 布劳考 | browkaw
比纳吉 | 比纳乔 | binaggio
贝赫 | 贝尔赫 | bailhe
斯科克罗夫特 | 斯考克罗夫特 | scowcroft
麦卡尔 | 麦考尔 | mackal
阿勒门 | 阿利芒 | allemang
赛奇 | 赛什 | saich
皮奥特罗斯基 | 彼得罗夫斯基 | piotrowski
贾恩 | 扬 | jahn
康戈尔顿 | 康高尔顿 | congalton
杜克斯 | 杜阿克斯 | duax
沙滕克 | 沙滕柯克 | schattenkerk
加特纳 | 盖特纳 | gaertner
格里哈特 | 格林赫特 | greenhut
法隆 | 法伦 | falloon
西利森 | 西利格森 | seeligson
克莱本 | 克莱伯恩 | clyburn
奥斯维 | 奥斯威尤 | oswiu
兰德威西 | 兰德沃西 | landwirthy
米隆 | 米伦 | millon
特特尔 | 瑟特尔 | thurtle
艾利 | 艾莉 | eily
埃克恩 | 伊肯 | ekern
菲利恩 | 菲利翁 | filion
舒珊 | 舒尚 | shooshan
莫普斯 | 莫皮斯 | moppes
帕塞尔 | 帕斯尔 | parcell
泰博尔特 | 蒂博尔特 | tybalt
索尔 | 苏尔 | soul
吕尔 | 卢尔 | lure
德多奥 | 戴德奥 | dedeo
泰达 | 西达 | theda
麦克里思 | 麦克勒思 | mackereth
奥瑟 | 奥泽 | orser
帕珀马斯特 | 佩珀马斯特 | papermaster
贝伦德斯 | 贝伦兹 | berendes
埃拉齐姆 | 伊拉齐姆 | erazim
施雷德 | 施拉德 | schrade
奇丝特 | 奇斯特 | chiste
伯克 | 比尔克 | birck
斯潘金 | 斯庞金 | spungin
巴索尔森 | 巴托尔松 | bartholdson
英格林 | 英林 | yingling
库普里尔 | 卡普里尔 | cuprill
波特厄斯 | 波蒂厄斯 | porteus
查努廷 | 查纽廷 | chanutin
埃塞克 | 伊塞克 | esek
马耶霍弗 | 迈尔霍费尔 | maierhofer
安加拉拉 | 安加罗拉 | angarola
德普勒格 | 德普卢格 | derploog
马伦普尔 | 马伦普雷 | malempre
阿勒顿 | 阿里顿 | arreton
贝哈 | 贝亚 | beha
法尔布伦斯 | 法尔布兰斯 | firebrance
富洛姆 | 富勒姆 | fullom
博尔多 | 波尔多 | bordeaux
德西德里厄斯 | 德西迪里厄斯 | desiderius
塔尔戈特 | 索尔戈特 | thalgott
切克齐安 | 彻克齐安 | cherkezian
马尼尔 | 马尼耶 | magnier
奥尔特林克 | 奥特林厄姆 | altrincham
纳普斯特克 | 纳帕斯特克 | naparstek
艾尔纳姆 | 埃努姆 | aernum
麦基尔雷 | 麦基雷维 | macilrevie
艾肯林 | 艾肯格林 | eichengreen
莱夫勒 | 莱弗勒 | leffler
科卡姆 | 科克姆 | corkum
加罗菲斯 | 加劳菲斯 | garaufis
拉文 | 雷文 | raven
黑文纳 | 哈文纳 | havenner
格威哈德斯 | 格威查德斯 | gwychardus
莫布斯比 | 莫布兹比 | mobsby
西加尔 | 西格尔 | seegal
西波兰 | 西波隆 | cipollone
阿库埃 | 阿夸约 | aquayo
赛泽 | 赛斯 | sise
帕尔莫维夫 | 帕尔莫利夫 | palmolive
弗雷林豪森 | 弗里林海森 | frelinghuysen
麦克鲁登 | 麦克拉登 | mccrudden
帕杰利斯 | 帕盖利斯 | pargellis
莱波尔 | 勒普尔 | lepoer
阿尔施塔特 | 阿尔斯塔特 | alstadt
布雷斯瓦夫斯基 | 布雷斯拉夫斯基 | breslawsky
博尼法修斯 | 博尼费修斯 | bonifacius
达夫尼 | 达夫妮 | daphne
麦克莱夫 | 麦克拉夫 | mcclave
范赞特 | 范桑特 | vansandt
麦康基 | 麦康希 | macconchy
桑德姆 | 桑达姆 | sandham
里穆斯基 | 里莫斯基 | rimouski
马宁 | 曼宁 | maning
布拉赫特 | 布拉胡特 | blachut
赫明 | 亨明 | hemming
特文加姆 | 蒂文加杜姆 | tirvengadum
卡尔斯密斯 | 卡尔史密斯 | carlsmith
马米 | 玛米 | mami
杰内罗 | 吉尼罗 | genero
比斯特 | 比伊斯特 | buist
拉拉莫尔 | 拉腊莫尔 | laramore
埃尔特林赫姆 | 埃尔特林厄姆 | eltringham
德里南 | 德赖南 | drynan
福韦尔 | 福尔韦尔 | faulwell
哈基 | 黑克 | hake
哈什根 | 哈舍根 | hashagen
赖尔斯 | 赖亚尔斯 | ryalls
特里梅因 | 特里曼 | tremain
梅伦 | 默龙 | merron
范德克伊德 | 范德克利德 | vanderkleed
安克鲁姆 | 安克拉姆 | ancrum
赫斯伯格 | 亨斯伯格 | hunsberger
贝基 | 巴基 | bakey
鲁埃 | 吕埃 | ruez
拉德布罗克 | 拉德布鲁克 | ladbroke
卢伊斯蒂格 | 卢斯蒂格 | luistig
恩斯莱格 | 奥恩斯莱格 | oenslager
哈加丁 | 哈格丁 | hargadine
利基姆 | 利克希姆 | leikhim
沃奇法特 | 沃特沙夫特 | wirtschafter
艾默斯 | 伊穆斯 | imus
德文特 | 德温特 | dewenter
佩特菲尔德 | 彼得菲尔德 | peterfield
加瓦尔特 | 加沃尔特 | gawalt
哈雷尔 | 哈勒尔 | harrel
斯普勒 | 施普勒 | spuhler
阿马尼 | 阿尔马尼 | armani
弗莱布 | 弗莱比 | flebbe
汤姆斯 | 图姆斯 | tombs
达夫隆 | 杜弗隆 | duflon
塞兹尼克 | 塞兹内克 | seznec
哈纳 | 哈娜 | hana
贝恩 | 本 | benn
莫伊西维奇 | 莫伊塞维奇 | moiseiwitsch
马诺普利 | 马诺波利 | manopoli
梅纳姆 | 梅纳汉 | menaham
多里 | 多丽 | dorrie
法尼夫 | 法纳夫 | faneuf
索隆 | 索伦 | solon
罗赫 | 罗奇 | roch
洛嫩克龙 | 洛温克伦 | lowenkron
多勒 | 多拉夫 | dorough
巴尔尼尔 | 巴尼尔 | balniel
菲林 | 法尔林 | firing
克莱姆 | 克莱米 | klemme
费尔 | 费雷 | ferre
安娜贝尔 | 安娜贝勒 | annabelle
贝伊文 | 博伊文 | boivin
福齐 | 福西 | feusi
江伯格 | 宗伯格 | zumberg
萨加 | 塞格尔 | sagar
恩格兰 | 英格兰 | england
纽伊特 | 纽特 | newt
艾琳妮 | 艾琳 | irene
塔尔曼 | 托尔曼 | tallman
西拉森 | 西劳森 | cilawson
艾德斯莫 | 艾兹莫 | eidsmoe
阿布 | 阿贝 | abbe
博瓦兹坦 | 博伊斯方丹 | boisfontaine
麦卡赫蒂 | 麦克哈蒂 | mccahearty
韦斯特摩兰 | 威斯特摩兰 | westmoreland
伯格哈德 | 伯格哈特 | burghard
伊尔普 | 厄普 | earp
蒙多尔 | 蒙多 | mondor
格尔泽 | 盖尔泽 | gelzer
施赖纳 | 施里纳 | shriner
维尔皮勒 | 韦皮勒 | verpilleux
汤温德 | 汤恩德 | townend
伊内斯 | 伊内兹 | inez
杰彭 | 杰波恩 | jepoen
伯肯霍尔茨 | 伯肯霍尔兹 | birkenholtz
默蒂斯 | 默特斯 | mertes
拉克特 | 勒基特 | luckett
斯珀珀尔 | 斯珀尔 | spurr
伊德 | 伊德尔 | eader
维诺格拉德 | 维诺格勒 | vinograd
安纳莫尔 | 安纳克莫尔 | annaghmore
斯图德曼 | 斯蒂德曼 | studeman
利林 | 勒林 | lelean
布里森 | 布赖森 | bridson
蒂林赫斯特 | 蒂林哈斯特 | tillinghast
马达维克 | 马达维赫 | mhadavikh
戈布拉特 | 戈卢布 | golub
伊尔根里茨 | 伊尔根弗里茨 | ilgenfritz
杜拉克 | 杜拉奇 | dullach
佐尔德 | 索尔德 | szold
杜普卡克 | 杜普恰克 | dupcak
布雷登 | 布拉顿 | bradon
奥西 | 奥齐 | orczy
贝姆 | 巴姆 | bame
莱西 | 利西 | leisy
普利马尔 | 普莱梅尔 | plymale
布罗梅特 | 布罗米特 | bromet
奥雷斯肯 | 奥雷斯坎 | orescan
惠特伯 | 惠特伯勒 | whitburgh
霍莫尔卡 | 霍穆尔卡 | homolka
海斯伯格 | 海斯堡 | heisborg
格尔农 | 热农 | gernon
斯桑特 | 斯坦特 | stunt
埃莉斯 | 埃莉丝 | elyse
伦格利 | 伦利 | lungley
克勒勒 | 克雷勒 | kroehler
谢米宁 | 切米宁特 | cheminint
迪本 | 德本 | deben
法斯纳纳 | 法斯纳克特 | fasnacht
赫尔霍尔特 | 赫尔姆霍尔特 | helmholdt
布根 | 巴根 | bugan
施瓦姆 | 施万布 | schwamb
麦克米克尔 | 麦克迈克尔 | macmichael
奥里 | 奥赖 | ory
艾尔弗里克 | 阿尔弗里克 | aelfric
艾尔加 | 艾尔格 | eylgar
耶 | 伊 | yee
索尼曼 | 索恩曼 | sonnemann
奥赞娜 | 奥赞 | ozanne
德汉 | 德哈恩 | dehaan
雷诺 | 雷纳 | raynor
弗西瓦尔 | 费西瓦尔 | fercival
贝克哈特 | 贝克哈德 | beckhard
松塔格 | 桑塔格 | sontag
麦克尔赫农 | 麦克尔哈农 | mcelhanon
沃尔德雷雷夫 | 沃尔德格雷夫 | waldegrave
塔利奥 | 图利奥 | tullio
麦康 | 梅肯 | macon
德拉丰斯 | 德拉方斯 | delafons
戴维 | 达维 | davee
戈希 | 戈伊 | gohey
克莱弗 | 克拉弗 | claver
桑瑟姆 | 桑森 | sansum
吉吉 | 吉盖 | giggey
多本 | 多宾 | doben
杰穆特 | 格穆思 | germuth
泰恩什 | 坦什 | tainsh
克雷斯皮尼 | 克雷皮尼 | crespigny
哈梅尔辛 | 休梅尔辛 | humelsine
皮杰斯利 | 皮格斯利 | pigsley
马夸里 | 麦夸里 | maquarie
比尔基 | 伯基 | buerki
斯沃迪 | 斯沃德什 | swadesh
巴贝尔 | 贝布尔 | babell
克拉丽达 | 克拉里达 | clarida
博德温恩 | 博德瓦恩 | bordwine
布朗塔斯 | 布龙塔斯 | brountas
梅耶森 | 迈耶森 | mayerson
麦科姆 | 麦库姆 | mccombe
德鲁沃鲁拉 | 德沃尔吉拉 | drevorguilla
奥弗拉蒂蒂 | 奥弗莱厄蒂 | o'flahertie
塞维 | 西维 | sevey
鲍沃 | 鲍尔 | bouwer
博克尔 | 博克 | boker
斯森特 | 森特 | scent
伊肖 | 埃舒 | eshoo
马金克斯 | 马辛克斯 | marcinkus
佩雷兹 | 佩雷斯 | perez
蒂利 | 蒂莉 | tillie
赖格 | 里格 | riger
阿利森 | 艾莉森 | alyson
德雷塞尔 | 德雷斯尔 | dressel
朱利 | 朱莉 | julie
芬格哈特 | 芬格赫特 | fingerhut
丹尼恩 | 达尼恩 | danyon
马休伦 | 马胡兰 | mahuran
波莱恩 | 普兰 | poulain
切 | 切赫 | czeh
西尔瓦纳斯 | 西尔维纳斯 | silvanus
埃克斯坦斯 | 埃克斯滕斯 | exstance
艾恩斯 | 安斯 | aines
普萨特里 | 普萨泰里 | pusateri
尼恩 | 奈恩 | nyhen
霍拉修斯 | 霍雷修斯 | horatius
克利瑟 | 克莱瑟 | cleather
罗巴提斯 | 罗巴茨 | robartes
阿格内洛 | 阿涅洛 | agnello
伊莱 | 艾莱 | ilay
内蒂尤 | 纳休 | nathiew
斯蒂格利茨 | 施蒂格利茨 | stiglitz
塞西利厄斯 | 塞西莉厄斯 | cecilius
温纳科特 | 旺纳科特 | wonnacott
哈姆斯 | 黑姆斯 | hammes
查格尔斯 | 查格利斯 | chagles
肖厄尔 | 肖尔 | schauer
加纳金安 | 加南吉扬 | ganangiyan
泰特 | 廷特 | tynte
古拉德 | 戈拉德 | goulard
迪特斯 | 戴特斯 | deiters
斯利顿 | 斯莱顿 | slighton
布里斯 | 布赖斯 | brise
沙特勒 | 舒特勒 | shutler
怀特利瑟 | 怀特莱瑟 | whiteleather
埃夫勒 | 埃弗勒 | effler
罗亚伊尔 | 罗亚尔 | royale
道纳尔 | 多纳尔 | donal
明顿 | 明特恩 | minturn
瓦斯默 | 沃斯默 | wasmer
勒克龙 | 莱克龙 | leckrone
布雷斯纳安 | 布雷斯纳汉 | bresnahan
波 | 鲍 | pow
拉克索尔 | 拉克斯尔 | wraxhall
莱托克 | 勒托克 | letocq
谢拉 | 希拉 | shelagh
约弗里翁 | 乔夫里翁 | joffrion
伯恩 | 贝尼 | boehne
德沃拉克 | 德沃夏克 | dvorak
贝纳迪兹 | 贝纳维兹 | benavides
梅乔斯 | 梅杰斯 | majors
福伊尔韦克 | 福伊尔沃克 | feuerwerker
塔吉 | 塔姬 | taggy
麦科克 | 麦科奇 | mccoch
蒂姆韦尔 | 泰姆韦尔 | timewell
巴克纳 | 巴赫纳 | bachner
图德霍 | 塔杜 | tudhoe
托莱斯特拉普 | 托尔斯特拉普 | tollestrup
纳蒂蒂 | 克努蒂 | knutti
凯嫩 | 凯南 | kainen
德普图克 | 德普塔克 | deptuck
迪特 | 迪特尔 | dieter
格尔 | 吉尔 | gehl
迪斯特伯格 | 杜斯特伯格 | duesterberg
富尔韦勒 | 富尔怀勒 | fulwyler
唐纳姆 | 多纳姆 | donham
利德福 | 利德福德 | lydford
比尔克 | 贝尔克 | beilke
巴尔诺 | 巴诺 | barno
法雷尔 | 法勒 | farer
福尔克纳 | 福克纳 | falkner
格雷博 | 格里博 | grebow
弗里斯 | 弗雷斯 | frece
朗莱因 | 朗莱恩 | longhlein
德克尔斯基 | 德克林斯基 | deklinski
埃勒斯 | 埃利斯 | elles
沃拉克 | 沃勒克 | wallack
约奥 | 约洛 | iolo
卡尼尔尼 | 卡奈尔尼 | carnearney
特嫩鲍姆 | 特南鲍姆 | tennenbaum
卡奇亚 | 卡夏 | cachia
莫森 | 莫桑 | morsan
阿杰里斯 | 阿吉里斯 | argeris
明尼特 | 明妮特 | minnette
斯坦卡德 | 斯顿卡德 | stunkard
里哈尔 | 雷哈尔 | rehal
安斯帕彻 | 安斯帕赫尔 | anspacher
杰西诺夫斯基 | 贾西诺斯基 | jasinowski
沃尔索夫 | 瓦尔塞奥夫 | waltheof
托比特 | 托贝特 | torbett
泰雷尔 | 蒂雷尔 | tyrell
安德雷斯 | 安德烈斯 | andress
埃尔斯皮 | 伊丽莎白 | elspie
加奇 | 盖奇 | gage
哈根 | 黑根 | hagan
卡特琳卡克 | 卡特林萨克 | katrinsak
托普尔 | 托佩尔 | topple
塞姆斯 | 泰晤士 | thames
斯坦布勒 | 斯坦伯勒 | stanbrough
肯奈尔德 | 肯奈德 | kennaird
勒克拉斯 | 勒克拉 | lecras
斯普赖耶 | 斯普雷耶 | spreyer
艾克纳 | 艾希纳 | eichner
温斯皮 | 温斯皮尔 | winspear
费拉奥 | 费劳 | ferrao
奥弗拉蒂蒂 | 奥弗莱厄蒂 | o'flaherty
博尼斯蒂尔 | 博恩斯蒂尔 | bonesteel
克里安 | 克林 | crean
萨马罗 | 萨马鲁 | samaroo
卡歇特 | 卡彻特 | kachert
霍 | 霍格 | hoegh
派克 | 珀基 | pyrke
恩布林 | 恩布琳 | emblin
卡尔索普 | 考尔索普 | calthorpe
西森 | 特森 | thesen
吉尔德姆姆 | 吉尔多姆 | guildhaume
埃普尤 | 埃维尤 | evjue
贾什帕 | 贾斯帕 | jaspar
威尔科夫斯基 | 维尔科夫斯基 | wilkowski
法尼耶尔 | 法纳尔 | faneuil
盖尔 | 加尔 | garr
伯尼特 | 伯内特 | burnett
里查特 | 理查特 | richart
朗尼格 | 朗内加 | runnegar
卡莎 | 卡撒 | cartha
麦克莱恩 | 麦克林 | mcclean
延格尔 | 扬格 | younger
多尔格 | 德尔格 | dolger
希尔泰密斯 | 希尔史密斯 | shearsmith
赫贝斯特里特 | 赫布斯特雷特 | herbestreit
赫尔斯滕 | 赫尔斯特恩 | hellstern
法兹卡斯 | 法泽卡斯 | fazekas
普莱斯顿 | 普利斯顿 | puleston
鲍金 | 鲍德金 | baudkin
迪林 | 迪尔林 | deerlin
科森 | 科瑟恩 | cothern
埃尔韦斯 | 埃尔威斯 | elwes
塔弗 | 塔沃尔 | tavor
昆坦纳 | 昆塔纳 | quintana
韦弗 | 韦伊尔 | weiher
维特 | 维特尔 | vetter
赫米恩 | 赫米奥娜 | hermione
约翰森 | 约翰逊 | johnson
杭德里奇 | 杭德里克 | honderich
利伯廷 | 利伯蒂娜 | libertine
达利佩齐 | 达莱佩泽 | dallepezze
胡普特 | 胡夫特 | hooft
博纳维娅 | 博纳维亚 | bonavia
迈莱斯特拉普 | 迈尔斯特勒普 | meilstrup
朗斯莱塞斯 | 朗斯利特斯 | launceletus
埃德利 | 埃德尔 | ederle
阿代奥 | 阿德奥 | addeo
米杰利 | 米奇利 | midgley
科莫尼亚克 | 科莫尼亚雷克 | komoniarek
格恩斯巴克 | 根斯巴克 | gernsback
蒂托 | 蒂特 | teetor
比尔 | 伯尔 | birr
邓坎森 | 邓肯森 | duncanson
高迪安 | 高迪恩 | gaudian
迪尔 | 代尔 | diel
菲茨伯伦 | 菲茨沃伦 | fitzwarren
迪思里希 | 迪特里希 | diethrich
德黑 | 德海 | dehay
当西 | 当齐 | dauntsey
沃索 | 瓦索 | wasow
吉尔迪 | 吉亚尔迪 | ghiardi
阿勒姆 | 奥勒姆 | allam
博迪科姆 | 博迪库姆 | bodycombe
艾泽诺尔 | 艾泽努尔 | izenour
布尔 | 布雷 | buhre
杰各布斯顿 | 雅各布斯坦 | jacobstein
特里里斯 | 特里赖斯 | trerise
帕尼特 | 帕内特 | panet
龙恩 | 龙尼 | ronne
伊尔 | 伊尔克 | ilg
查森 | 蔡森 | chasen
科佩拉 | 科皮拉 | coppela
朱拉比安 | 朱拉布奇安 | joorabchian
斯顿博 | 斯通博 | stombaugh
斯拉特里 | 斯莱特里 | slattery
弗雷克勒顿 | 弗雷克尔顿 | freckleton
托罗 | 陶罗 | tauro
埃尔马思 | 厄马思 | earmarth
希拉克 | 希莱克 | shillaker
莫特兰 | 莫思兰 | morthland
博尔杜克 | 博尔达克 | bolduc
梅约 | 梅奥 | mayo
达纳文特 | 杜纳万特 | dunavant
梅恩多尔德 | 梅因唐纳德 | maindonald
麦卡勒里 | 麦卡利里 | mcalery
黑兹尔廷 | 黑兹尔坦 | hazeltine
米吉尔 | 迈伊尔 | mighill
赫曼 | 希曼 | heman
布罗瑟 | 布拉泽 | brother
金索尔温 | 金索尔文 | kinsolving
赛恩 | 锡恩 | thynne
弗里斯 | 弗里亚斯 | freas
布里安 | 布赖恩 | brian
莱丁德尔 | 勒滕德 | letendre
杰斯 | 杰西 | jesse
海恩特 | 海因特 | heinte
莱夫斯丘 | 莱韦斯克 | levesque
奥德里 | 奥德丽 | audrey
约瓦诺维奇 | 约万诺维奇 | yovanovitch
安德里尔 | 安德里奥尔 | andriole
斯马比 | 斯梅比 | smaby
德赖伯格 | 德赖伯勒 | dryburgh
英奇金 | 英奇昆 | inchiquin
勒彭内克 | 勒佩内克 | lepennec
多南菲尔德 | 多宁费尔德 | donenfeld
沃尔德雷普 | 沃尔德里普 | waldrep
德马西奥 | 德马肖 | demascio
穆科夫斯基 | 穆科斯基 | mukowski
泽切拉 | 泽克拉 | zechella
卡莉 | 凯莉 | kallie
麦吉尔沃 | 麦吉尔伍尔 | macgillvoor
布古尔德 | 布古尔 | bougourd
塞文 | 西文 | sevin
欣恩 | 希恩 | shinn
庞纳帕拉马 | 庞南佩鲁马 | ponnamperuma
米曾 | 迈曾 | mizen
洛梅尔 | 隆梅尔 | lommel
金尼弗 | 珍妮弗 | gennifer
查萨尼斯 | 沙萨涅 | chassagnes
厄尔利 | 厄利 | earley
阿鲁托 | 阿尤托 | aiuto
博格伍德 | 鲍赫鲁德 | boughrood
吉隆 | 吉伦 | gillon
道沃德 | 道尔德 | doward
韦克 | 瓦克尔 | wacker
路易佐 | 路易祖 | louizou
弗兰兹 | 弗朗兹 | franz
特里福迪迪斯 | 特里福尼迪斯 | trifonidis
米泽尔 | 米泽勒 | mizelle
托雷斯 | 托里斯 | torres
沃利本 | 沃莱本 | wohlleben
普阿尔格拉夫 | 法尔茨格拉夫 | pfaltzgraff
玛丽恩 | 马里恩 | maryon
沃申科 | 瓦申科 | washenko
博尼特 | 博内特 | bonett
伊利特 | 艾利特 | ilett
多伊施 | 多伊施尔 | deuschl
马库斯 | 马库塞 | marcuse
伊尔明杰 | 艾尔明格 | irminger
阿伦 | 艾伦 | allen
伊莎巴德 | 伊桑巴德 | isambard
斯森特 | 斯滕特 | stent
乔瑟姆 | 乔撒姆 | jotham
温切莱 | 温切尔西 | winchelsea
古卡斯 | 古奥卡斯 | guokas
迪特 | 迪泰特 | dittert
杜尔费 | 德菲 | durfee
菲查林 | 菲茨艾尔温 | fitzailwyn
埃迪生 | 埃迪森 | eddison
加雷特 | 加勒特 | garret
希金博瑟姆 | 希金博特姆 | higinbotham
马吉 | 马季 | marj
布加斯 | 巴加斯 | bugas
凯 | 基 | key
林德斯滕 | 林斯滕 | lindsten
本内特 | 贝内特 | bennete
贝罗尔 | 伯罗尔 | berall
施威默 | 施维默 | schwimmer
凯特伦 | 卡特伦 | catron
斯威特基 | 斯威凯 | switkay
布里哈特 | 布里尔哈特 | brillhart
多本斯贝克 | 多本斯佩克 | daubenspeck
索布洛夫 | 索贝洛夫 | sobeloff
布巴尔斯基 | 兹巴尔斯基 | zbarskiy
麦卡利基 | 麦卡利克西 | mcaliksey
休利尔 | 特威利尔 | thuillier
戴亚曼特 | 迪亚曼特 | diamant
科德 | 科尔德 | coard
德加里里安 | 德加拉贝迪安 | dergarabedian
戈特特里奥 | 戈特格特鲁 | gottgetereu
赫伦布兰德 | 海伦布兰德 | hellenbrand
埃布 | 厄尔布 | erb
巴尔桑齐 | 巴尔丹齐 | baldanzi
莱兰 | 利兰 | lelland
奇瓦蒂罗 | 奇瓦特罗 | chivatero
温泽尔 | 温策尔 | wenzel
杜格 | 杜奇 | dooge
巴蒙特 | 贝蒙特 | bamont
加利亚多 | 加利亚尔多 | galiardo
奥尔德西泽 | 奥尔迪泽 | aldhizer
卡洛戈罗 | 卡洛杰罗 | calogero
纳盖 | 纳金 | nagean
麦利纳基克 | 姆利纳奇克 | mlinarchik
道兹韦尔 | 多德斯韦尔 | dowdeswell
德尔 | 杜尔 | durr
米齐 | 梅齐 | meazey
斯坦纳 | 斯蒂纳 | stiner
迪伦福思 | 迪伦弗思 | dhyrenfurth
拉费蒂 | 拉菲蒂 | laffeaty
扎尔米 | 扎尔梅 | zalmay
扬克威奇 | 扬克维奇 | yankwich
萨格曼 | 塞奇曼 | sageman
凯尔维尔 | 克切维尔 | kercheville
施韦特 | 施韦蒂德 | schwetid
德西里 | 德西蕾 | desiree
奎利 | 丘利 | kewley
卡德拉 | 夸德拉 | cuadra
德普米尔 | 德波米耶 | depommier
加哈根 | 加黑根 | gahagen
麦金托夫 | 麦金塔夫 | mcinturff
莫弗德 | 莫维兹 | morfudd
桑克利 | 尚克利 | sankley
罗梅因 | 罗曼 | romaine
萨马拉 | 赛马拉 | saemala
怀斯坦 | 威斯坦 | wystan
博德温恩 | 鲍德温 | bodwine
勒斯 | 卢斯 | luss
欧斯 | 奥恩斯 | owns
鲍科姆 | 鲍库姆 | bawcombe
莱瑟夫 | 勒瑟夫 | lesurf
查伦杰 | 查林杰 | challenger
泰特 | 撒特 | thaete
约基尔森 | 约克尔森 | yochelson
贾恩 | 杰恩 | jayne
弗兰西娅 | 弗朗西亚 | francia
亨特雷斯 | 亨特里斯 | huntress
图瓦安 | 蒂乌萨宁 | tiusanen
赫尔西泽 | 赫尔希泽 | hulshizer
特里布 | 特赖布 | tribe
金卡尼 | 金凯尼 | kincairney
阿尼尼 | 阿内尼 | aneny
马斯曼 | 穆斯曼 | mussman
沃罗德 | 沃尔龙德 | walrond
蒙塔文 | 蒙塔冯 | montavon
萨奇 | 萨特杰 | satge
贾尼斯 | 贾尼西 | janisse
杜蒂 | 达西 | duthie
加汉 | 加恩 | gahan
希索姆 | 希瑟姆 | heesom
德拉波 | 德拉珀 | drapeau
巴里克 | 巴威克 | barwick
霍杰特 | 霍贾特 | hodgart
桑比 | 桑德比 | saundby
斯威布 | 斯韦比 | swaebe
弗鲁伊特 | 弗鲁特 | fruit
伊利恩 | 伊尔伦 | illearn
阿布洛姆 | 阿布隆 | ablom
博尔加塔 | 博加塔 | borgatta
埃斯菲尔 | 伊斯梅尔 | esmail
沃滕伯格 | 瓦滕伯格 | wattenberg
安东尼斯 | 安图尼斯 | antunes
阿迪内特 | 阿迪尼特 | adinet
吉尔克雷斯特 | 吉尔克里斯特 | gilchrest
迪克 | 迪克尔 | dicker
德塞 | 德瑟 | desser
格博尔 | 格巴尔 | geballe
豪耶莱贝克 | 胡尔贝克 | houiellebecq
布希 | 布舍 | busche
卡梅尔福德 | 卡姆尔福德 | camelford
卢金贝尔 | 卢金比尔 | lukingbeal
比伊 | 布伊 | buie
费多克 | 费多奇克 | fedochik
马尔谢恩 | 马尔夏恩 | mulshine
迈哈拉克 | 迈克拉克 | michalak
查费茨 | 查菲茨 | chafetz
塞米厄斯 | 瑟缪斯 | sermeus
安杰莱斯 | 安杰利斯 | angeles
艾肯 | 伊坎 | icahn
里厄尔 | 鲁埃尔 | reuel
克兰德 | 克林德 | cleander
海森 | 希森 | hyson
沃姆索 | 沃姆泽 | wormsor
吉诺尔 | 格瑙尔 | genauer
克莱夫 | 克拉夫 | clave
蒙托纳 | 蒙顿纳 | montonna
卡莎 | 卡沙 | kasha
利多姆 | 利德姆 | leedom
马拉布尔 | 梅拉伯 | malabre
利希特沃特 | 利希特瓦尔特 | lichtwardt
加诺斯 | 加农斯 | garnons
奥弗罗尔 | 奥费拉尔 | o'ferrall
希登 | 黑登 | headon
塔谢罗 | 塔什罗 | taschereau
埃廷杰 | 埃廷格 | ettinger
查彭 | 沙蓬 | chapone
卢格 | 洛格 | logue
林迪 | 琳迪 | lynndie
奇德尔 | 切德尔 | chedell
甘博 | 甘博亚 | gamboa
巴蒂泽尔 | 巴蒂扎尔 | bartizal
法耶 | 费尔 | fayer
康伯 | 库默 | comber
赫施 | 胡希 | husch
阿克利 | 埃克利 | akeley
尤耶 | 尤伊泽 | ueyser
奥拉 | 奥尔拉 | orla
西拉 | 赛拉 | thyra
卡丹 | 卡登 | kadane
斯特罗休尔 | 斯特罗萨尔 | strohsahl
埃弗伯里 | 埃夫伯里 | avebury
图伊希 | 图伊 | tuohey
卢什 | 勒什 | lush
迪达姆 | 迪德姆 | deedham
古特威思 | 格特沃思 | gutwirth
斯特朗伯格 | 斯特龙伯格 | stromberg
格维茨 | 格威茨 | gurwitz
德梅特 | 德梅特尔 | demaitre
哈特内特 | 哈特尼特 | hartnett
贝里 | 比尔里 | beary
斯韦特林 | 斯韦思林 | swaythling
达姆勒 | 杜姆勒 | dumler
莱奥尼达斯 | 利奥尼达斯 | leonidas
海因菲尔德 | 汉费尔德 | hainfeld
沃拉 | 瓦拉 | walla
伊尔德勒姆 | 埃尔德姆 | ealdhelm
斯塔内克 | 斯托尔内克 | stalnecker
马杰里 | 马格丽 | margery
贝尔瓦尔德 | 贝瓦尔德 | baerwald
盖伊 | 贾伊 | ghey
赖姆斯 | 里姆斯 | rheims
费罗瑟德 | 费罗祖德 | ferozud
普卢奇 | 普拉奇 | plugge
基乔 | 凯乔 | kejoa
博斯顿 | 波士顿 | boston
费克特基蒂 | 费克特库蒂 | feketekuty
赫芬 | 赫法恩 | huffine
梅雷韦瑟 | 梅里韦瑟 | mereweather
门恰卡 | 门查卡 | menchaca
瑟希 | 塞希 | sershey
拉克斯里思 | 拉克斯弗里思 | laxfrith
埃诺 | 伊诺 | eno
塞利格曼 | 塞利希曼 | seligmann
加韦德 | 加维德 | gaved
斯特雷隆 | 斯特里姆劳 | stremlau
佩洛贝特 | 佩卢贝特 | peloubet
德罗姆洛尔 | 德罗姆古尔 | dromgoole
拜尔 | 贝耶尔 | beier
斯普赖耶 | 斯普赖尔 | spryer
马卡洛尼斯 | 马查洛尼斯 | marchalonis
瑟沃克 | 瑟瓦奇 | serwach
艾斯林 | 阿斯林 | acelin
萨德比 | 萨德贝 | sudbay
阿菲 | 埃菲 | afee
西德博特姆 | 赛德博特姆 | sidebotham
格德 | 格尔德 | gerd
埃克洛夫 | 埃克勒夫 | eklof
博格哈尔 | 博格蒂尔 | boghatyr
芬格勒 | 芬勒 | fengler
伊因 | 约恩 | eoin
索 | 托 | thau
西德尼 | 西妮 | sydni
图里曼 | 图尔曼 | tureman
德西德拉塔 | 德西德蕾塔 | desiderata
茹埃特 | 朱厄特 | jouett
班顿 | 贝恩顿 | baynton
勒菲弗 | 勒费布尔 | lefebvre
约克威姆斯 | 约克威廉 | yorkwilliams
弗拉利克 | 弗雷利克 | fralick
瑟娜 | 塞尔纳 | serna
伦嫩 | 伦南 | lennen
罗吉特 | 罗热 | roget
杰塞里奇 | 杰塞里克 | jeserich
海内特 | 希格尼特 | hignett
沙夫特伯里 | 沙夫茨伯里 | shaftesbury
杜庞特 | 杜邦 | dupont
克利姆克 | 克利姆基 | klimcke
赫尔布尔 | 赫布尔 | helble
比尔布罗 | 比尔伯勒 | bilbrough
特拉皮耶 | 特拉皮尔 | trapier
昂布赖特 | 昂布里特 | umbreit
布劳恩 | 布朗 | browne
凯加 | 凯加鲁 | caegarw
赫沃斯 | 休沃斯 | huvos
莱热 | 利热 | leasure
萨姆斯塔格 | 扎姆斯塔格 | samstag
贾格斯 | 贾格尔斯 | jaggers
赛克 | 西克 | cyker
凯斯 | 基斯 | keys
萨基纳 | 萨金娜 | sakinah
勒丰 | 勒方 | lefaune
拉夫向 | 拉夫肖恩 | rafshoon
哈格特 | 哈吉特 | haggitt
贝曼 | 比曼 | beman
索弗特 | 索伊弗特 | seufert
斯坦纳姆 | 斯塔纳姆 | stanham
麦克沃登 | 麦克瓦登 | mcvadon
帕特诺 | 佩特诺 | paterno
阿克申 | 埃克申 | action
梅因沙因 | 梅恩沙因 | maienschein
加斯丘 | 加斯克 | gasque
桑兹 | 桑德斯 | sondes
穆普森 | 马普森 | mupson
奥金科斯洛斯 | 奥金克洛斯 | auchincloss
埃尔利 | 埃尔勒 | ehrle
勒克赫斯特 | 卢克赫斯特 | luckhurst
卡罗尔 | 卡萝尔 | carole
埃丁杰 | 埃丁格 | edinger
德维尔 | 德韦尔 | deveulle
麦高兰 | 麦戈兰 | mcgauran
巴尔达扎 | 巴尔丹扎 | baldanza
马格尼 | 马格内 | magnay
法尔克里奇 | 福尔肯布里奇 | falconbridge
马库斯 | 马克斯 | marcuss
格林斯特德 | 格林斯蒂德 | grinstead
纳克曼 | 纳奇曼 | nacheman
阿尔文 | 奥尔文 | allvine
林德尼斯 | 莱因德尼斯 | rhindness
米多斯 | 梅多斯 | meadows
帕德西 | 帕齐 | pudsey
罗勒夫斯 | 罗卢夫斯 | rolufs
汉德伯格 | 汉德沃格 | handwerger
莱加特 | 莱格特 | legatt
尼科莱迪斯 | 尼古拉迪斯 | nikolaidis
戈利特利 | 戈莱特利 | golightly
芒尼克森 | 芒尼克海森 | munnikhuysen
朱尔科维茨 | 尤尔科维茨 | jurkowitz
鲁宾斯坦 | 鲁本斯坦 | rubenstein
休尤 | 舍韦 | schewe
麦坎金 | 麦克琼金 | mcjunkin
高蒂耶 | 高蒂尔 | gauthier
古普 | 格普 | gup
拉贝特 | 拉贝 | rabet
吉盖尔 | 吉格尔 | giguere
彭特 | 庞特 | punter
麦克法迪安 | 麦克法迪恩 | mcfadyean
卢尼德 | 莉内德 | luned
乔莫 | 肖莫 | chomeau
科勒斯 | 科雷斯 | corace
科克兰 | 科克伦 | cochrane
布班扎 | 布尔扎纳 | brzana
莫尔霍尔特 | 莫霍尔特 | molholt
阿加西亚 | 阿加西娅 | agacia
梅佩尔 | 马佩尔 | mapel
塞尔蒙 | 瑟蒙 | sermon
克里茨 | 克赖茨 | crites
钱伯林 | 钱伯辛 | chamberlsin
格青格 | 格青杰 | getsinger
艾维特 | 艾尔薇特 | irvette
霍尼斯 | 霍尔尼斯 | holness
德尼奥 | 迪奈欧 | denio
基尔 | 基利 | kille
奥西内尔 | 奥塞内尔 | othenel
坦迪恩 | 坦丁 | tandien
马尼奥利亚 | 马格诺利娅 | magnolia
埃莱斯米尔 | 埃尔斯米尔 | ellesmere
戴西 | 黛西 | daisy
戈德弗 | 戈德夫 | godefe
布拉诺 | 布拉诺姆 | branom
沃瑟姆 | 沃特海姆 | wertheim
克里斯特高 | 克里斯戈 | christgau
奥科因 | 奥库安 | aucoin
休尔塔 | 许尔塔 | huerta
彼得罗 | 佩特罗 | petro
亨萨克 | 亨塞克 | hunsaker
诺库伊 | 诺基 | norquoy
马克厄姆 | 梅卡姆 | makeham
斯特拉布里奇 | 斯特劳布里奇 | strawbridge
希肯洛珀 | 希肯卢珀 | hickenlooper
巴尔萨萨 | 巴尔塔泽 | baltassar
杜克 | 杜凯 | duque
海尔卡 | 海尔基 | heilkay
泽比娜 | 泽拜纳 | zebina
麦卡尼 | 麦卡内尼 | mcaneney
格拉斯戈 | 格拉斯哥 | glasgow
赫奇格 | 赫金杰 | hechinger
哈恩迪 | 哈内迪 | harnedy
斯梅耶 | 斯梅奇 | smaje
奥利文特 | 奥利万特 | ollivant
戈洛夫科 | 戈洛夫琴科 | golovchenko
麦克利尔莫尔 | 麦克勒莫尔 | mclemore
德布勒勒 | 德布鲁勒 | debruler
麦克费德兰 | 麦克费德伦 | macphedran
奥迪吉尔 | 奥迪吉耶 | audigier
赫蒙 | 哈蒙 | hummon
伯特胡德 | 伯绍德 | berthoud
奥尔卡德 | 阿尔卡德 | alcalde
帕克特 | 帕赫特 | pachter
比奥利 | 比利 | beoley
戴 | 丁 | din
古比托希 | 古比托西 | gubitoshi
比塔 | 比塔尔 | bitar
洛伊 | 洛 | loew
金 | 钦 | ching
达尔维奇 | 达利奇 | dulwich
格罗西斯特 | 格罗斯泰特 | grosseteste
施蒂布林 | 斯蒂贝林 | stiebeling
洛克希尔 | 洛希尔 | lochiel
弗里尔 | 弗雷耶 | freyere
汉斯利 | 亨斯利 | hensly
斯桑菲尔德 | 舍恩菲尔德 | schonfield
斯托尔普曼 | 施托尔普曼 | stolpman
弗兰普欣 | 弗兰普申 | framption
博雷特 | 博里特 | borrett
米克尔约恩 | 米克尔约翰 | meiklejohn
拉肯迈耶 | 拉肯米尔 | lackenmier
费切姆 | 费克姆 | feachem
拉卡潘尼 | 拉康帕涅 | lacampagne
索维奇 | 索瓦热 | sauvage
赫曼 | 赫尔曼 | herman
科帕德 | 科珀德 | coppard
埃尔齐伊 | 埃尔扎伊 | elzay
韦格佐 | 维格索 | vegso
巴思 | 巴特 | barthe
埃斯科菲 | 伊斯科菲 | escoffey
吉利亚姆 | 吉列姆 | gilliam
皮埃 | 皮埃尔 | pierre
博施威茨 | 博希威茨 | boschwitz
哈德格雷 | 哈迪格里 | hardegree
皮尔 | 珀尔 | pearl
维拉雷尔 | 维拉里尔 | villarreal
伊格莱维奇 | 伊格尔维奇 | iglewicz
洛西安 | 洛西恩 | lowthian
多姆安 | 多米扬 | domjan
阿巴斯蒂尼娅 | 阿巴斯蒂尼亚 | abastenia
阿利斯 | 阿莱斯 | allies
海伊泽 | 哈伊泽 | huyser
马特尔 | 马蒂尔 | martyl
科默杰 | 康马杰 | commager
卡拉佩蒂安 | 卡拉佩琴 | carapetyan
布里宁 | 布赖宁 | bryning
格利多尔 | 格利德尔 | gleadall
麦克恩恩 | 麦克钦 | mccheane
切尔滕纳姆 | 切尔特纳姆 | cheltenham
布罗德伯特 | 布罗德本特 | broadbent
克拉布里 | 克拉布特里 | crabtree
埃里特 | 埃雷特 | ehret
特洛 | 特略 | tello
纽伯勒 | 纽伯格 | newburgh
博贝特 | 博塞特 | botset
威克斯特德 | 威克斯第德 | wicksteed
维克斯科夫斯基 | 维斯克洛斯基 | visclosky
斯科格伦 | 斯科格隆 | skoglund
拉萨尔 | 拉萨 | lassar
万诺伊 | 范诺伊 | vannoy
魏塔尔 | 温特尔 | weintal
贾夫 | 贾菲 | jaffe
斯塔姆 | 施塔姆 | stamm
法扎 | 法扎尔 | fazar
马塞尔 | 玛塞勒 | marcelle
黑兹利特 | 赫兹利特 | hezlet
尤文斯 | 尤温斯 | uwins
切瑟尔斯基 | 切赫尔斯基 | cehelsky
尤莱维奇 | 乌莱维奇 | ulevich
德黑斯 | 德海斯 | dehayes
马顿 | 梅顿 | maton
希拉 | 夏伊拉 | shyla
比恩 | 比汉 | beehan
法尔肯海姆 | 福尔肯海姆 | falkenheim
哈努舍克 | 哈努谢克 | hanushek
德拉施塔特 | 德拉格施泰特 | dragstedt
洛恩 | 洛温 | lowen
韦勒姆 | 沃勒姆 | warham
德弗勒 | 德夫勒 | doerfler
施朗茨 | 施龙茨 | shrontz
贝默赛德 | 比默赛德 | bemersyde
米姆诺 | 明诺 | mimno
布平达 | 布平达尔 | bhupindar
罗明 | 罗梅因 | romeyn
扬赫斯沙德 | 扬哈斯本 | younghusband
夏皮 | 沙比 | sharpey
莱西奇 | 勒萨热 | lesage
布布利斯 | 布勃利斯 | bublys
特德福德 | 塞德福德 | thedford
伯特霍尔夫 | 伯索夫 | bertholf
塞迪亚 | 切迪亚 | ceddia
沙特利夫 | 舒特莱夫 | shurtleff
乔齐 | 乔茜 | jozy
黛安 | 戴安 | dian
劳克霍夫 | 劳卡夫 | laukhuff
米尔利 | 米尔海 | milhy
卡德根 | 卡杜根 | cadwgan
博希尔 | 博舍尔 | boshier
斯克里伯 | 斯克赖伯 | scriber
博维 | 博韦 | bovee
赫克顿 | 赫克通 | hektoen
莱维 | 利瓦伊 | levi
克里亚 | 克雷 | crea
卡佐普拉 | 库佐克雷亚 | cuzzocrea
克拉茨 | 克卢茨 | clutz
普罗斯卡尔 | 普罗斯考尔 | proskauer
阿德金森 | 阿基森 | adkisson
施莱 | 施利 | schlie
艾维根 | 伊菲吉妮 | iphigene
德比基 | 德比茨基 | debicki
泽费列利 | 泽菲雷利 | zeffirelli
泰菲恩 | 泰维恩 | teifion
亚历克西斯 | 亚历克西丝 | alexys
本加明 | 本杰明 | benjamin
菲塞利斯 | 菲谢利斯 | fischelis
坎帕涅 | 坎佩恩 | campaigne
古茨威勒 | 古茨维勒 | gutzwiller
马奎斯 | 马克斯 | marques
勒金 | 勒德金 | ludgin
阿尔皮娜 | 阿尔皮纳 | alpina
韦勒尔 | 沃雷尔 | werrell
福尔兹 | 福尔茨 | folz
德福德 | 德福特 | deford
齐尼基 | 齐尔尼基 | ziernicki
博比泽 | 博比苏德 | bobisud
图尔 | 特尔 | tourle
图利特 | 塔利特 | tulett
斯塔克 | 斯图克 | stucke
斯恩伯格 | 舍恩伯格 | schonberger
兰贝利特 | 兰伯利特 | lambelet
盖 | 贾伊 | gye
布卢梅菲尔德 | 布卢姆菲尔德 | blumefield
利希滕斯坦 | 利克滕斯坦 | liechtenstein
安德尔鲁维奇 | 安德鲁斯克维奇 | andruskevich
托德里斯 | 托德雷亚斯 | todreas
布金 | 布尔金 | bourgin
兰米德 | 兰梅德 | langmaid
比 | 布埃 | bue
阿维斯 | 阿维丝 | aveis
斯特朗杰 | 斯特兰杰 | stranger
阿伦 | 阿龙 | aaron
马尔克斯 | 马尔库斯 | malkus
杜奇 | 杜格 | dhooge
齐恩 | 蔡恩 | zion
格尔巴赫 | 盖尔博 | gelbach
布雷克兰 | 布里克兰 | brekland
布卡拉 | 布阿哈拉 | buachalla
里丁斯 | 赖丁斯 | ridings
沃尔克 | 沃克 | walke
考特尼 | 考特妮 | kourtney
布洛格伦 | 布洛姆格伦 | blomgren
奎尔 | 屈尔 | kuehl
纽泽姆 | 纽瑟姆 | newsum
比利尔 | 比埃 | billiere
梅茨杰 | 梅茨格 | metsger
埃尔杰 | 埃尔格 | elger
曼恩 | 曼 | mann
佩金 | 帕金 | pagin
尼古利 | 尼古拉 | nicolay
塔图莱斯 | 塔图尔斯 | tatooles
弗雷塔格 | 弗赖塔格 | freytag
基米特 | 金米特 | kimmitt
克罗斯曼 | 克罗斯蒙 | croasmun
乔登斯 | 乔丹斯 | jordans
利萨特 | 利撒特 | leathart
赖津 | 里津 | ryzin
库尔德 | 库尔德韦尔 | couldwell
内特特 | 纳马思 | namath
索利兹 | 索莱 | saulez
布莱克欣登 | 布莱钦登 | blechynden
马利纳克 | 马利纳克斯 | mullinax
巴托利欧 | 巴托洛缪 | bartholemeu
安德烈娜 | 安德里娜 | andrina
塔尼娅 | 塔妮娅 | tania
柯克 | 瑟克 | cirker
德文特 | 德温特 | derwent
妮科尔 | 尼科尔 | nicolle
恩德科特 | 恩迪科特 | endecott
阿尔文 | 阿尔温 | alwin
拉索姆 | 莱瑟姆 | lathom
霍塞尔 | 休塞尔 | heusel
莱夫拉 | 莱弗拉尔 | leflar
罗萨佩普 | 罗萨皮普 | rosapepe
赫宁伯格 | 赫宁堡 | heningburg
巴萨德 | 巴萨德雷 | basadre
塞勒斯 | 塞拉斯 | sellars
斯威策 | 斯韦策 | sweitzer
梅卢普斯 | 梅拉普斯 | mellups
巴尔西格 | 巴尔西杰 | balsiger
希拉伯 | 希莱伯 | shillaber
布兰德马斯 | 布兰德法斯 | brandfas
斯卡卡西特 | 斯卡尔普西特 | sculpsit
休马森 | 赫马森 | humason
斯特夫斯 | 斯特弗斯 | steffes
吉尔鲍德 | 吉尔博 | guillebaud
比切特 | 贝谢 | bechet
梅利奥尔 | 梅莉奥尔 | melior
鲁马塞特 | 罗马塞特 | roumasset
奥利耶 | 奥利尔 | ollier
克谢弗 | 克切弗 | kerchever
比阿特里亚 | 比阿特丽西娅 | beatricia
梅纽欣 | 梅纽因 | menuhin
舒雷 | 舒尔 | shure
凯格 | 基格 | keig
菲阿尔卡 | 菲亚尔卡 | fialka
伊萨科 | 伊萨科夫 | isakow
兹沃 | 兹瓦尔 | zwar
克伦西克 | 赫伦奇克 | chrencik
奈萨 | 尼萨 | neysa
彭沃尔特 | 佩恩沃尔特 | pennwalt
米柳斯 | 米利厄斯 | milius
库塞弗基 | 科乌谢维茨基 | koussevitzky
米尼奥 | 米内奥 | mineo
布鲁宁 | 布罗宁 | broening
伊尔图德 | 伊尔蒂德 | illtud
弗罗伊斯 | 弗勒泽 | froese
莱尔 | 赖尔 | ryle
阿什利 | 阿什莉 | ashleigh
斯图扎 | 斯图尔扎 | stoorza
切内里 | 切纳里 | chenery
弗拉赫蒂 | 弗莱厄蒂 | flaherty
诺克斯 | 努克斯 | nokes
恰奥鲁奇 | 基亚鲁奇 | chiarucci
图尔默 | 瑟默 | thuermer
汉奇 | 汉格 | hange
谢格尔斯 | 舍加尔斯 | shergals
杜库诺伊 | 迪克努瓦 | duquenoy
斯托齐 | 斯托西 | stosy
波特努伊德 | 波特诺伊德 | portnoid
托里奥斯 | 托里霍斯 | torrijos
柯彻 | 基尔舍 | kircher
斯托尔曾巴赫 | 斯托曾巴赫 | stolzenbach
杰杰 | 杰格 | jeger
杜贝格 | 杜伯格 | duberg
马德里德 | 马德里 | madrid
唐恩 | 唐 | donn
凯特尔比 | 基特尔比 | ketelbey
怀安特 | 威甘特 | wygant
博弗里 | 博韦里 | boverie
埃弗雷茨 | 埃弗里茨 | everetts
贝尔 | 贝利 | behle
阿尔格拉 | 阿利格拉 | allegra
赖克沃特 | 里克沃特 | rykwert
奥法雷尔 | 奥法雷 | o'farrell
卢宁 | 吕宁 | luening
特金 | 图尔金 | turkin
蒂尔里 | 蒂里 | thierry
阿斯当登 | 阿斯普登 | aspden
乔西 | 约瑟 | josee
施赖伯 | 施里伯 | shriber
迈斯兰 | 迈斯拉恩 | meislahn
格尔纳 | 盖尔纳 | gellner
森塞尼克 | 森塞尼奇 | sensenich
比斯林林夫 | 比斯普林霍夫 | bisplinghoff
高温 | 高英 | gowing
亨尼卡特 | 亨尼克特 | hunnicutt
本恩 | 贝恩 | benne
科斯 | 库斯 | coes
舍内曼 | 舍尼曼 | schoeneman
维尼斯 | 维内斯 | veness
穆斯 | 缪斯 | muse
霍伊斯布罗克 | 哈维克斯布罗克 | hawixbrock
冈海利 | 贡希利 | goonhilly
霍尔蒂厄 | 霍尔蒂万格 | haltiwanger
哈里尔 | 哈丽尔 | harriel
奎恩 | 奎因 | queen
塞塞尔 | 塞斯尔 | sessel
尼尼亚基斯 | 尼奥纳基斯 | nionakis
费尔马纳 | 费尔曼纳 | fairmaner
霍金森 | 霍奇金森 | hodgkinson
奥尔奇普龙 | 阿尔西弗龙 | alciphron
特雷西 | 特蕾西 | tracey
乔克 | 吉奥克 | giauque
埃尼德 | 伊妮德 | enid
西金特 | 瑟金特 | searjeant
拉金 | 莱金 | laging
斯恩伯格 | 舍恩伯格 | schonberg
米特夫夫 | 米采夫 | mitseff
芬格 | 范杰 | fanger
布兰琴 | 布兰昌 | blanchan
霍尔戴蒙德 | 哈尔迪曼德 | haldimand
吉廉斯 | 吉利亚姆 | guilliams
多奇 | 道奇 | dodge
梅莉娅 | 米利亚 | melia
弗赖里克 | 弗赖雷克 | freireich
罗明格 | 罗明杰 | rominger
戈梅斯拉塔 | 戈梅斯普拉塔 | gomezplata
布热瓦 | 布儒瓦 | bourgeois
安东尼欧 | 安东尼乌 | antoniou
罗伊巴尔 | 罗伊鲍尔 | roybal
布舒尔夫 | 布舒夫 | bushueff
萨吉塔里厄斯 | 萨吉泰里厄斯 | sagittarius
比克 | 贝克 | beek
特怀德尔 | 特威德尔 | twidell
雷努德 | 伦瓦尔 | renouard
希拉斯 | 希勒斯 | heelas
考尔德克拉 | 考尔德克拉夫 | caldcleugh
克拉格 | 克莱格 | clague
雅西纳 | 杰西纳 | jacyna
切希尔 | 切斯希尔 | chesshyre
布雷钦 | 布里金 | brechin
古德勒姆 | 古德哈姆 | gooderham
亚杰 | 耶格尔 | yager
巴尔尼 | 鲍恩 | balne
霍普 | 霍伊普 | heup
富尔赫姆 | 富勒姆 | fulham
格鲁赛德 | 格鲁辛德 | grusinde
希曼娜 | 希曼纳 | sheemanna
阿迪尼奇 | 阿德查尼克 | ardcharnich
比迪利恩 | 贝迪利翁 | bedillion
斯迈思 | 史密斯 | smyth
赖道特 | 赖德奥特 | rideout
麦考斯兰 | 麦考斯伦 | mcauslan
尼思代尔 | 尼斯代尔 | nithsdale
多罗西 | 多萝西 | dorothy
斯塔宾 | 斯图宾 | stubbing
奥尔弗森 | 阿尔弗森 | alverson
德尔福斯 | 达尔福斯 | dullforce
菲比杰 | 菲比格 | fibiger
索洛茨茨 | 索尔特斯 | solotesz
坎普施勒 | 坎普施罗尔 | kampschror
布姆斯特德 | 巴姆斯特德 | bumstead
坦普拉 | 坦普勒 | templar
伦恩 | 莱恩 | len
德马蒂诺 | 德马尔托 | desmarteau
夏尔普 | 谢普 | shairp
格赖德 | 格雷德 | greider
克洛德纳 | 科洛德纳 | kolodner
索恩代克 | 桑代克 | thorndike
马沙姆 | 马香 | marsham
切尔尼克 | 切尔内克 | chelnek
奥伯霍尔曼 | 奥伯黑尔曼 | oberhelman
多纳休 | 多尼休 | donehue
帕特里亚克 | 佩特里亚克 | patriach
莱斯 | 莱什 | leisz
里查兹 | 理查兹 | richards
艾奇森 | 艾奇逊 | eytchison
布里恩特 | 布赖恩特 | briant
丹罗威瑟 | 丹罗伊特 | dannreuther
巴恩比 | 巴恩贝 | barnebey
梅林达 | 梅琳达 | melinda
弗伦泽 | 弗伦策 | frenzer
康西尔 | 康斯尔 | council
谢因鲍姆 | 欣鲍姆 | sheinbaum
尚顿 | 桑顿 | szanton
戈德博勒 | 戈德伯勒 | goldborough
赫马尼克 | 赫马纽克 | hermaniuk
维思 | 韦思 | vaeth
埃尔瓦恩 | 埃尔温 | elwane
巴塔格尔 | 巴塔杰尔 | battagel
埃勒克 | 埃厄克 | earwaker
格林达尔 | 格林德尔 | grindal
贝克斯泰特 | 贝克施泰特 | beckstedt
塞弗林豪斯 | 塞夫林豪斯 | sevringhaus
雅科特 | 贾科泰 | jacottet
布雷利 | 布里厄利 | brealey
麦科尚希希 | 麦科尚奈格 | maco'shannaig
麦克廷格 | 马赫廷格 | machtinger
特里斯特里姆 | 特里斯特雷姆 | tristrem
康杰 | 康格 | conger
克尼格 | 凯尼格 | koernig
马米特 | 马梅特 | mamet
卡特尔 | 卡瑟尔 | cuthell
诺埃 | 诺姆 | noam
迪尤斯 | 德威斯 | dewees
奥琳达 | 奥林达 | orinda
斯塔林 | 斯托林 | stalling
基茨哈伯 | 基察伯 | kitzhaber
布雷齐尔 | 布雷热 | brazier
斯米亚克 | 斯米亚利克 | smialek
芬尼 | 菲尼 | phinney
奥尔迪 | 阿尔迪 | alday
阿曼德斯 | 阿曼达斯 | amandus
哈洛兰 | 哈洛伦 | halloran
赛纳 | 西纳尔 | synar
康乔拉 | 康科勒 | concholar
杜纳利 | 达纳利 | dunalley
瑟弗蒂 | 瑟法蒂 | serfaty
肖勒 | 朔伊勒 | scheuler
特鲁曼 | 杜鲁门 | truman
惠伦 | 惠兰 | whelan
迪奥 | 德奥 | deo
拉思 | 雷思 | rathe
哈尔巴克 | 哈尔巴赫 | halbach
盖利尔 | 加利尔 | galil
劳特 | 鲁尔特 | rurt
赫利 | 赫尔利 | hurleigh
克罗嫩贝格 | 克罗嫩伯格 | kronenberg
克里奇顿 | 克赖顿 | crichton
格温尼德 | 格威内思 | gwynedd
特罗蒂耶 | 特罗蒂尔 | trottier
凯利 | 基利 | kealy
科特 | 考特 | cawte
布基 | 布谢 | bouchey
鲍尔斯 | 鲍威尔斯 | powels
罗雷姆 | 罗勒姆 | rorem
安德烈奥 | 安德里厄 | andrieux
阿莱恩 | 阿林 | alleine
贝克 | 贝克尔 | becker
纳克马诺夫 | 纳赫马诺夫 | nachmanoff
怀索基 | 维索茨基 | wysocki
斯莫尔迈斯 | 斯莫尔皮斯 | smallpeice
萨里奇 | 瑟里奇 | surridge
唐西娅 | 唐西亚 | donsia
杜克罗 | 迪克罗 | ducrow
沃尔克 | 沃克 | walk
沃尔克 | 沃克 | walker
麦科拉姆 | 麦科勒姆 | mccollam
斯坦达洛夫特 | 斯坦德洛夫特 | standaloft
莱恩斯 | 莱昂斯 | lyons
德沃查克 | 德沃夏克 | dvorchak
费布里坎特 | 法布里坎特 | fabricant
多克特 | 多克托 | docktor
弗朗斯 | 弗朗西斯 | fraunces
菲林 | 法林 | filene
巴戈 | 巴戈特 | bagot
吕尔 | 勒尔 | lull
希尔茨 | 希尔兹 | shields
菲内尔 | 芬内尔 | feennell
埃弗舍德 | 埃弗谢德 | evershed
塞门扎 | 西门扎 | semenza
沃拉思 | 沃尔拉思 | walrath
彼得龙 | 佩特龙 | petrone
格里桑蒂 | 格里桑迪 | grisanti
梅尔斯 | 马雷斯 | mares
庞蒂尼 | 庞特尼 | pounteney
阿奈林 | 阿内林 | aneirin
高利 | 高恩利 | gownley
劳本盖尔 | 劳本盖耶 | laubengayer
阿图鲁斯 | 阿图罗斯 | arturous
布兰肯巴克 | 布兰肯贝克 | blankenbaker
拉拉比 | 拉勒比 | larabee
埃斯卡迪里安 | 伊斯坎达里安 | eskandarian
贾洛伦西 | 贾洛伦齐 | giallorenzi
加杰 | 盖杰 | gager
查宁 | 查嫩 | chanen
贝松 | 贝森 | bessone
塞科夫斯基 | 赛科夫斯基 | saikowski
塞格雷夫 | 西格雷夫 | segrave
休伊尔 | 舍代尔 | suirdale
哈莫尔 | 哈默 | hamor
博索福思 | 博索姆沃思 | bosomworth
普普 | 普珀 | puppe
施米德 | 施密德 | schmid
塔默格尔 | 塔穆格尔 | tarmugl
黑尔 | 海尔 | haire
哈克威尔 | 黑克威尔 | hakewill
冈萨勒兹 | 冈萨雷斯 | gonzalez
莫纳 | 莫娜 | mona
格雷恩 | 格兰妮 | grainne
兹瓦德林 | 兹沃德林 | zwerdling
布拉德特里特 | 布拉德斯特里特 | bradstreet
麦克斯托菲 | 麦克斯蒂奥芬 | macstiofain
夏米恩 | 希米恩 | shimeon
亚里莫维奇 | 雅里莫维奇 | yarymovych
塞尼奥尔 | 西尼尔 | senior
哈特赛德 | 哈齐德 | hartsid
博伊斯拉根 | 博勒根 | boisragon
雷伯特 | 雷巴特 | rebut
梅特罗普利斯 | 梅特罗波利斯 | metropolis
索热 | 索热尔 | saussure
科克森 | 考克森 | coxon
斯克鲁托托 | 斯克鲁泰特 | scrutator
格里泽 | 格赖泽 | griser
普雷斯托菲诺 | 普雷斯托皮诺 | prestopino
贝拉尼娅 | 贝拉尼亚 | berania
戈尔兹蒙 | 戈德西蒙 | goldsymon
许伊尔茨 | 许霍尔茨 | schuerholz
科尔希普 | 科尔黑普 | kohlhepp
鲁科科 | 罗科 | ruocco
鲍尔施凯勒 | 巴尔德施维勒 | baldeschwieler
斯洛尼姆 | 斯洛宁 | slonim
马撒 | 玛莎 | martha
卡斯特莱恩 | 卡斯特兰 | castellain
珀塞克 | 佩塞克 | perseck
维伦 | 瓦伊伦 | viron
索尔茨 | 肖尔茨 | soults
乔西亚斯 | 乔赛亚斯 | josias
杰罗 | 杰罗尔德 | gerould
耶尔 | 耶格 | jaegher
赫雷肖夫 | 赫雷斯霍夫 | herreshoff
加弗 | 盖弗 | gaver
皮普 | 派普 | pipe
麦克马廷 | 麦克马丁 | macmartin
柯兰 | 柯伦 | curran
瓦伦苏拉 | 巴伦苏埃拉 | valenzuela
阿格沃 | 阿古 | agwu
弗拉克斯 | 弗勒克斯 | flux
康斯利 | 库斯利 | cousley
阿达夫南 | 阿达姆南 | adamnan
林恩 | 林 | linn
里查德 | 理查德 | richard
罗伯森 | 罗伯逊 | robertson
达肯 | 达坎 | dakan
吉茨沙姆 | 吉彻姆 | gitsham
利夫约克 | 莱夫奥克 | liveoak
范德霍夫 | 范德胡夫 | vanderhoof
普鲁斯曼 | 普拉斯曼 | prusman
基弗 | 凯弗 | keifer
吉安 | 吉亨 | gehan
施努肯 | 施努克内 | schnukne
阿戈尔 | 阿高尔 | argall
温纳斯特拉姆 | 温纳斯特鲁姆 | wennerstrum
伦德尔 | 伦达尔 | lundahl
利德克 | 利迪克 | luedecke
普伦内克 | 普伦尼克 | pluenneke
贝拉德 | 贝拉尔 | berard
马尔文农 | 马尔韦农 | mulvenon
巴特伦 | 巴特拉姆 | battram
麦吉顿 | 麦金蒂 | mcguinty
皮珀 | 派珀 | piper
卡莉什 | 卡利什 | kalish
埃冯代尔 | 埃文代尔 | avondale
格丽索戈尼亚 | 格丽索戈尼娅 | grisogonia
德保 | 德波 | depauw
格劳尔 | 格罗尔 | grower
豪瑟姆 | 豪萨姆 | howsam
德沃尔金 | 德沃金 | dworkin
阿特尔西 | 阿特莱西 | attlesey
加杰宾 | 加涅班 | gagnebin
阿克雷斯 | 阿克斯 | acres
布莱克施米特 | 布莱希施米特 | blechschmidt
赫维茨 | 赫威茨 | herwitz
梅恩斯 | 梅因斯 | mains
克兰德 | 克兰 | kland
布卢克 | 布劳克 | blouke
梅明格 | 梅明杰 | memminger
德莱斯克 | 德赖斯克 | dreiske
费布里斯 | 法布里斯 | fabris
普赖尔 | 普里尔 | preil
贝鲁克 | 贝尤克 | bayuk
奎伦 | 奎林 | quillen
贝思 | 贝丝 | beth
比尔霍尔特 | 伯霍尔特 | byrholdt
普罗文舍 | 普罗文彻 | provencher
约约尔 | 约埃 | yohe
耶特伦 | 亚特隆 | yatron
格沃托斯基 | 格瓦尔托夫斯基 | gewartowski
布思利 | 布思莱 | buthlay
赖鲁塔 | 里乌塔 | riutta
普伦蒂 | 普朗蒂 | prunty
维西 | 维齐 | veysey
巴斯曼 | 贝斯曼 | baseman
沃斯塔克拉夫特 | 沃斯通克拉夫特 | wollstonecraft
法夫罗特 | 法夫罗 | favrot
阿曼 | 阿尔曼 | arman
阿米欧 | 阿米奥特 | amiot
阿德尼 | 埃德尼 | adney
莫勒诺尔 | 莫勒瑙尔 | mollenauer
芬维西 | 芬韦西 | fenvessy
帕奇 | 帕克 | pach
盖尔德 | 格尔德 | gelder
于里安 | 尤里安 | urien
佩皮厄特 | 佩皮奥特 | pepiot
巴查尔 | 巴卡尔 | bachar
奥尔博 | 阿尔博 | allbaugh
盖米特 | 加梅特 | gamet
雷蒂 | 雷图 | rettew
德利吉吉斯 | 德利乔治斯 | deligiorgis
加雷尔 | 加勒尔 | garel
欧尔 | 奥利 | ole
巴德威恩 | 布德温 | budwine
迪奥 | 戴奥 | dio
布罗尔希 | 布勒尔施 | broelsch
塞维尔 | 萨维尔 | savele
莱维 | 利维 | levie
格朗基 | 格朗茨基 | groncki
加孔 | 加肯 | garcon
埃布 | 厄布 | erbe
沃米利 | 沃姆利 | wormeley
达姆里希 | 德姆里克 | daemmrich
斯考尔德 | 斯科德勒 | scholderer
杜比 | 达比 | duby
贝尔比 | 比尔比 | beilby
博斯金德 | 博斯坎德 | boskind
阿妮斯 | 安妮斯 | anis
阿布林 | 埃布林 | ablin
班德 | 班德尔 | bander
罗索尔 | 罗塞尔 | rossall
谢德 | 沙德 | shad
埃奇逊 | 艾奇逊 | etcheson
福塞特 | 福西特 | fawssett
莫菲 | 莫夫 | maufe
梅维蒂 | 马维蒂 | mavity
吉尔德福德 | 吉尔福德 | guildford
阿加斯 | 阿加丝 | agase
阿提亚 | 阿提耶 | atiyeh
伦芬特 | 朗方 | lenfant
尤夫罗辛 | 尤弗罗西尼 | euphrosyne
艾亚拉 | 阿亚拉 | ayala
彼得里兹 | 佩特里迪斯 | petrides
戴文 | 达文 | davern
罗莎恩 | 罗珊 | rozanne
格里豪 | 格里诺 | greenhow
格利摩 | 格利穆尔 | glymour
埃莱娜 | 埃琳娜 | elena
杜尤 | 杜韦 | duwe
布雷德 | 布里德 | breder
麦加恩 | 麦加亨 | mcgahern
勒本 | 莱班 | leban
穆拉尔特 | 缪拉尔持 | muralt
巴克韦尔 | 贝克韦尔 | bakewell
萨洛梅 | 萨洛米 | salome
玛丽萨 | 马里萨 | marisa
克鲁什 | 克鲁伊什 | kerruish
鲍廷豪斯 | 博尔廷豪斯 | boultinghouse
尤金尼亚 | 尤金妮亚 | eugenia
梅德瓦夫斯基 | 梅德瓦多夫斯基 | medwadowski
希厄特 | 海厄特 | hieatt
科德尔 | 科格德尔 | cogdell
惠奇利夫 | 惠特克利夫 | whitchliffe
卡利尔 | 卡莱尔 | carlisle
怀森 | 威森 | wison
德彻特 | 德克特 | dechert
弗伊尔 | 福伊尔 | feuer
洛芙登 | 洛夫登 | loveden
德韦尼 | 迪夫尼 | deveney
海姆索思 | 海姆塞特 | heimsoth
盖斯特菲尔德 | 盖斯特费尔德 | geistfeld
塔利亚罗罗 | 托利弗 | taliaferro
蒂特勒 | 泰特勒 | tytler
埃博罗尔 | 埃博拉尔 | eborall
莱塞特 | 莱西特 | lycett
莱根 | 利根 | lygon
奥莱克西 | 奥莱克休 | oleksiw
萨尔温 | 西尔温 | sulwen
谢德尔 | 沙德尔 | shadel
法迪安 | 法迪恩 | fadyean
伯克隆 | 伯克伦 | berklund
德雷南 | 德雷宁 | drennen
德彻 | 德谢尔 | decher
巴特伦 | 巴特拉姆 | buttram
麦库尔 | 麦考尔 | mackoul
特鲁齐 | 特拉齐 | truzzi
阿布迪安 | 阿布迪恩 | abdian
蒙特梅莫洛 | 蒙特莫雷诺 | montemoreno
托里 | 托丽 | tori
卡里洛 | 卡里略 | carrillo
马西纳 | 马塞纳 | marthena
凯莉 | 卡利 | cali
