拉帕迪兹 | 拉帕迪斯 | lapadis
布雷金里奇 | 布雷肯里奇 | breckinridge
锡德 | 切德 | cedd
马莉 | 马利 | maly
阿西尼加 | 阿西涅加 | arciniega
斯特拉撒恩 | 斯特拉森 | strathearn
皮内 | 皮奈 | pinay
梅雷斯曼 | 米尔斯曼 | meresman
弗兰宗 | 弗兰曾 | franzon
伊兹比基 | 伊兹比茨基 | izbicky
伊卡维斯特 | 埃沙韦斯特 | echaveste
费尔伯恩 | 费尔贝恩 | fairbairn
舒普 | 肖普 | shoupp
普恩 | 普汉 | puhan
曼斯巴克 | 蒙斯巴克 | maunsbach
沃塞尔 | 瓦塞尔 | wassell
西金特 | 萨金特 | seargent
亨巴克 | 亨巴赫 | heimbach
基布勒 | 库布勒 | kuebler
纳尔迪 | 纳迪 | nardi
杰米马 | 杰迈玛 | jemima
莫杜瓦 | 莫德维 | mauduit
惠塔克 | 惠特克 | whitacre
艾特 | 艾厄特 | eyet
厄德利 | 亚德利 | yeardley
欣奇利夫 | 欣奇克利夫 | hinchcliffe
博比 | 鲍比 | bobbie
哈布雷恩 | 哈布伦 | harberen
麦基尔文娜 | 麦基尔温纳 | macilvenna
莱因斯 | 赖恩斯 | rines
麦克费伦 | 麦克弗伦 | mcpherren
博策尔 | 博索尔 | botsal
科勒伦 | 科尔雷因 | coleraine
科克拉姆 | 科克勒姆 | cockrum
瓦格尼 | 韦恩 | wagne
多特曼 | 多伊特曼 | deutermann
埃德曼 | 厄尔德曼 | erdman
戈伦布贝斯基 | 戈伦别夫斯基 | golembiewski
格雷戈伊尔 | 格雷瓜尔 | gregoire
米卡贾 | 迈凯亚 | micajah
莱德洛 | 莱德劳 | laidlaw
科姆萨罗夫 | 科梅萨罗夫 | komesaroff
雷梅克斯 | 拉马克斯 | raemakers
皮凯弗 | 皮卡弗 | piccaver
苏布林 | 萨布林 | subrin
津嫩 | 津宁 | zinnen
费登 | 法登 | faden
布盖兹 | 布尔盖兹 | bourgaize
佩莱蒂尔 | 佩尔蒂埃 | pelletier
帕塞尔 | 帕斯尔 | parcel
霍诺里 | 霍诺丽 | honori
艾梅希 | 伊梅施 | imesch
西明顿 | 赛明顿 | symington
卡利本 | 卡利班 | caliban
马霍尔特 | 玛奥 | mahault
罗萨斯 | 罗扎斯 | rozas
沃伊蒂克 | 沃伊蒂奇 | woytych
韦克特尔 | 瓦赫特尔 | wachtel
夏弗尔 | 希维尔 | shivell
马基宁 | 马基嫩 | makinen
拉胡斯 | 拉雪兹 | lachaise
麦科瑙希 | 麦康瑙希 | mcconaughy
格肯斯 | 格尔肯斯 | gehrkens
达维格多 | 达维多尔 | d'avigdor
玛吉 | 马吉 | magi
曼纳韦 | 马纳韦 | mannaway
迈恩 | 米恩 | meighen
伊兹德 | 伊佐德 | izod
图马 | 托伊马 | teuma
奥赫 | 奥 | ough
阿福蒂特 | 阿富尔蒂特 | affourtit
米塞尔 | 米赛尔 | misael
赫默里赫 | 亨默里克 | hemmerich
詹宁斯 | 杰宁斯 | jenyns
斯塔姆斯 | 斯泰姆斯 | stames
博巴克 | 博哈克 | bohac
比布 | 毕比 | beebe
巴尔默 | 布尔默 | bulmer
考尔德尔 | 考德尔 | caldell
博查特 | 博哈特 | borchardt
卡明 | 卡迈恩 | carmine
巴特伦 | 巴特拉姆 | bartram
派尔 | 皮尔 | peile
麦康 | 麦肯 | mccon
舒克伯格 | 舒克伯勒 | schuckburgh
麦卡里 | 麦凯里 | mccarey
布罗克 | 布勒克 | broecker
凯利奥 | 卡利奥 | calio
英芬特 | 因方特 | infant
卡勒 | 卡尔 | karrh
亨内肯斯 | 亨尼肯斯 | hennekens
杰弗 | 贾埃弗 | giaever
贾米 | 杰米 | jamie
鲍尔霍恩 | 巴尔霍恩 | ballhorn
斯特吉斯 | 斯特奇斯 | sturges
莫克萨姆 | 莫克塞姆 | moxam
米德尔伯什 | 米德尔布什 | middlebush
多 | 道 | daw
阿什多恩 | 阿什当 | ashdown
卡姆 | 卡尔姆 | culme
夏尔曼 | 沙伊尔曼 | shireman
梅索利 | 梅索伊 | meszoly
格尔德 | 盖尔德 | geld
埃森斯 | 埃森丝 | essence
格韦思迈 | 格瓦思米 | gwathmey
巴比罗利 | 巴尔比罗利 | barbirolli
利布比 | 利比 | luebbe
黑泽尔 | 黑兹尔 | hazell
阿什林 | 阿什琳 | ashlyn
施蒂宁 | 斯蒂宁 | stiening
克莱农 | 克勒农 | clernon
金德雷德 | 金德里德 | kindred
德鲁夫 | 德鲁伊夫 | druiff
努索尔 | 纳托尔 | nuthall
戴格 | 戴伊 | daigh
埃坦 | 埃泰恩 | etain
勒罗伊德 | 利罗伊德 | learoyd
德尔丽戈 | 德尔列戈 | delriego
巴策 | 巴策尔 | batzer
廷肯 | 廷康 | tinkon
德弗拉特斯 | 迪弗雷特斯 | defrates
尤拉姆 | 乌拉姆 | ulam
达劳 | 达罗 | darraugh
米恩斯 | 默恩斯 | mearns
拜耶勒姆 | 拜勒姆 | byerrum
格罗布 | 格罗比 | grobe
塔塔利诺 | 塔尔塔利诺 | tartaglino
亚历山大 | 达历山大 | d'alexander
兰姆 | 拉姆 | lambe
西迪克 | 塞迪克 | seddik
卡德韦尔 | 考德威尔 | caldwell
希利 | 赫利 | helie
坎特伯里 | 坎特伯雷 | canterbury
塔肯 | 泰肯 | tacon
基尔施 | 基尔希 | kirsch
古特穆特 | 古特穆思 | gutermuth
托皮 | 托毕 | torpey
马戈林 | 马乔林 | marjolin
洛多维克 | 洛多威克 | lodowicke
梅拉尼 | 梅拉妮 | melanie
泰奇曼 | 泰克曼 | teichmann
普鲁德姆 | 普鲁多姆 | prudhomme
坎比 | 坎贝 | cumbey
赫姆尔 | 赫姆利 | hermle
弗罗梅泰尔 | 弗罗曼蒂尔 | fromanteel
蒙冈 | 蒙贡 | mongon
蒂特尔 | 泰特尔 | tytell
亨佩尔 | 亨普尔 | hempel
艾罗 | 艾罗尔特 | ayrault
里亚 | 雷 | rea
富加特 | 富盖特 | fugate
德卢伊吉 | 德路易吉 | deluigi
科彻雷斯 | 科克里斯 | cocheres
霍斯伯格 | 霍斯伯勒 | horsburgh
鲁亚 | 鲁阿兹 | ruadh
格雷思黑德 | 格雷特黑德 | greathead
马尔特比 | 莫尔特比 | maltby
埃塞蕾达 | 埃塞丽达 | ethelreda
默切斯顿 | 默奇斯顿 | merchiston
迪娜 | 迪恩纳 | dienna
博里尔 | 博雷尔 | boreel
布雷洪 | 布里恩 | brehon
吉尔 | 圭尔 | guire
厄丘克 | 尤尔丘克 | yurchuck
坦尼肯 | 滕尼肯 | tennican
麦金蒂尔 | 麦金太尔 | mcintire
利文 | 莱文 | levene
克拉伦斯 | 克拉雷斯 | clares
朱林科 | 祖林科 | dzurinko
索茹纳 | 索杰纳 | sojourner
布鲁霍森 | 布鲁克豪森 | bruchhausen
克内尔 | 努贝尔 | knubel
卡诺肯 | 卡诺坎 | carnochan
吉尼诺 | 吉赫诺 | giheno
罗克辛 | 罗克西娜 | roxinne
伦斯莱尔 | 伦塞勒 | rensselaer
萨尼普 | 萨格尼普 | sagnip
詹米森 | 詹姆森 | jameson
比哈里尔 | 贝哈里尔 | beharriell
朗坎普 | 朗香 | longchamp
贝德纳斯基 | 贝德纳尔斯基 | bednarski
舒尔金德 | 舒尔坎德 | schulkind
伯勒德 | 伯拉德 | burrard
赫勒韦尔 | 赫拉韦尔 | hellawell
威尔怀特 | 威尔海特 | willhite
洛伦兹 | 洛伦茨 | lorenz
勒夫特 | 卢夫特 | looft
特波尔 | 蒂普尔 | tepoel
吉莫 | 贾伊莫 | giaimo
库尔贾安 | 库尔金 | kuljian
哈米利恩 | 哈米里恩 | hamilyon
利恩娜 | 利安娜 | leanne
特比特 | 特贝特 | turbett
纽布朗奇 | 纽布兰奇 | newbranch
里索诺沃 | 里曾诺弗 | reasonover
查肯 | 查康 | chacon
雷布萨曼 | 里布萨门 | rebsamen
托菲琴 | 托菲肯 | torphichen
布利克肯斯特 | 布利肯斯德弗 | blickensderfer
斯卡尔特 | 斯卡尔普特 | sculpt
哈鲁普 | 哈勒普 | harrup
戈萨尔斯 | 戈瑟尔斯 | goethals
瓜尔蒂里 | 瓜尔蒂耶里 | gualtieri
泽兰 | 齐伦 | zeran
比贝尔 | 比布尔 | biebel
奥尔德斯蒂尔 | 奥尔德斯泰尔 | oldstyle
西门斯 | 西门子 | siemens
普莱本 | 普利邦 | plybon
佩伊夫 | 帕耶夫 | payeff
斯温斯鲁德 | 斯温斯拉德 | swensrud
贝克纳 | 比克纳 | beichner
恩霍姆 | 恩格霍姆 | engholm
惠特洛 | 怀特洛 | whytlaw
迪厄斯 | 德瓦斯 | dewas
兰内伯格 | 兰恩伯格 | ranneberger
桑德威克 | 桑威克 | sandwick
威思 | 韦思 | wyeth
施魏歇尔德 | 施韦柴尔德 | schweichild
斯坦霍普 | 斯坦诺普 | stanhope
英沃尔兹塔德 | 英沃斯塔德 | ingvoldstad
森厄尔 | 桑戈尔 | senghor
布赖豪斯 | 布里格豪斯 | brighouse
杰斯蒙德 | 吉斯蒙德 | jismond
克伦巴哈尔 | 克伦巴尔 | krumbhaar
莫拉尔 | 莫勒 | morar
弗里利 | 弗赖利 | friley
赖兰斯 | 赖伦斯 | rylance
吉尔德利夫 | 吉尔德斯利夫 | gildersleeve
赫斯莱普 | 赫斯利普 | heslep
鲍托尔 | 鲍塔尔 | boutall
斯帕因 | 斯佩因 | spayin
马谢特 | 马希特 | mushet
杜切斯 | 达切斯 | dutchess
布鲁姆利 | 布伦利 | brumley
明 | 米恩 | min
菲格雷斯 | 菲格斯 | figures
特库姆西 | 特库姆塞 | tecumseh
伊万杰莉塔 | 埃万杰利斯塔 | evangelista
韦布利 | 韦伯利 | webley
克勒格 | 克卢格 | kluger
帕门蒂尔 | 帕尔芒捷 | parmentier
迪杰格斯 | 迪安杰利斯 | deangelis
麦格拉斯里奇 | 麦格拉斯里克 | macglasrich
桑恩顿 | 桑顿 | thornton
芭布 | 巴布 | baab
巴洛克 | 巴洛赫 | balloch
彻内斯基 | 切尔涅斯基 | chernesky
贝利夫 | 贝尔维 | bellevue
西博恩 | 西伯恩 | seaborn
德尔钱 | 德尔尚 | delchamps
布劳恩 | 布朗 | braun
劳夫 | 豪夫 | hauf
特里利文 | 特里莱文 | treleaven
阿文特 | 埃文特 | avent
比斯内尔 | 比尤内尔 | buesnel
阿迪 | 埃迪 | adye
哈格迈耶 | 哈格迈尔 | hagemeyer
卡蒂亚 | 凯蒂娅 | katia
阿拉蒙 | 阿拉芒 | allamong
麦克布罗姆 | 麦克布鲁姆 | mcbroom
弗凯伊克 | 弗凯克 | verkaik
西米恩 | 西明 | siemien
罗万德 | 罗安德 | rowand
普里亚尔 | 普赖尔 | prial
布利萨克 | 布利萨茨 | blisac
马尼斯 | 马内斯 | maness
比兹 | 比德兹 | bidez
伊尔威尔 | 厄维尔 | irwil
威尔米特 | 薇尔梅特 | wilmett
尼迪 | 内迪 | neddy
霍米特 | 霍梅特 | homet
拉图里特 | 拉图雷特 | latourette
纳拉诺 | 纳兰霍 | naranjo
布雷兰 | 布里兰 | breland
卡尔 | 卡利 | karle
克勒菲尔德 | 克卢菲尔德 | klufeld
阿德莉娜 | 阿德利娜 | adelina
斯特尔特 | 斯泰尔特 | stelter
舒克伯格 | 沙克伯勒 | shuckburgh
特里菲斯 | 特里富西斯 | trefusis
亚历山登 | 亚历山德森 | alexanderson
科克伦 | 科克兰 | cockran
格尔 | 瓜尔 | guare
朱皮特 | 丘辟特 | jupiter
迪尤特里奇 | 多伊特里希 | deutrich
托厄里 | 托尔里 | towery
马德林 | 马德琳 | madlin
威舍 | 维舍 | wischer
卡基尔 | 卡利尔 | kalil
尚茨 | 肖恩茨 | shontz
戴加德 | 迪格 | dygard
巴利克 | 巴利奇 | balich
库比特 | 丘比特 | cubitt
福尔迪西 | 福尔德西 | foldessy
西克雷斯特 | 西克里斯特 | secrest
拉扎 | 拉扎尔 | lazar
佩茨 | 皮特斯 | petes
皮克斯 | 皮尔克斯 | pearkes
费尔哈文 | 费尔黑文 | fairhaven
齐斯洛夫 | 扎斯洛夫 | zaslove
特里德加 | 特里迪加 | tredegar
艾丽 | 阿利 | alli
阿蒂盖尔 | 阿蒂格尔 | attygalle
马西娅 | 玛西娅 | mathea
费布勒 | 法布勒 | fabler
格莱德 | 格利德 | gleed
彼得鲁斯卡 | 彼特鲁斯卡 | petruska
弗恩 | 维恩 | verne
尤迪切洛 | 尤迪塞洛 | iudicello
韦姆 | 瓦伊姆 | waim
鲁兰 | 鲁伦 | ruellan
拉哈布 | 雷哈布 | rahab
麦金纳尼 | 麦基纳尼 | macinerney
埃根 | 伊根 | egan
斯蒂格勒 | 施蒂格勒 | stigler
特威宁 | 特文宁 | twining
乌尔夫 | 厄尔夫 | ulph
迪达罗斯 | 西达劳斯 | sidarouss
弗洛韦韦 | 弗劳尔迪 | flowerdew
盖兰 | 格兰 | gellan
吉梅内斯 | 希门尼斯 | jimenez
普勒 | 普拉 | pullar
杜因特 | 德温特 | dewint
斯威特曼 | 斯韦特曼 | sweatman
范法森 | 范福森 | vanfossan
尼斯克恩 | 尼斯肯 | kniskern
布鲁因 | 布勒因 | bruyn
塔米黑尔 | 塔米希尔 | tamihere
库劳 | 库罗 | courau
迪米奥 | 迪梅奥 | dimeo
贝尼迪克斯 | 贝内迪克斯 | benedicus
拉弗莱希 | 拉弗莱什 | lafleche
麦格罗瑟 | 麦格鲁瑟 | macgreuther
柯尔蒂厄斯 | 柯特纽斯 | curtenius
阿斯威思 | 阿斯奎思 | asquith
赫利娜 | 赫莉娜 | helina
帕策尔 | 普策尔 | putzel
伊蒂拉格 | 伊泰拉格 | itteilag
斯特朗奇 | 斯特朗 | stronge
埃沃伊 | 伊沃伊 | evoy
迪伦福思 | 迪伦弗思 | dyhrenfurth
坦盖 | 坦圭 | tanguay
拉斯布里奇 | 拉斯布里杰 | rusbridger
波克 | 普克 | pook
杜布拉斯 | 杜布拉 | dubras
亚兹明 | 亚斯明 | yazmin
劳德代尔 | 劳德戴尔 | lauderdale
拉瑟姆 | 拉萨姆 | russum
伯贝奇 | 伯比奇 | burbage
巴多夫 | 巴特多夫 | batdorf
哈斯卢普 | 哈斯勒普 | haslup
泽纳 | 策纳 | zaehner
科尔尼特 | 科尔内特 | collnette
切斯托利尼 | 奇斯托利尼 | chistolini
波洛斯 | 普洛斯 | poulos
利万多 | 柳安多 | lewando
克莱恩 | 克莱因 | clyne
麦克沃尼什 | 麦克瓦尼什 | macvarnish
休林斯 | 赫林斯 | hulings
弗里岑 | 弗里曾 | fritzen
麦克米切尔 | 麦克迈克尔 | mcmichael
贝尔希 | 贝尔赫 | bailhe
斯科克罗夫特 | 斯考克罗夫特 | scowcroft
麦卡尔 | 麦考尔 | mackal
奥尔曼 | 阿利芒 | allemang
赛奇 | 赛什 | saich
旺因克 | 沃恩克 | warnke
皮奥托夫斯基 | 彼得罗夫斯基 | piotrowski
麦克尔赫尼 | 麦克尔哈尼 | mcelhaney
贾恩 | 扬 | jahn
康格尔顿 | 康高尔顿 | congalton
乌尔默 | 厄尔默 | ulmer
杜瓦克斯 | 杜阿克斯 | duax
戴森豪费尔 | 戴森霍弗 | deisenhofer
沙特克 | 沙滕柯克 | schattenkerk
格特纳 | 盖特纳 | gaertner
法隆 | 法伦 | falloon
克莱本 | 克莱伯恩 | clyburn
奥斯维 | 奥斯威尤 | oswiu
兰德维西 | 兰德沃西 | landwirthy
福曼内克 | 福马内克 | formanek
米隆 | 米伦 | millon
特特尔 | 瑟特尔 | thurtle
艾利 | 艾莉 | eily
埃克恩 | 伊肯 | ekern
菲利恩 | 菲利翁 | filion
斯派克 | 斯平克 | spink
苏沙 | 舒尚 | shooshan
莫普斯 | 莫皮斯 | moppes
帕塞尔 | 帕斯尔 | parcell
泰博尔特 | 蒂博尔特 | tybalt
索尔 | 苏尔 | soul
德代奥 | 戴德奥 | dedeo
麦克雷思 | 麦克勒思 | mackereth
博尼霍迪 | 博尼哈迪 | bonyhadi
奥瑟 | 奥泽 | orser
帕珀马斯特 | 佩珀马斯特 | papermaster
贝伦德斯 | 贝伦兹 | berendes
埃拉齐姆 | 伊拉齐姆 | erazim
施雷德 | 施拉德 | schrade
切斯特 | 奇斯特 | chiste
安格尔 | 安杰尔 | angel
斯潘金 | 斯庞金 | spungin
巴索尔森 | 巴托尔松 | bartholdson
麦克斯波兰 | 麦克斯波伦 | macsporran
钱努廷 | 查纽廷 | chanutin
埃塞克 | 伊塞克 | esek
梅尔霍费尔 | 迈尔霍费尔 | maierhofer
德普勒格 | 德普卢格 | derploog
唐勒维 | 唐拉维 | donlavey
弗赖海伊特 | 弗赖海特 | freiheit
马伦普尔 | 马伦普雷 | malempre
斯拉克 | 斯莱克 | slack
多奇 | 德奇 | doetsch
阿雷顿 | 阿里顿 | arreton
比哈 | 贝亚 | beha
法尔布朗斯 | 法尔布兰斯 | firebrance
安嫩贝格 | 安嫩伯格 | annenberg
博尔多 | 波尔多 | bordeaux
德西德里厄斯 | 德西迪里厄斯 | desiderius
塔尔戈特 | 索尔戈特 | thalgott
卡特 | 柯特 | curt
切尔基安 | 彻克齐安 | cherkezian
舍恩巴克 | 舍恩巴赫 | schoenbach
马尼尔 | 马尼耶 | magnier
奥特林查姆 | 奥特林厄姆 | altrincham
艾尔纳姆 | 埃努姆 | aernum
麦基尔维 | 麦基雷维 | macilrevie
艾兴格林 | 艾肯格林 | eichengreen
莱夫勒 | 莱弗勒 | leffler
拉文 | 雷文 | raven
黑文纳 | 哈文纳 | havenner
多尔兹 | 德尔兹 | doelz
莫布斯比 | 莫布兹比 | mobsby
南迪 | 农迪 | nundy
阿奎约 | 阿夸约 | aquayo
赛兹 | 赛斯 | sise
弗雷林厄森 | 弗里林海森 | frelinghuysen
麦克鲁登 | 麦克拉登 | mccrudden
帕杰利斯 | 帕盖利斯 | pargellis
莱波尔 | 勒普尔 | lepoer
布雷斯洛夫斯基 | 布雷斯拉夫斯基 | breslawsky
博尼法修斯 | 博尼费修斯 | bonifacius
达夫内 | 达夫妮 | daphne
恩德烈尼 | 恩德雷尼 | endrenyi
斯基勒 | 斯凯勒 | skyler
麦康奇 | 麦康希 | macconchy
桑德姆 | 桑达姆 | sandham
里穆斯基 | 里莫斯基 | rimouski
马宁 | 曼宁 | maning
布莱赫特 | 布拉胡特 | blachut
赫明 | 亨明 | hemming
特文加登姆 | 蒂文加杜姆 | tirvengadum
卡尔斯密斯 | 卡尔史密斯 | carlsmith
马米 | 玛米 | mami
吉内罗 | 吉尼罗 | genero
比斯特 | 比伊斯特 | buist
拉雷莫尔 | 拉腊莫尔 | laramore
德里南 | 德赖南 | drynan
福韦尔 | 福尔韦尔 | faulwell
哈克 | 黑克 | hake
哈沙根 | 哈舍根 | hashagen
拉尔斯 | 赖亚尔斯 | ryalls
特里梅因 | 特里曼 | tremain
梅伦 | 默龙 | merron
范德莱德 | 范德克利德 | vanderkleed
汉斯伯格 | 亨斯伯格 | hunsberger
格鲁科特 | 格劳科特 | groucott
鲁兹 | 吕埃 | ruez
拉德布罗克 | 拉德布鲁克 | ladbroke
奥斯莱格 | 奥恩斯莱格 | oenslager
哈加丁 | 哈格丁 | hargadine
利克姆 | 利克希姆 | leikhim
沃楚夫特 | 沃特沙夫特 | wirtschafter
艾默斯 | 伊穆斯 | imus
托奇 | 托克 | toch
德翁特 | 德温特 | dewenter
斯珀勒 | 施普勒 | spuhler
马诺赫 | 马诺克 | marnoch
弗莱布 | 弗莱比 | flebbe
汤布斯 | 图姆斯 | tombs
达夫隆 | 杜弗隆 | duflon
谢里克 | 谢雷克 | sherek
克里斯梅尼奇 | 克里斯马尼奇 | crismanich
贝恩 | 本 | benn
梅纳厄姆 | 梅纳汉 | menaham
麦基利肯 | 麦基利坎 | mackillican
多里 | 多丽 | dorrie
法努夫 | 法纳夫 | faneuf
韦克迈斯特 | 沃克迈斯特 | werkmeister
雷德斯克 | 拉德斯克 | radesk
罗赫 | 罗奇 | roch
鲍伯格 | 邦伯格 | baumberger
洛温克龙 | 洛温克伦 | lowenkron
多勒 | 多拉夫 | dorough
巴尔尼尔 | 巴尼尔 | balniel
菲林 | 法尔林 | firing
克莱姆 | 克莱米 | klemme
费尔 | 费雷 | ferre
安娜贝尔 | 安娜贝勒 | annabelle
布伊文 | 博伊文 | boivin
福伊西 | 福西 | feusi
江伯格 | 宗伯格 | zumberg
萨加 | 塞格尔 | sagar
恩格兰 | 英格兰 | england
努特 | 纽特 | newt
林克 | 伦克 | renk
齐洛森 | 西劳森 | cilawson
阿布 | 阿贝 | abbe
布伊森顿 | 博伊斯方丹 | boisfontaine
麦卡赫蒂 | 麦克哈蒂 | mccahearty
麦克门 | 麦克蒙 | mcmunn
塞弗里 | 萨弗里 | savery
布赖滕菲尔德 | 布赖滕费尔德 | breitenfeld
韦斯特摩伦 | 威斯特摩兰 | westmoreland
伯格哈德 | 伯格哈特 | burghard
厄尔普 | 厄普 | earp
蒙多尔 | 蒙多 | mondor
格尔泽 | 盖尔泽 | gelzer
施赖纳 | 施里纳 | shriner
弗皮利 | 韦皮勒 | verpilleux
布罗克特 | 布勒克特 | broekert
汤南德 | 汤恩德 | townend
伊内斯 | 伊内兹 | inez
杰彭 | 杰波恩 | jepoen
伯肯霍尔茨 | 伯肯霍尔兹 | birkenholtz
勒克特 | 勒基特 | luckett
斯珀 | 斯珀尔 | spurr
埃德 | 伊德尔 | eader
艾韦茨 | 艾维茨 | ivetts
维诺格拉德 | 维诺格勒 | vinograd
安纳莫尔 | 安纳克莫尔 | annaghmore
斯塔德曼 | 斯蒂德曼 | studeman
勒利恩 | 勒林 | lelean
布里森 | 布赖森 | bridson
蒂林赫斯特 | 蒂林哈斯特 | tillinghast
扎克利 | 朱克利 | zuckley
达里夫 | 达雷夫 | dareff
佩里斯廷 | 皮里斯坦 | pearistine
纳尔米 | 纳米 | narmi
拉尚 | 拉申 | raschen
克劳肯登 | 克鲁肯登 | crookenden
马达维奇 | 马达维赫 | mhadavikh
伊尔格弗里茨 | 伊尔根弗里茨 | ilgenfritz
杜拉克 | 杜拉奇 | dullach
肖尔德 | 索尔德 | szold
杜普卡克 | 杜普恰克 | dupcak
布雷登 | 布拉顿 | bradon
贝姆 | 巴姆 | bame
普利马尔 | 普莱梅尔 | plymale
布罗梅特 | 布罗米特 | bromet
阿奇巴尔 | 阿查巴尔 | archabal
惠特伯格 | 惠特伯勒 | whitburgh
西比尔 | 塞比尔 | sebire
佩蒂波尔 | 佩蒂普尔 | pettypool
普伊勒 | 法伊勒 | pfeiler
菲希特 | 菲克特 | fiechter
霍莫尔卡 | 霍穆尔卡 | homolka
海斯伯格 | 海斯堡 | heisborg
费尔德布里尔 | 费德布里尔 | feldbrill
格农 | 热农 | gernon
斯滕特 | 斯坦特 | stunt
法布里西奥 | 法布里齐奥 | fabrizio
埃莉斯 | 埃莉丝 | elyse
伦格利 | 伦利 | lungley
克勒勒 | 克雷勒 | kroehler
凯米宁 | 切米宁特 | cheminint
德贝 | 德本 | deben
阿尔曼 | 奥尔曼 | alman
克赖扎 | 克里扎 | kryza
塞德 | 森德 | sender
法斯纳赫特 | 法斯纳克特 | fasnacht
赫尔姆霍特 | 赫尔姆霍尔特 | helmholdt
布根 | 巴根 | bugan
佩奇 | 皮奇 | pechey
施万姆 | 施万布 | schwamb
麦克米切尔 | 麦克迈克尔 | macmichael
奥里 | 奥赖 | ory
艾尔弗里克 | 阿尔弗里克 | aelfric
艾尔加 | 艾尔格 | eylgar
索纳曼 | 索恩曼 | sonnemann
奥扎妮 | 奥赞 | ozanne
沙普尔斯 | 沙普利斯 | sharpless
达安 | 德哈恩 | dehaan
雷诺 | 雷纳 | raynor
贝克哈特 | 贝克哈德 | beckhard
松塔格 | 桑塔格 | sontag
麦克尔霍农 | 麦克尔哈农 | mcelhanon
梅赞 | 马赞 | mazan
沃尔德迪雷夫 | 沃尔德格雷夫 | waldegrave
阿维洛 | 阿韦洛 | arvelo
塔利奥 | 图利奥 | tullio
麦康 | 梅肯 | macon
德拉丰斯 | 德拉方斯 | delafons
赫费特 | 赫弗特 | herfurt
古德里 | 格德里 | guedry
戴维 | 达维 | davee
戈希 | 戈伊 | gohey
克莱弗 | 克拉弗 | claver
桑萨姆 | 桑森 | sansum
吉吉 | 吉盖 | giggey
达科姆 | 戴科姆 | dacombe
邦廷 | 邦坦 | bontein
多本 | 多宾 | doben
阿尔肯 | 阿夫肯 | arfken
麦克尼尼尼 | 麦克尼尼 | mceneaney
泰恩什 | 坦什 | tainsh
克雷斯皮吉 | 克雷皮尼 | crespigny
马夸里 | 麦夸里 | maquarie
比尔基 | 伯基 | buerki
斯韦兹 | 斯沃德什 | swadesh
巴贝尔 | 贝布尔 | babell
克拉丽达 | 克拉里达 | clarida
博德温恩 | 博德瓦恩 | bordwine
布朗塔斯 | 布龙塔斯 | brountas
麦康姆 | 麦库姆 | mccombe
德雷沃戈拉 | 德沃尔吉拉 | drevorguilla
伊斯特尔 | 伊斯蒂尔 | easteal
奥弗拉哈蒂 | 奥弗莱厄蒂 | o'flahertie
塞维 | 西维 | sevey
鲍厄 | 鲍尔 | bouwer
博克尔 | 博克 | boker
埃申 | 埃舒 | eshoo
马金库斯 | 马辛克斯 | marcinkus
佩雷兹 | 佩雷斯 | perez
维泽 | 维佐尔 | vizor
蒂利 | 蒂莉 | tillie
赖格 | 里格 | riger
怀斯曼 | 威斯曼 | wieseman
艾利森 | 艾莉森 | alyson
德雷塞尔 | 德雷斯尔 | dressel
朱利 | 朱莉 | julie
埃格利 | 埃奇利 | edgley
丹尼恩 | 达尼恩 | danyon
欣克 | 舍克 | shirk
马休伦 | 马胡兰 | mahuran
佩耶 | 派尔 | peyer
波兰 | 普兰 | poulain
齐 | 切赫 | czeh
西尔瓦纳斯 | 西尔维纳斯 | silvanus
埃克斯坦斯 | 埃克斯滕斯 | exstance
艾恩斯 | 安斯 | aines
普萨特里 | 普萨泰里 | pusateri
尼恩 | 奈恩 | nyhen
阿拉第厄斯 | 阿拉迪厄斯 | aradius
瓦基特 | 瓦克特 | wackett
阿格内洛 | 阿涅洛 | agnello
格拉齐亚代奥 | 格拉齐亚迪奥 | graziadio
伊莱 | 艾莱 | ilay
纳锡 | 纳休 | nathiew
休达克 | 赫达克 | hudak
斯蒂格利茨 | 施蒂格利茨 | stiglitz
塞西利厄斯 | 塞西莉厄斯 | cecilius
温纳科特 | 旺纳科特 | wonnacott
哈姆斯 | 黑姆斯 | hammes
雷贝尔 | 里贝尔 | rebel
查格尔斯 | 查格利斯 | chagles
麦凯克森 | 麦凯琴 | maceachen
加南吉安 | 加南吉扬 | ganangiyan
辛特 | 廷特 | tynte
古拉德 | 戈拉德 | goulard
迪特斯 | 戴特斯 | deiters
格罗杰 | 格罗格 | grogger
布里斯 | 布赖斯 | brise
洛林达 | 洛琳达 | lorinda
怀特利瑟 | 怀特莱瑟 | whiteleather
埃夫勒 | 埃弗勒 | effler
惠特切特 | 惠特西特 | whitsett
明图恩 | 明特恩 | minturn
赫德克 | 赫德基 | hedke
勒克龙 | 莱克龙 | leckrone
布雷斯纳安 | 布雷斯纳汉 | bresnahan
波 | 鲍 | pow
拉克索尔 | 拉克斯尔 | wraxhall
曼柳斯 | 曼利厄斯 | manlius
莱托克 | 勒托克 | letocq
谢拉格 | 希拉 | shelagh
内格尔 | 尼格尔 | negel
巴吉特 | 巴杰特 | bardgett
乔弗里翁 | 乔夫里翁 | joffrion
伯恩 | 贝尼 | boehne
格鲁尔 | 格劳尔 | grouer
德沃拉克 | 德沃夏克 | dvorak
贝纳维迪斯 | 贝纳维兹 | benavides
梅耶斯 | 梅杰斯 | majors
福伊尔克 | 福伊尔沃克 | feuerwerker
塔吉 | 塔姬 | taggy
麦科克 | 麦科奇 | mccoch
泰默韦尔 | 泰姆韦尔 | timewell
巴克纳 | 巴赫纳 | bachner
图德霍 | 塔杜 | tudhoe
蒂格雷特 | 泰格雷特 | tigrett
埃金 | 伊金 | eking
纳蒂 | 克努蒂 | knutti
凯嫩 | 凯南 | kainen
德普特克 | 德普塔克 | deptuck
迪特 | 迪特尔 | dieter
莱 | 利 | ley
格尔 | 吉尔 | gehl
唐纳姆 | 多纳姆 | donham
莱德福 | 利德福德 | lydford
菲恩 | 费恩 | feane
科奈因 | 科奈恩 | conein
朗莱因 | 朗莱恩 | longhlein
德克兰斯基 | 德克林斯基 | deklinski
埃勒斯 | 埃利斯 | elles
沃拉克 | 沃勒克 | wallack
卡尼尔尼 | 卡奈尔尼 | carnearney
坦嫩鲍姆 | 特南鲍姆 | tennenbaum
霍甘 | 霍根 | hodgan
卡基亚 | 卡夏 | cachia
莫森 | 莫桑 | morsan
阿格里斯 | 阿吉里斯 | argeris
明内特 | 明妮特 | minnette
雷霍尔 | 雷哈尔 | rehal
安斯帕彻 | 安斯帕赫尔 | anspacher
贾西诺夫斯基 | 贾西诺斯基 | jasinowski
克雷弗 | 克里弗 | crever
沃尔休夫 | 瓦尔塞奥夫 | waltheof
拉帕诺 | 拉普阿诺 | rapuano
托比特 | 托贝特 | torbett
奇弗斯 | 查弗斯 | chavers
安德雷斯 | 安德烈斯 | andress
埃尔斯皮 | 伊丽莎白 | elspie
哈根 | 黑根 | hagan
麦卡拉克 | 麦柯拉克 | maccurrach
凯特琳萨克 | 卡特林萨克 | katrinsak
托普尔 | 托佩尔 | topple
塔姆斯 | 泰晤士 | thames
肯奈尔德 | 肯奈德 | kennaird
勒克拉斯 | 勒克拉 | lecras
艾克纳 | 艾希纳 | eichner
费罗 | 费劳 | ferrao
奥弗拉蒂蒂 | 奥弗莱厄蒂 | o'flaherty
克雷恩 | 克林 | crean
萨马罗 | 萨马鲁 | samaroo
维伊塔 | 维尼塔 | vinita
卡赫特 | 卡彻特 | kachert
伯杰文 | 伯格文 | bergevin
珀克 | 珀基 | pyrke
鲍根 | 鲍恩 | baughan
罗维塔 | 罗韦塔 | rovetta
西森 | 特森 | thesen
吉尔德豪姆 | 吉尔多姆 | guildhaume
威尔科夫斯基 | 维尔科夫斯基 | wilkowski
法努伊尔 | 法纳尔 | faneuil
雷塔 | 里塔 | rheta
里查特 | 理查特 | richart
朗尼加尔 | 朗内加 | runnegar
安恩索尔兹 | 安索尔兹 | ahntholz
扬格尔 | 扬格 | younger
多尔杰 | 德尔格 | dolger
希尔斯密斯 | 希尔史密斯 | shearsmith
赫贝斯特里特 | 赫布斯特雷特 | herbestreit
沙克 | 舒克 | schuck
费齐卡斯 | 法泽卡斯 | fazekas
普莱斯顿 | 普利斯顿 | puleston
凯伦 | 克伦 | keren
鲍金 | 鲍德金 | baudkin
迪林 | 迪尔林 | deerlin
埃尔韦斯 | 埃尔威斯 | elwes
塔弗 | 塔沃尔 | tavor
韦赫尔 | 韦伊尔 | weiher
维特 | 维特尔 | vetter
赫米恩 | 赫米奥娜 | hermione
约翰森 | 约翰逊 | johnson
杭德里奇 | 杭德里克 | honderich
洛克林 | 劳克林 | laughlin
利伯廷 | 利伯蒂娜 | libertine
多尔佩齐 | 达莱佩泽 | dallepezze
赫夫特 | 胡夫特 | hooft
迈尔斯特拉普 | 迈尔斯特勒普 | meilstrup
兰塞莱特斯 | 朗斯利特斯 | launceletus
阿代奥 | 阿德奥 | addeo
布菲 | 巴菲 | buffey
科莫尼亚克 | 科莫尼亚雷克 | komoniarek
德拉吕 | 德拉鲁 | delarue
格恩斯巴克 | 根斯巴克 | gernsback
马兹洛夫 | 马兹卢夫 | marzluf
蒂托尔 | 蒂特 | teetor
维图凯蒂斯 | 韦图凯蒂斯 | vaitukaitis
比尔 | 伯尔 | birr
邓坎森 | 邓肯森 | duncanson
高迪安 | 高迪恩 | gaudian
迪尔 | 代尔 | diel
菲茨韦伦 | 菲茨沃伦 | fitzwarren
迪思里希 | 迪特里希 | diethrich
迪海 | 德海 | dehay
迈斯利希 | 迈斯利奇 | meislich
沃索 | 瓦索 | wasow
利昂季耶夫 | 列昂季耶夫 | leontiev
阿拉姆 | 奥勒姆 | allam
博迪科姆 | 博迪库姆 | bodycombe
伊森纳 | 艾泽努尔 | izenour
布尔 | 布雷 | buhre
特里里斯 | 特里赖斯 | trerise
帕尼特 | 帕内特 | panet
罗恩 | 龙尼 | ronne
平乔 | 平肖 | pinchot
范热 | 范格特 | fanget
斯蒂 | 斯图 | stew
伊尔格 | 伊尔克 | ilg
查森 | 蔡森 | chasen
科佩拉 | 科皮拉 | coppela
古拉奇安 | 朱拉布奇安 | joorabchian
斯拉特里 | 斯莱特里 | slattery
弗雷克洛 | 弗雷克尔顿 | freckleton
埃尔马思 | 厄马思 | earmarth
贝格尔曼 | 比格尔曼 | begelman
梅约 | 梅奥 | mayo
安蒂维尔 | 安特维尔 | antevil
达纳万特 | 杜纳万特 | dunavant
梅因多尔德 | 梅因唐纳德 | maindonald
麦卡勒里 | 麦卡利里 | mcalery
法拉达 | 法拉丹 | farradane
哈兹尔廷 | 黑兹尔坦 | hazeltine
斯莱茨 | 斯卢茨 | slutz
迈希尔 | 迈伊尔 | mighill
赫曼 | 希曼 | heman
布罗瑟 | 布拉泽 | brother
辛尼 | 锡恩 | thynne
弗里斯 | 弗里亚斯 | freas
布里安 | 布赖恩 | brian
勒顿德尔 | 勒滕德 | letendre
杰斯 | 杰西 | jesse
海恩特 | 海因特 | heinte
格温福弗 | 格温弗 | gwynfor
利夫斯丘 | 莱韦斯克 | levesque
奥德里 | 奥德丽 | audrey
约瓦诺维奇 | 约万诺维奇 | yovanovitch
皮伊什 | 皮尤什 | piyush
安德烈奥尔 | 安德里奥尔 | andriole
丹尼罗 | 达尼罗 | daniero
斯马比 | 斯梅比 | smaby
英奇凯因 | 英奇昆 | inchiquin
勒彭内克 | 勒佩内克 | lepennec
多嫩费尔德 | 多宁费尔德 | donenfeld
沃尔德雷普 | 沃尔德里普 | waldrep
德马西奥 | 德马肖 | demascio
穆科夫斯基 | 穆科斯基 | mukowski
泽谢拉 | 泽克拉 | zechella
卡莉 | 凯莉 | kallie
斯基特 | 斯卡特 | skate
麦吉尔福 | 麦吉尔伍尔 | macgillvoor
布格德 | 布古尔 | bougourd
塞文 | 西文 | sevin
欣恩 | 希恩 | shinn
波南佩勒马 | 庞南佩鲁马 | ponnamperuma
米曾 | 迈曾 | mizen
洛梅尔 | 隆梅尔 | lommel
马赫 | 马奇 | much
金尼弗 | 珍妮弗 | gennifer
查萨尼斯 | 沙萨涅 | chassagnes
厄尔利 | 厄利 | earley
艾尤托 | 阿尤托 | aiuto
布尔伍德 | 鲍赫鲁德 | boughrood
吉隆 | 吉伦 | gillon
道厄德 | 道尔德 | doward
贝尼诺夫 | 贝尼奥夫 | benioff
班恩哈特 | 巴恩哈特 | barnhardt
基尔里 | 基里 | kearey
韦克 | 瓦克尔 | wacker
路易佐 | 路易祖 | louizou
弗兰兹 | 弗朗兹 | franz
特里福尼斯 | 特里福尼迪斯 | trifonidis
米泽尔 | 米泽勒 | mizelle
托尔斯 | 托里斯 | torres
沃尔伯 | 沃莱本 | wohlleben
沃申科 | 瓦申科 | washenko
克罗普廷 | 克罗帕特金 | kropatkin
博尼特 | 博内特 | bonett
多伊施勒 | 多伊施尔 | deuschl
马克斯威尔 | 马克斯维尔 | maxvill
欧明杰 | 艾尔明格 | irminger
伊布斯利 | 耶布斯利 | yeabsley
阿伦 | 艾伦 | allen
布杰克 | 布亚克 | bujake
乔塔姆 | 乔撒姆 | jotham
加诺 | 加诺特 | garnaut
温彻西 | 温切尔西 | winchelsea
瓜卡斯 | 古奥卡斯 | guokas
德费 | 德菲 | durfee
汉德林克 | 杭德林克 | hondelink
克里维利 | 克里韦利 | crivelli
菲策尔温 | 菲茨艾尔温 | fitzailwyn
埃迪生 | 埃迪森 | eddison
加雷特 | 加勒特 | garret
登宁 | 丹宁 | denning
斯维里斯 | 斯威里斯 | sweeris
马杰 | 马季 | marj
布加斯 | 巴加斯 | bugas
埃奇达尔 | 埃奇代尔 | edgedal
凯 | 基 | key
林德斯滕 | 林斯滕 | lindsten
德克罗克 | 德克鲁克 | decroock
贝拉尔 | 伯罗尔 | berall
斯威特基 | 斯威凯 | switkay
道本斯佩克 | 多本斯佩克 | daubenspeck
索布洛夫 | 索贝洛夫 | sobeloff
麦卡利基 | 麦卡利克西 | mcaliksey
卡图 | 卡顿 | kartun
舍弗勒 | 肖夫勒 | schauffler
休利尔 | 特威利尔 | thuillier
戴亚曼特 | 迪亚曼特 | diamant
弗兰西斯科 | 弗朗西斯科 | francisco
德加拉比迪安 | 德加拉贝迪安 | dergarabedian
诺桑顿 | 诺桑普顿 | northampton
布罗亚斯 | 布罗斯 | broas
尼迪 | 内迪 | neddie
赫伦布兰德 | 海伦布兰德 | hellenbrand
厄布 | 厄尔布 | erb
鲍尔丹齐 | 巴尔丹齐 | baldanzi
西西 | 锡西 | cissie
莱兰 | 利兰 | lelland
希瓦特罗 | 奇瓦特罗 | chivatero
温泽尔 | 温策尔 | wenzel
巴蒙特 | 贝蒙特 | bamont
奥尔德海泽 | 奥尔迪泽 | aldhizer
卡洛格罗 | 卡洛杰罗 | calogero
麦利纳奇克 | 姆利纳奇克 | mlinarchik
德尔 | 杜尔 | durr
米齐 | 梅齐 | meazey
普拉芬 | 普拉欣 | prahin
迪伦福思 | 迪伦弗思 | dhyrenfurth
扎尔米 | 扎尔梅 | zalmay
扬克威奇 | 扬克维奇 | yankwich
萨格曼 | 塞奇曼 | sageman
库达希 | 卡达希 | cudahy
克赖维尔 | 克切维尔 | kercheville
德西雷 | 德西蕾 | desiree
凯利 | 丘利 | kewley
迪德 | 戴德 | dyde
乔塞林 | 乔斯林 | josselyn
卡德拉 | 夸德拉 | cuadra
德普米耶 | 德波米耶 | depommier
拜恩 | 拜昂 | bion
麦金图夫 | 麦金塔夫 | mcinturff
莫法德 | 莫维兹 | morfudd
桑克利 | 尚克利 | sankley
罗梅因 | 罗曼 | romaine
萨马拉 | 赛马拉 | saemala
怀兹坦 | 威斯坦 | wystan
博德威恩 | 鲍德温 | bodwine
勒斯 | 卢斯 | luss
布劳恩 | 布朗 | brown
霍里 | 豪里 | haury
奥斯 | 奥恩斯 | owns
鲍科姆 | 鲍库姆 | bawcombe
查伦格 | 查林杰 | challenger
泰特 | 撒特 | thaete
齐克里森 | 扎克里森 | zackrison
亨特雷斯 | 亨特里斯 | huntress
图乌萨南 | 蒂乌萨宁 | tiusanen
特里布 | 特赖布 | tribe
米尔德万 | 米尔德文 | mildvan
安尼尼 | 阿内尼 | aneny
马斯曼 | 穆斯曼 | mussman
克龙姆 | 克罗姆 | cromb
沃朗德 | 沃尔龙德 | walrond
蒙塔文 | 蒙塔冯 | montavon
阿尔韦尔 | 奥尔韦尔 | alwell
萨奇 | 萨特杰 | satge
贾尼斯 | 贾尼西 | janisse
比基特 | 比克特 | bicket
迪蒂 | 达西 | duthie
加安 | 加恩 | gahan
希索姆 | 希瑟姆 | heesom
德雷波 | 德拉珀 | drapeau
迪利 | 杜利 | duley
霍加特 | 霍贾特 | hodgart
桑比 | 桑德比 | saundby
斯韦布 | 斯韦比 | swaebe
格雷巴 | 格拉巴 | grabar
弗鲁伊特 | 弗鲁特 | fruit
伊勒恩 | 伊尔伦 | illearn
阿布洛姆 | 阿布隆 | ablom
博尔加塔 | 博加塔 | borgatta
埃斯梅尔 | 伊斯梅尔 | esmail
沃滕伯格 | 瓦滕伯格 | wattenberg
瓦利克 | 瓦莱克 | valek
阿迪内特 | 阿迪尼特 | adinet
克里沃罗 | 克里瓦罗 | crivaro
迪克 | 迪克尔 | dicker
佩特金 | 彼得金 | peterkin
德塞 | 德瑟 | desser
格贝尔 | 格巴尔 | geballe
霍伊尔巴克 | 胡尔贝克 | houiellebecq
布希 | 布舍 | busche
卡梅尔福德 | 卡姆尔福德 | camelford
比伊 | 布伊 | buie
赖特 | 雷特 | raitt
马尔欣恩 | 马尔夏恩 | mulshine
多佩尔 | 德佩尔 | doepel
查费茨 | 查菲茨 | chafetz
瑟米厄斯 | 瑟缪斯 | sermeus
德根特 | 德甘特 | degandt
伊肯 | 伊坎 | icahn
鲁厄尔 | 鲁埃尔 | reuel
海森 | 希森 | hyson
沃姆瑟 | 沃姆泽 | wormsor
热诺尔 | 格瑙尔 | genauer
默里 | 缪里 | murie
克莱夫 | 克拉夫 | clave
蒙东纳 | 蒙顿纳 | montonna
卡莎 | 卡沙 | kasha
利多姆 | 利德姆 | leedom
马拉布尔 | 梅拉伯 | malabre
苏里纳 | 苏雷纳 | surena
马比 | 梅比 | mabie
利希特沃特 | 利希特瓦尔特 | lichtwardt
奥弗罗尔 | 奥费拉尔 | o'ferrall
马琴 | 梅琴 | machen
塔谢罗 | 塔什罗 | taschereau
安纳尼 | 阿纳尼 | anany
福尔维 | 法尔维 | falvey
杜拉德 | 达拉德 | durrad
查彭 | 沙蓬 | chapone
柯尔曼 | 柯夫曼 | curfman
西拉西娅 | 特拉西娅 | therasia
林迪 | 琳迪 | lynndie
多纳莫尔 | 多诺莫尔 | donoughmore
奇德尔 | 切德尔 | chedell
卡兰 | 卡莱恩 | carline
甘博阿 | 甘博亚 | gamboa
巴蒂泽尔 | 巴蒂扎尔 | bartizal
康伯 | 库默 | comber
奈什 | 尼什 | neish
赫施 | 胡希 | husch
阿克利 | 埃克利 | akeley
尤泽 | 尤伊泽 | ueyser
奥拉 | 奥尔拉 | orla
马斯 | 马尔斯 | marrs
西拉 | 赛拉 | thyra
卡丹 | 卡登 | kadane
斯特罗索尔 | 斯特罗萨尔 | strohsahl
埃弗伯里 | 埃夫伯里 | avebury
比利亚博斯 | 比利亚洛沃斯 | villalobos
卢什 | 勒什 | lush
戴德姆 | 迪德姆 | deedham
纳尔 | 诺尔 | nall
迪克米尼尔 | 杜克米尼尔 | dukeminier
格维茨 | 格威茨 | gurwitz
德梅特 | 德梅特尔 | demaitre
科夫 | 科普夫 | kopf
塞吉恩 | 塞金 | seguin
海因菲尔德 | 汉费尔德 | hainfeld
沃拉 | 瓦拉 | walla
埃尔德海姆 | 埃尔德姆 | ealdhelm
斯坦内克 | 斯托尔内克 | stalnecker
马格里 | 马格丽 | margery
贝尔沃德 | 贝瓦尔德 | baerwald
盖伊 | 贾伊 | ghey
莱姆斯 | 里姆斯 | rheims
费罗扎德 | 费罗祖德 | ferozud
普拉杰 | 普拉奇 | plugge
基贾亚 | 凯乔 | kejoa
博斯顿 | 波士顿 | boston
费克特基蒂 | 费克特库蒂 | feketekuty
赫芬 | 赫法恩 | huffine
瑟希 | 塞希 | sershey
拉克斯赖思 | 拉克斯弗里思 | laxfrith
埃诺 | 伊诺 | eno
塞利格曼 | 塞利希曼 | seligmann
加韦德 | 加维德 | gaved
科奇尼希 | 科奇尼格 | kotschnig
斯特雷姆劳 | 斯特里姆劳 | stremlau
德罗姆戈尔 | 德罗姆古尔 | dromgoole
拜尔 | 贝耶尔 | beier
斯普赖耶 | 斯普赖尔 | spryer
瑟瓦克 | 瑟瓦奇 | serwach
阿菲 | 埃菲 | afee
里韦代尔 | 里弗代尔 | riverdale
西德博特姆 | 赛德博特姆 | sidebotham
格德 | 格尔德 | gerd
埃克洛夫 | 埃克勒夫 | eklof
博格哈 | 博格蒂尔 | boghatyr
芬格勒 | 芬勒 | fengler
豪恩谢尔 | 霍恩谢尔 | hounshell
奥因 | 约恩 | eoin
索 | 托 | thau
西德尼 | 西妮 | sydni
图雷曼 | 图尔曼 | tureman
德西德拉思 | 德西德蕾塔 | desiderata
茹埃特 | 朱厄特 | jouett
布龙克 | 布朗克 | bronk
班顿 | 贝恩顿 | baynton
塞格尔 | 西格尔 | seigel
约基廉廉斯 | 约克威廉 | yorkwilliams
弗拉利克 | 弗雷利克 | fralick
瑟娜 | 塞尔纳 | serna
伦嫩 | 伦南 | lennen
弗雷伊 | 弗雷 | frej
阿伯恩 | 阿本 | abern
伊登 | 艾登 | idden
希格内特 | 希格尼特 | hignett
杜庞特 | 杜邦 | dupont
克利姆克 | 克利姆基 | klimcke
赫尔布利 | 赫布尔 | helble
比尔布勒 | 比尔伯勒 | bilbrough
斯温托 | 斯温特 | swintor
特拉皮耶 | 特拉皮尔 | trapier
布里斯宾 | 布里斯本 | brisben
昂布赖特 | 昂布里特 | umbreit
布劳恩 | 布朗 | browne
凯加 | 凯加鲁 | caegarw
哈沃斯 | 休沃斯 | huvos
勒热 | 利热 | leasure
萨姆斯塔格 | 扎姆斯塔格 | samstag
麦克纳格 | 麦克诺尔 | mcnaugher
贾格斯 | 贾格尔斯 | jaggers
格伦巴克 | 格伦巴赫 | grumbach
凯克 | 西克 | cyker
凯斯 | 基斯 | keys
萨基纳 | 萨金娜 | sakinah
勒福恩 | 勒方 | lefaune
拉夫申 | 拉夫肖恩 | rafshoon
哈格特 | 哈吉特 | haggitt
贝曼 | 比曼 | beman
休费特 | 索伊弗特 | seufert
斯坦纳姆 | 斯塔纳姆 | stanham
麦克法登 | 麦克瓦登 | mcvadon
阿克申 | 埃克申 | action
梅因沙因 | 梅恩沙因 | maienschein
齐米曼 | 齐梅曼 | zimmeman
桑兹 | 桑德斯 | sondes
穆普森 | 马普森 | mupson
奥克林克斯 | 奥金克洛斯 | auchincloss
埃尔利 | 埃尔勒 | ehrle
勒克赫斯特 | 卢克赫斯特 | luckhurst
卡罗尔 | 卡萝尔 | carole
埃丁杰 | 埃丁格 | edinger
德沃尔 | 德韦尔 | deveulle
麦高伦 | 麦戈兰 | mcgauran
登帕萨 | 登帕西 | dempasay
马格尼 | 马格内 | magnay
法尔康布里奇 | 福尔肯布里奇 | falconbridge
马库斯 | 马克斯 | marcuss
格林斯特德 | 格林斯蒂德 | grinstead
内奇曼 | 纳奇曼 | nacheman
特鲁特 | 特拉特 | trutter
赖因德尼斯 | 莱因德尼斯 | rhindness
米多斯 | 梅多斯 | meadows
帕德西 | 帕齐 | pudsey
罗莱夫 | 罗卢夫斯 | rolufs
汉德伯格 | 汉德沃格 | handwerger
莱加特 | 莱格特 | legatt
尼科莱迪迪斯 | 尼古拉迪斯 | nikolaidis
戈利特利 | 戈莱特利 | golightly
芒尼希森 | 芒尼克海森 | munnikhuysen
贾科维茨 | 尤尔科维茨 | jurkowitz
休伊 | 舍韦 | schewe
麦古金 | 麦克琼金 | mcjunkin
高蒂耶 | 高蒂尔 | gauthier
古普 | 格普 | gup
拉贝特 | 拉贝 | rabet
吉格雷 | 吉格尔 | giguere
庞特尔 | 庞特 | punter
卢内德 | 莉内德 | luned
科勒斯 | 科雷斯 | corace
科克兰 | 科克伦 | cochrane
布扎纳 | 布尔扎纳 | brzana
莫尔霍尔特 | 莫霍尔特 | molholt
菲尔 | 费尔 | phaer
阿加西亚 | 阿加西娅 | agacia
梅佩尔 | 马佩尔 | mapel
西克斯 | 赛克斯 | sikes
克里茨 | 克赖茨 | crites
布兰特里 | 布伦特里 | braintree
格青格 | 格青杰 | getsinger
艾韦特 | 艾尔薇特 | irvette
霍内斯 | 霍尔尼斯 | holness
德尼奥 | 迪奈欧 | denio
基尔 | 基利 | kille
奥思内尔 | 奥塞内尔 | othenel
坦迪恩 | 坦丁 | tandien
巴克兰夫 | 巴克拉诺夫 | baklanoff
福克斯 | 富克斯 | fooks
马尼奥利亚 | 马格诺利娅 | magnolia
埃莱斯迈 | 埃尔斯米尔 | ellesmere
戴西 | 黛西 | daisy
戈迪夫 | 戈德夫 | godefe
沃西姆 | 沃特海姆 | wertheim
奥科因 | 奥库安 | aucoin
彼得罗 | 佩特罗 | petro
诺阔伊 | 诺基 | norquoy
米克马 | 米克瓦 | mikva
梅克厄姆 | 梅卡姆 | makeham
齐默 | 泽默 | zemmer
希肯洛普尔 | 希肯卢珀 | hickenlooper
巴尔塔萨 | 巴尔塔泽 | baltassar
迪克 | 杜凯 | duque
弗利金格 | 弗利金杰 | flickinger
泽比纳 | 泽拜纳 | zebina
麦卡纳尼 | 麦卡内尼 | mcaneney
布拉夫 | 布劳 | blough
格拉斯戈 | 格拉斯哥 | glasgow
赫钦格 | 赫金杰 | hechinger
哈恩迪 | 哈内迪 | harnedy
布拉斯内特 | 布拉斯尼特 | brasnett
斯梅伊 | 斯梅奇 | smaje
奥利文特 | 奥利万特 | ollivant
戈洛文科科 | 戈洛夫琴科 | golovchenko
布利肯施塔夫 | 布利肯斯塔夫 | blickenstaff
麦克洛尔 | 麦克勒莫尔 | mclemore
德布勒勒 | 德布鲁勒 | debruler
麦克费德兰 | 麦克费德伦 | macphedran
奥迪杰 | 奥迪吉耶 | audigier
赫蒙 | 哈蒙 | hummon
伯特伍德 | 伯绍德 | berthoud
阿尔代尔德 | 阿尔卡德 | alcalde
帕克特 | 帕赫特 | pachter
比利利 | 比利 | beoley
丁恩 | 丁 | din
古比托什 | 古比托西 | gubitoshi
比塔 | 比塔尔 | bitar
麦莱卡 | 姆拉卡 | mlakar
达尔维奇 | 达利奇 | dulwich
迪卢基奥 | 迪卢乔 | diluchio
格罗塞泰特 | 格罗斯泰特 | grosseteste
施蒂布林 | 斯蒂贝林 | stiebeling
洛克希尔 | 洛希尔 | lochiel
弗里尔 | 弗雷耶 | freyere
斯科菲尔德 | 舍恩菲尔德 | schonfield
斯托尔普曼 | 施托尔普曼 | stolpman
弗兰普欣 | 弗兰普申 | framption
博雷特 | 博里特 | borrett
拉肯迈耶 | 拉肯米尔 | lackenmier
菲彻姆 | 费克姆 | feachem
拉兰帕尼 | 拉康帕涅 | lacampagne
索维奇 | 索瓦热 | sauvage
普鲁德富特 | 普劳德富特 | proudfoot
赫曼 | 赫尔曼 | herman
蔡夫 | 泽夫 | zeff
科帕德 | 科珀德 | coppard
盖曼 | 格曼 | gehman
斯塔雷斯 | 斯泰尔斯 | stares
埃尔齐 | 埃尔扎伊 | elzay
索尔韦因 | 索尔温 | sauerwein
巴思 | 巴特 | barthe
埃斯科菲 | 伊斯科菲 | escoffey
吉利亚姆 | 吉列姆 | gilliam
皮尔 | 皮埃尔 | pierre
博施威茨 | 博希威茨 | boschwitz
哈德格雷 | 哈迪格里 | hardegree
弗利克拉夫特 | 弗利特克拉夫特 | flitcraft
皮尔 | 珀尔 | pearl
布雷希尔 | 布拉希尔 | brashier
维勒雷尔 | 维拉里尔 | villarreal
伊格尔韦奇 | 伊格尔维奇 | iglewicz
洛西安 | 洛西恩 | lowthian
多姆詹 | 多米扬 | domjan
阿巴斯滕亚亚 | 阿巴斯蒂尼亚 | abastenia
阿利斯 | 阿莱斯 | allies
海泽 | 哈伊泽 | huyser
科马杰 | 康马杰 | commager
卡拉佩蒂安 | 卡拉佩琴 | carapetyan
布里宁 | 布赖宁 | bryning
麦凯恩 | 麦克钦 | mccheane
埃德尔 | 伊德尔 | eedle
布罗德伯特 | 布罗德本特 | broadbent
克拉特里 | 克拉布特里 | crabtree
特洛 | 特略 | tello
纽伯勒 | 纽伯格 | newburgh
博特西特 | 博塞特 | botset
托尔梅奇 | 塔尔梅奇 | tallmadge
威克斯特德 | 威克斯第德 | wicksteed
维斯斯洛斯基 | 维斯克洛斯基 | visclosky
杰吉斯 | 格吉斯 | gergis
斯科格伦 | 斯科格隆 | skoglund
拉萨尔 | 拉萨 | lassar
温塔尔 | 温特尔 | weintal
贾夫 | 贾菲 | jaffe
斯塔姆 | 施塔姆 | stamm
法扎 | 法扎尔 | fazar
马塞尔 | 玛塞勒 | marcelle
塔斯特 | 图斯特 | touster
尤文斯 | 尤温斯 | uwins
切尔斯基 | 切赫尔斯基 | cehelsky
托勒马什 | 托尔马什 | tollemache
尤莱维奇 | 乌莱维奇 | ulevich
达尔斯特龙 | 达尔斯特伦 | dahlstrom
德赫斯 | 德海斯 | dehayes
希拉 | 夏伊拉 | shyla
比恩 | 比汉 | beehan
法尔肯海姆 | 福尔肯海姆 | falkenheim
雷吉纳德 | 雷金纳德 | reginald
哈努舍克 | 哈努谢克 | hanushek
斯珀斯 | 斯波斯 | spouse
洛恩 | 洛温 | lowen
乔翰尼 | 约翰尼 | johnny
多尔夫勒 | 德夫勒 | doerfler
施朗茨 | 施龙茨 | shrontz
伊利希 | 伊利格 | illig
贝默塞德 | 比默赛德 | bemersyde
米姆诺 | 明诺 | mimno
布平达 | 布平达尔 | bhupindar
罗明 | 罗梅因 | romeyn
布雷克斯皮 | 布雷克斯皮尔 | breakspear
扬格斯本德 | 扬哈斯本 | younghusband
夏皮 | 沙比 | sharpey
勒西奇 | 勒萨热 | lesage
杰普萨 | 杰普撒 | jeptha
布布利斯 | 布勃利斯 | bublys
辛皮克 | 辛皮奇 | simpich
锡德福德 | 塞德福德 | thedford
伯索尔夫 | 伯索夫 | bertholf
塞迪亚 | 切迪亚 | ceddia
戴文波特 | 达文波特 | davenport
沙特利夫 | 舒特莱夫 | shurtleff
斯波托德 | 斯波蒂德 | spotted
乔齐 | 乔茜 | jozy
黛安 | 戴安 | dian
赞布鲁姆 | 赞布勒姆 | zambrum
马霍恩 | 马洪 | mahone
劳克霍夫 | 劳卡夫 | laukhuff
德拉基斯 | 德拉奎斯 | delaquis
米尔希 | 米尔海 | milhy
卡德温 | 卡杜根 | cadwgan
博希尔 | 博舍尔 | boshier
斯克里伯 | 斯克赖伯 | scriber
博维 | 博韦 | bovee
赫克顿 | 赫克通 | hektoen
莱维 | 利瓦伊 | levi
蔡伊斯 | 蔡斯 | chayes
纳撒尼尔 | 纳撒内尔 | nathanael
克里亚 | 克雷 | crea
乔尔万 | 朱尔万 | joulwan
阿德金森 | 阿基森 | adkisson
施莱 | 施利 | schlie
伊菲根 | 伊菲吉妮 | iphigene
塞金格 | 塞金杰 | seckinger
泽费雷利 | 泽菲雷利 | zeffirelli
泰菲恩 | 泰维恩 | teifion
拉罗姆 | 拉勒姆 | larom
坎帕因 | 坎佩恩 | campaigne
古茨威勒 | 古茨维勒 | gutzwiller
马奎斯 | 马克斯 | marques
勒金 | 勒德金 | ludgin
阿尔皮娜 | 阿尔皮纳 | alpina
韦雷尔 | 沃雷尔 | werrell
福尔兹 | 福尔茨 | folz
德福 | 德福特 | deford
博比萨德 | 博比苏德 | bobisud
托尔 | 特尔 | tourle
图利特 | 塔利特 | tulett
尚伯格 | 舍恩伯格 | schonberger
兰贝利特 | 兰伯利特 | lambelet
盖伊 | 贾伊 | gye
利希滕斯坦 | 利克滕斯坦 | liechtenstein
安德鲁齐维奇 | 安德鲁斯克维奇 | andruskevich
托德里亚斯 | 托德雷亚斯 | todreas
泰林厄姆 | 蒂林厄姆 | tyringham
比 | 布埃 | bue
斯拉克斯 | 斯莱克斯 | slacks
阿维斯 | 阿维丝 | aveis
黑吉斯 | 海吉斯 | haigis
基珀 | 凯珀 | kuiper
斯卡珀罗 | 斯卡佩罗 | scarpero
阿伦 | 阿龙 | aaron
马尔克斯 | 马尔库斯 | malkus
杜奇 | 杜格 | dhooge
格尔巴赫 | 盖尔博 | gelbach
布雷克兰 | 布里克兰 | brekland
布亚拉 | 布阿哈拉 | buachalla
里丁斯 | 赖丁斯 | ridings
沃尔克 | 沃克 | walke
考特尼 | 考特妮 | kourtney
布洛姆伦 | 布洛姆格伦 | blomgren
库尔 | 屈尔 | kuehl
比利埃 | 比埃 | billiere
马什霍尔 | 马申霍尔 | mashenhole
曼恩 | 曼 | mann
施纳克 | 施努克 | schnuck
佩金 | 帕金 | pagin
杰拉特 | 贾勒特 | jarratt
帕雷斯 | 佩尔斯 | pares
尼科莱 | 尼古拉 | nicolay
塔图利斯 | 塔图尔斯 | tatooles
梅尔森 | 默森 | merson
弗雷塔格 | 弗赖塔格 | freytag
基米特 | 金米特 | kimmitt
克罗斯曼 | 克罗斯蒙 | croasmun
乔登斯 | 乔丹斯 | jordans
艾勒 | 艾拉 | ayla
利瑟特 | 利撒特 | leathart
赖津 | 里津 | ryzin
内马特 | 纳马思 | namath
伯娜 | 伯纳 | berna
索尔斯 | 索莱 | saulez
斯坦齐克 | 斯坦奇克 | stanczyk
布莱欣登 | 布莱钦登 | blechynden
巴托莱梅 | 巴托洛缪 | bartholemeu
安德烈娜 | 安德里娜 | andrina
塔尼娅 | 塔妮娅 | tania
奇尔尔 | 瑟克 | cirker
德文特 | 德温特 | derwent
妮科尔 | 尼科尔 | nicolle
恩德科特 | 恩迪科特 | endecott
阿尔文 | 阿尔温 | alwin
胡克 | 霍克 | houcke
豪塞尔 | 休塞尔 | heusel
莱夫勒 | 莱弗拉尔 | leflar
罗萨佩普 | 罗萨皮普 | rosapepe
赫宁伯格 | 赫宁堡 | heningburg
巴萨德 | 巴萨德雷 | basadre
派约特 | 派奥特 | pyott
斯威策 | 斯韦策 | sweitzer
梅勒普斯 | 梅拉普斯 | mellups
马拉赫 | 马拉克 | malach
唐奇恩 | 唐奇安 | donchian
桑顿 | 桑克顿 | sancton
巴尔西格 | 巴尔西杰 | balsiger
希拉伯 | 希莱伯 | shillaber
布兰法斯 | 布兰德法斯 | brandfas
斯卡普西特 | 斯卡尔普西特 | sculpsit
休马森 | 赫马森 | humason
斯蒂夫斯 | 斯特弗斯 | steffes
贝希特 | 贝谢 | bechet
梅利奥尔 | 梅莉奥尔 | melior
克尔奇弗 | 克切弗 | kerchever
比阿特里夏 | 比阿特丽西娅 | beatricia
梅努欣 | 梅纽因 | menuhin
舒雷 | 舒尔 | shure
凯格 | 基格 | keig
伊萨科 | 伊萨科夫 | isakow
兹沃 | 兹瓦尔 | zwar
克伦西克 | 赫伦奇克 | chrencik
内莎 | 尼萨 | neysa
彭沃尔特 | 佩恩沃尔特 | pennwalt
库斯维茨基 | 科乌谢维茨基 | koussevitzky
伊尔图德 | 伊尔蒂德 | illtud
弗罗泽 | 弗勒泽 | froese
莱尔 | 赖尔 | ryle
阿什利 | 阿什莉 | ashleigh
斯托扎 | 斯图尔扎 | stoorza
弗拉赫蒂 | 弗莱厄蒂 | flaherty
诺克斯 | 努克斯 | nokes
奇亚鲁奇 | 基亚鲁奇 | chiarucci
舍格尔斯 | 舍加尔斯 | shergals
贝格特拉普 | 贝格特鲁普 | begtrup
安巴德达 | 安贝德卡 | ambedkar
迪克诺伊 | 迪克努瓦 | duquenoy
托里佐斯 | 托里霍斯 | torrijos
柯彻 | 基尔舍 | kircher
斯托岑巴赫 | 斯托曾巴赫 | stolzenbach
杰尔 | 杰格 | jeger
马德里德 | 马德里 | madrid
凯特尔比 | 基特尔比 | ketelbey
怀金特 | 威甘特 | wygant
博弗里 | 博韦里 | boverie
贝勒 | 贝利 | behle
阿姆什威茨 | 阿姆谢维茨 | amshewitz
奥法雷尔 | 奥法雷 | o'farrell
卢宁 | 吕宁 | luening
特金 | 图尔金 | turkin
西里 | 蒂里 | thierry
乔西 | 约瑟 | josee
施赖伯 | 施里伯 | shriber
迈斯兰 | 迈斯拉恩 | meislahn
德拜尔 | 德比尔 | derbyl
格尔纳 | 盖尔纳 | gellner
森塞尼克 | 森塞尼奇 | sensenich
比斯普林夫 | 比斯普林霍夫 | bisplinghoff
高因 | 高英 | gowing
亨尼卡特 | 亨尼克特 | hunnicutt
本恩 | 贝恩 | benne
科斯 | 库斯 | coes
斯库斯 | 斯丘斯 | skuce
福尔克 | 福克 | foulke
维尼斯 | 维内斯 | veness
穆斯 | 缪斯 | muse
哈威克斯博克 | 哈维克斯布罗克 | hawixbrock
冈亨利 | 贡希利 | goonhilly
哈里尔 | 哈丽尔 | harriel
奎恩 | 奎因 | queen
塞塞尔 | 塞斯尔 | sessel
费尔马纳 | 费尔曼纳 | fairmaner
霍格金森 | 霍奇金森 | hodgkinson
托马利娅 | 托马利亚 | tomalia
阿尔西芬 | 阿尔西弗龙 | alciphron
达纳根 | 杜纳根 | dunagan
特雷西 | 特蕾西 | tracey
戈克 | 吉奥克 | giauque
埃尼德 | 伊妮德 | enid
萨金特 | 瑟金特 | searjeant
拉金 | 莱金 | laging
劳斯 | 鲁斯 | roose
尚恩伯格 | 舍恩伯格 | schonberg
米茨霍夫 | 米采夫 | mitseff
伊普尔 | 耶普尔 | yeaple
范格 | 范杰 | fanger
布兰钱 | 布兰昌 | blanchan
霍尔迪曼德 | 哈尔迪曼德 | haldimand
吉利亚姆斯 | 吉利亚姆 | guilliams
多奇 | 道奇 | dodge
梅利亚 | 米利亚 | melia
斯温恩 | 斯温 | sween
弗赖赖希 | 弗赖雷克 | freireich
戈姆兹拉塔 | 戈梅斯普拉塔 | gomezplata
布尔吉伊斯 | 布儒瓦 | bourgeois
奥利瓦里兹 | 奥利瓦雷斯 | olivarez
罗伊巴尔 | 罗伊鲍尔 | roybal
布谢夫 | 布舒夫 | bushueff
萨吉蒂赖厄斯 | 萨吉泰里厄斯 | sagittarius
比克 | 贝克 | beek
雷诺瓦德 | 伦瓦尔 | renouard
希拉斯 | 希勒斯 | heelas
考尔德克 | 考尔德克拉夫 | caldcleugh
克拉格 | 克莱格 | clague
杰西娜 | 杰西纳 | jacyna
切希尔 | 切斯希尔 | chesshyre
布雷欣 | 布里金 | brechin
古德勒姆 | 古德哈姆 | gooderham
耶格 | 耶格尔 | yager
巴尔尼 | 鲍恩 | balne
霍普 | 霍伊普 | heup
格鲁赛德 | 格鲁辛德 | grusinde
希曼娜 | 希曼纳 | sheemanna
施雷尔 | 施赖尔 | schreyer
阿查尼奇 | 阿德查尼克 | ardcharnich
贝迪利恩 | 贝迪利翁 | bedillion
斯迈思 | 史密斯 | smyth
赖道特 | 赖德奥特 | rideout
麦考斯兰 | 麦考斯伦 | mcauslan
尼思代尔 | 尼斯代尔 | nithsdale
布卢顿 | 布勒顿 | blurton
多罗西 | 多萝西 | dorothy
斯塔宾 | 斯图宾 | stubbing
索洛茨 | 索尔特斯 | solotesz
坎普施罗 | 坎普施罗尔 | kampschror
布姆斯特德 | 巴姆斯特德 | bumstead
纳特 | 纳赫特 | nacht
德马塔 | 德马尔托 | desmarteau
马吉雷尔 | 马圭雷尔 | maguirel
夏尔普 | 谢普 | shairp
格赖德 | 格雷德 | greider
伯兹尔 | 伯塞尔 | birdsell
普雷彻 | 普里彻 | preacher
索恩代克 | 桑代克 | thorndike
马沙姆 | 马香 | marsham
切尔尼克 | 切尔内克 | chelnek
奥伯赫尔曼 | 奥伯黑尔曼 | oberhelman
帕特里亚克 | 佩特里亚克 | patriach
海内曼 | 海涅曼 | heinemann
里查兹 | 理查兹 | richards
艾奇森 | 艾奇逊 | eytchison
布里恩特 | 布赖恩特 | briant
科尔菲托 | 科菲亚托 | corfiato
科亚克 | 科哈克 | kohak
丹纳瑟 | 丹罗伊特 | dannreuther
巴恩比 | 巴恩贝 | barnebey
梅林达 | 梅琳达 | melinda
弗伦泽 | 弗伦策 | frenzer
康西尔 | 康斯尔 | council
沙因鲍姆 | 欣鲍姆 | sheinbaum
泰雷 | 泰里 | tyree
戈德博勒 | 戈德伯勒 | goldborough
沃拉尼厄斯 | 瓦拉尼厄斯 | waranius
赫曼尼克 | 赫马纽克 | hermaniuk
马考斯 | 马库斯 | makous
维思 | 韦思 | vaeth
雷津 | 拉津 | razeen
古 | 高夫 | gough
巴塔格尔 | 巴塔杰尔 | battagel
埃里克 | 埃厄克 | earwaker
格林达尔 | 格林德尔 | grindal
贝克斯泰特 | 贝克施泰特 | beckstedt
西弗林豪斯 | 塞夫林豪斯 | sevringhaus
贾科泰特 | 贾科泰 | jacottet
布里利 | 布里厄利 | brealey
麦科沙尼格 | 麦科尚奈格 | maco'shannaig
麦克廷格 | 马赫廷格 | machtinger
特里斯特伦 | 特里斯特雷姆 | tristrem
南内曼 | 南尼曼 | nenneman
康杰 | 康格 | conger
柯尼格 | 凯尼格 | koernig
马米特 | 马梅特 | mamet
卡塞尔 | 卡瑟尔 | cuthell
诺亚姆 | 诺姆 | noam
基茨哈伯 | 基察伯 | kitzhaber
布雷齐尔 | 布雷热 | brazier
斯迈亚克 | 斯米亚利克 | smialek
芬尼 | 菲尼 | phinney
奥尔迪 | 阿尔迪 | alday
阿曼杜斯 | 阿曼达斯 | amandus
麦克塔纳安 | 麦克塔纳汉 | mctarnahan
赛纳 | 西纳尔 | synar
纽因斯 | 纽恩斯 | newens
康科拉 | 康科勒 | concholar
默茨基 | 默茨克 | mertzke
朔勒 | 朔伊勒 | scheuler
特鲁曼 | 杜鲁门 | truman
迪奥 | 德奥 | deo
拉思 | 雷思 | rathe
霍尔巴克 | 哈尔巴赫 | halbach
加莱尔 | 加利尔 | galil
拉特 | 鲁尔特 | rurt
克罗嫩贝格 | 克罗嫩伯格 | kronenberg
克里奇顿 | 克赖顿 | crichton
格威内德 | 格威内思 | gwynedd
科特 | 考特 | cawte
冈特 | 甘特 | gant
鲍奇 | 布谢 | bouchey
波尔斯 | 鲍威尔斯 | powels
罗雷姆 | 罗勒姆 | rorem
伊萨克斯 | 艾萨克斯 | isaacs
安德烈欧 | 安德里厄 | andrieux
阿莱恩 | 阿林 | alleine
贝克 | 贝克尔 | becker
纳奇梅诺夫 | 纳赫马诺夫 | nachmanoff
怀索基 | 维索茨基 | wysocki
扎奇曼 | 扎克曼 | zachmann
斯梅尔皮斯 | 斯莫尔皮斯 | smallpeice
吉科瓦夫特 | 吉科瓦特 | gicovate
苏里奇 | 瑟里奇 | surridge
唐西娅 | 唐西亚 | donsia
达克罗 | 迪克罗 | ducrow
格雷根蒂 | 格雷甘蒂 | greganti
沃尔克 | 沃克 | walk
沃尔克 | 沃克 | walker
达迪生 | 麦迪逊 | madison
麦科拉姆 | 麦科勒姆 | mccollam
德格拉克 | 德格拉赫特 | dergracht
迈耶伯格 | 迈尔伯格 | myerburg
斯坦达洛夫特 | 斯坦德洛夫特 | standaloft
莱恩斯 | 莱昂斯 | lyons
德沃查克 | 德沃夏克 | dvorchak
费布里坎特 | 法布里坎特 | fabricant
库赫伦 | 库格伦 | coughran
多克特 | 多克托 | docktor
弗朗恩斯 | 弗朗西斯 | fraunces
菲林 | 法林 | filene
巴戈 | 巴戈特 | bagot
莱尔 | 勒尔 | lull
查克里斯 | 查基里斯 | chakiris
希尔茨 | 希尔兹 | shields
皮克普 | 皮卡普 | pickup
塞门扎 | 西门扎 | semenza
哈森富斯 | 哈森弗斯 | hasenfus
加索夫 | 加特霍夫 | garthoff
夏延 | 夏恩 | cheyenne
沃尔拉特 | 沃尔拉思 | walrath
彼得龙 | 佩特龙 | petrone
格蕾西 | 格雷西 | gracie
格里桑蒂 | 格里桑迪 | grisanti
梅尔斯 | 马雷斯 | mares
庞蒂尼 | 庞特尼 | pounteney
阿奈林 | 阿内林 | aneirin
冈利 | 高恩利 | gownley
劳宾盖尔 | 劳本盖耶 | laubengayer
拉腊比 | 拉勒比 | larabee
埃斯卡达里安 | 伊斯坎达里安 | eskandarian
斯莱普 | 斯卢普 | sloop
科尔奎特 | 科尔基特 | colquitt
比东多 | 比顿多 | bitondo
埃德巴尔德 | 埃德博尔德 | eadbald
查南 | 查嫩 | chanen
贝松 | 贝森 | bessone
撒勒 | 塞勒 | thaler
塞科夫斯基 | 赛科夫斯基 | saikowski
塞格雷夫 | 西格雷夫 | segrave
苏伊尔 | 舍代尔 | suirdale
克莱弗林 | 克拉弗林 | clavering
哈莫尔 | 哈默 | hamor
博索沃思 | 博索姆沃思 | bosomworth
普普 | 普珀 | puppe
施米德 | 施密德 | schmid
黑尔 | 海尔 | haire
哈克威尔 | 黑克威尔 | hakewill
冈扎利兹 | 冈萨雷斯 | gonzalez
莫纳 | 莫娜 | mona
格雷恩 | 格兰妮 | grainne
布拉德泰泰特 | 布拉德斯特里特 | bradstreet
麦克斯蒂芬 | 麦克斯蒂奥芬 | macstiofain
亚列莫维奇 | 雅里莫维奇 | yarymovych
塞尼奥尔 | 西尼尔 | senior
哈特赛德 | 哈齐德 | hartsid
博伊斯拉根 | 博勒根 | boisragon
雷伯特 | 雷巴特 | rebut
梅特罗普洛斯 | 梅特罗波利斯 | metropolis
索热 | 索热尔 | saussure
斯克鲁托托 | 斯克鲁泰特 | scrutator
格里泽 | 格赖泽 | griser
贝拉妮娅 | 贝拉尼亚 | berania
戈德史蒙 | 戈德西蒙 | goldsymon
舒尔霍尔兹 | 许霍尔茨 | schuerholz
科尔赫普 | 科尔黑普 | kohlhepp
鲁罗科 | 罗科 | ruocco
加诺尔 | 加诺 | ganor
沃格伦 | 沃尔格伦 | walgren
鲍尔施韦勒 | 巴尔德施维勒 | baldeschwieler
鲍兰 | 布兰 | bourland
斯洛尼姆 | 斯洛宁 | slonim
玛撒 | 玛莎 | martha
福内斯 | 福尼斯 | forness
鲍杜因 | 鲍德温 | bauduin
珀塞克 | 佩塞克 | perseck
维伦 | 瓦伊伦 | viron
索尔茨 | 肖尔茨 | soults
格罗尔德 | 杰罗尔德 | gerould
耶格尔 | 耶格 | jaegher
赫雷霍夫 | 赫雷斯霍夫 | herreshoff
加弗 | 盖弗 | gaver
西金 | 西尔金 | sirkin
皮普 | 派普 | pipe
柯兰 | 柯伦 | curran
瓦伦祖伊拉 | 巴伦苏埃拉 | valenzuela
弗卢克斯 | 弗勒克斯 | flux
林恩 | 林 | linn
德赖克 | 德里克 | driker
里查德 | 理查德 | richard
罗伯森 | 罗伯逊 | robertson
德拉考尔 | 德拉库尔 | delacour
达肯 | 达坎 | dakan
吉查姆 | 吉彻姆 | gitsham
利夫奥克 | 莱夫奥克 | liveoak
范德霍夫 | 范德胡夫 | vanderhoof
普鲁斯曼 | 普拉斯曼 | prusman
基弗 | 凯弗 | keifer
吉恩 | 吉亨 | gehan
施努肯 | 施努克内 | schnukne
阿盖尔 | 阿高尔 | argall
温纳斯特伦 | 温纳斯特鲁姆 | wennerstrum
伦德尔 | 伦达尔 | lundahl
利德克 | 利迪克 | luedecke
乔德雷 | 乔德尔 | jordre
普卢内克 | 普伦尼克 | pluenneke
布卡茨 | 布卡奇 | bukatzsch
贝拉德 | 贝拉尔 | berard
维格姆 | 威格姆 | wigham
马尔文农 | 马尔韦农 | mulvenon
道宁 | 唐宁 | downing
巴特伦 | 巴特拉姆 | battram
皮珀 | 派珀 | piper
格里苏贾尼亚 | 格丽索戈尼娅 | grisogonia
德保 | 德波 | depauw
格劳尔 | 格罗尔 | grower
豪瑟姆 | 豪萨姆 | howsam
豪杰 | 豪格 | hauger
科菲恩 | 科芬 | coffeen
德沃尔金 | 德沃金 | dworkin
阿特尔西 | 阿特莱西 | attlesey
加格宾 | 加涅班 | gagnebin
布莱克谢克特 | 布莱希施米特 | blechschmidt
赫维茨 | 赫威茨 | herwitz
梅恩斯 | 梅因斯 | mains
马塔雷佐 | 马塔拉佐 | matarazzo
德雷斯克 | 德赖斯克 | dreiske
普赖尔 | 普里尔 | preil
比勒姆 | 比鲁姆 | biroum
奎伦 | 奎林 | quillen
克伦 | 克兰 | kerlan
贝思 | 贝丝 | beth
拜霍尔特 | 伯霍尔特 | byrholdt
普罗文舍 | 普罗文彻 | provencher
约赫 | 约埃 | yohe
耶特伦 | 亚特隆 | yatron
布思利 | 布思莱 | buthlay
安杰莉娜 | 安杰利娜 | angelina
普伦蒂 | 普朗蒂 | prunty
奥洛克林 | 奥劳克林 | o'laughlin
梅奥拉斯 | 马约拉斯 | mayoras
伊夫勒 | 伊夫利 | evelegh
韦西 | 维齐 | veysey
拉里莎 | 拉丽莎 | larissa
格根海默 | 古根海默 | guggenheimer
沃尔斯通克拉夫特 | 沃斯通克拉夫特 | wollstonecraft
奥卡恩 | 奥凯恩 | o'kane
法夫罗特 | 法夫罗 | favrot
阿曼 | 阿尔曼 | arman
萨拉曾 | 萨拉津 | sarazyn
利拉 | 莱拉 | layla
阿米欧 | 阿米奥特 | amiot
贝德尔 | 比德尔 | bedel
阿德尼 | 埃德尼 | adney
波克 | 普克 | poock
莫勒诺尔 | 莫勒瑙尔 | mollenauer
芬维西 | 芬韦西 | fenvessy
帕奇 | 帕克 | pach
盖尔德 | 格尔德 | gelder
于里安 | 尤里安 | urien
佩皮厄特 | 佩皮奥特 | pepiot
诺塔奇 | 诺蒂奇 | nottage
巴查尔 | 巴卡尔 | bachar
奥尔博 | 阿尔博 | allbaugh
加米特 | 加梅特 | gamet
德利贾里斯 | 德利乔治斯 | deligiorgis
加雷尔 | 加勒尔 | garel
奥尔 | 奥利 | ole
巴德温恩 | 布德温 | budwine
迪奥 | 戴奥 | dio
布罗尔奇 | 布勒尔施 | broelsch
塞弗尔 | 萨维尔 | savele
莱维 | 利维 | levie
格朗基 | 格朗茨基 | groncki
加康 | 加肯 | garcon
沃米利 | 沃姆利 | wormeley
布鲁特勒格 | 布鲁特拉格 | brutlag
达姆里赫 | 德姆里克 | daemmrich
肖尔德勒 | 斯科德勒 | scholderer
杜比 | 达比 | duby
博斯金德 | 博斯坎德 | boskind
瑟维尔 | 瑟维耶 | surveyer
纽尼梅克 | 努尼梅克 | nunemaker
阿妮斯 | 安妮斯 | anis
阿布林 | 埃布林 | ablin
班德 | 班德尔 | bander
罗索尔 | 罗塞尔 | rossall
谢德 | 沙德 | shad
埃奇逊 | 艾奇逊 | etcheson
福塞特 | 福西特 | fawssett
莫菲 | 莫夫 | maufe
梅维蒂 | 马维蒂 | mavity
吉尔德福德 | 吉尔福德 | guildford
阿加斯 | 阿加丝 | agase
阿提亚 | 阿提耶 | atiyeh
伦芬特 | 朗方 | lenfant
尤普罗辛 | 尤弗罗西尼 | euphrosyne
艾奥拉 | 阿亚拉 | ayala
卡尔卡诺 | 卡尔卡尼奥 | calcagno
梅恩林 | 梅因沃林 | mainwaring
佩特里德斯 | 佩特里迪斯 | petrides
科德尔 | 科德 | corder
戴弗恩 | 达文 | davern
罗扎 | 罗珊 | rozanne
洛格 | 洛奇 | lorge
格林霍 | 格里诺 | greenhow
格利莫尔 | 格利穆尔 | glymour
斯利 | 斯莱 | sligh
海斯 | 谢斯 | shays
埃莱娜 | 埃琳娜 | elena
布雷德 | 布里德 | breder
勒班 | 莱班 | leban
穆拉尔特 | 缪拉尔持 | muralt
萨洛姆 | 萨洛米 | salome
利克曼 | 莱克曼 | likeman
玛丽莎 | 马里萨 | marisa
布尔廷豪斯 | 博尔廷豪斯 | boultinghouse
尤金尼亚 | 尤金妮亚 | eugenia
梅德瓦多斯基 | 梅德瓦多夫斯基 | medwadowski
希厄特 | 海厄特 | hieatt
科德尔 | 科格德尔 | cogdell
惠契利夫 | 惠特克利夫 | whitchliffe
卡利尔 | 卡莱尔 | carlisle
古弗里达 | 朱弗里达 | giuffrida
德哈特 | 德克特 | dechert
洛芙登 | 洛夫登 | loveden
德夫尼 | 迪夫尼 | deveney
海姆索特 | 海姆塞特 | heimsoth
希伯德 | 希巴德 | hibbard
科斯马 | 科斯莫 | cosmo
盖斯特菲尔德 | 盖斯特费尔德 | geistfeld
塔利亚费罗 | 托利弗 | taliaferro
蒂特勒 | 泰特勒 | tytler
莱塞特 | 莱西特 | lycett
莱根 | 利根 | lygon
奥利克西 | 奥莱克休 | oleksiw
赖代尔 | 里迪尔 | rideal
萨尔温 | 西尔温 | sulwen
谢德尔 | 沙德尔 | shadel
坦克蕾托 | 坦克雷托 | tancreto
法迪安 | 法迪恩 | fadyean
伯克隆 | 伯克伦 | berklund
德雷南 | 德雷宁 | drennen
迪彻 | 德谢尔 | decher
巴特伦 | 巴特拉姆 | buttram
特鲁齐 | 特拉齐 | truzzi
阿布迪安 | 阿布迪恩 | abdian
托里 | 托丽 | tori
卡里洛 | 卡里略 | carrillo
马思内 | 马塞纳 | marthena
格尼森 | 吉尼森 | genesen
凯莉 | 卡利 | cali
波兰 | 波伦 | pollan
弗默斯 | 瓦默斯 | varmus
