戈妮娅 | 戈尼亚 | gonia
布雷金里奇 | 布雷肯里奇 | breckinridge
玛莉 | 马利 | maly
阿西尼加 | 阿西涅加 | arciniega
霍普特 | 豪普特 | houpt
沃尔斯塔特 | 沃尔施塔特 | wollstadt
西恩 | 西根 | seaghan
斯特拉特恩 | 斯特拉森 | strathearn
派珀特 | 佩珀特 | peipert
皮内 | 皮奈 | pinay
梅雷斯曼 | 米尔斯曼 | meresman
弗兰宗 | 弗兰曾 | franzon
伊兹比基 | 伊兹比茨基 | izbicky
埃卡韦斯特 | 埃沙韦斯特 | echaveste
舒普 | 肖普 | shoupp
皮安 | 普汉 | puhan
沃塞尔 | 瓦塞尔 | wassell
西金特 | 萨金特 | seargent
亨巴克 | 亨巴赫 | heimbach
纳尔迪 | 纳迪 | nardi
杰米马 | 杰迈玛 | jemima
莫杜特 | 莫德维 | mauduit
惠塔克 | 惠特克 | whitacre
艾特 | 艾厄特 | eyet
耶德利 | 亚德利 | yeardley
博比 | 鲍比 | bobbie
麦基尔文纳 | 麦基尔温纳 | macilvenna
博查尔 | 博索尔 | botsal
科尔兰 | 科尔雷因 | coleraine
瓦格尼 | 韦恩 | wagne
厄德曼 | 厄尔德曼 | erdman
戈尔姆比夫斯基 | 戈伦别夫斯基 | golembiewski
夏尔迪 | 恰尔迪 | ciardi
格雷戈尔 | 格雷瓜尔 | gregoire
迈卡亚 | 迈凯亚 | micajah
雷梅克斯 | 拉马克斯 | raemakers
拜伦森 | 贝伦森 | beilenson
皮凯弗 | 皮卡弗 | piccaver
苏布林 | 萨布林 | subrin
斯克拉顿 | 斯克鲁顿 | scrutton
哈兹利特 | 黑兹利特 | hazlitt
费尔本 | 费尔伯恩 | fairburn
津南 | 津宁 | zinnen
布盖兹 | 布尔盖兹 | bourgaize
佩莱蒂埃 | 佩尔蒂埃 | pelletier
帕塞尔 | 帕斯尔 | parcel
霍诺里 | 霍诺丽 | honori
伊姆施 | 伊梅施 | imesch
埃尔托黑德 | 埃尔顿黑德 | eltonhead
西明顿 | 赛明顿 | symington
马豪 | 玛奥 | mahault
法克 | 菲克 | fike
奥德斯 | 奥杜斯 | audus
加布尔 | 加伯 | gabbour
沃伊蒂克 | 沃伊蒂奇 | woytych
韦克特尔 | 瓦赫特尔 | wachtel
夏夫尔 | 希维尔 | shivell
马基宁 | 马基嫩 | makinen
拉基斯 | 拉雪兹 | lachaise
麦科瑙希 | 麦康瑙希 | mcconaughy
达维格多 | 达维多尔 | d'avigdor
加莱夫 | 加利夫 | galef
玛吉 | 马吉 | magi
达文 | 达温 | darwen
曼纳韦 | 马纳韦 | mannaway
梅恩 | 米恩 | meighen
基利 | 基利亚 | killea
维尔蒂斯科 | 弗迪斯科 | verdisco
图马 | 托伊马 | teuma
阿福蒂特 | 阿富尔蒂特 | affourtit
米塞尔 | 米赛尔 | misael
赫默里克 | 亨默里克 | hemmerich
黑伍德 | 希伍德 | heawood
詹宁斯 | 杰宁斯 | jenyns
斯坦姆斯 | 斯泰姆斯 | stames
塔伦斯 | 塔兰斯 | tarrance
切尼夫 | 坎尼夫 | cunniffe
比比 | 毕比 | beebe
卡尔德尔 | 考德尔 | caldell
博查特 | 博哈特 | borchardt
卡明 | 卡迈恩 | carmine
巴特伦 | 巴特拉姆 | bartram
佩尔 | 皮尔 | peile
麦康 | 麦肯 | mccon
麦卡里 | 麦凯里 | mccarey
克雷昂 | 克雷恩 | crayon
英芬特 | 因方特 | infant
卡赫 | 卡尔 | karrh
杰勒尔 | 杰拉尔 | gerall
亨内肯斯 | 亨尼肯斯 | hennekens
贾弗 | 贾埃弗 | giaever
贾米 | 杰米 | jamie
鲍尔霍恩 | 巴尔霍恩 | ballhorn
斯特吉斯 | 斯特奇斯 | sturges
莫克萨姆 | 莫克塞姆 | moxam
多 | 道 | daw
阿什登 | 阿什当 | ashdown
卡姆 | 卡尔姆 | culme
比克姆 | 比卡姆 | bickham
希尔曼 | 沙伊尔曼 | shireman
梅索利 | 梅索伊 | meszoly
科劳尔 | 科罗尔 | corrowr
埃森斯 | 埃森丝 | essence
格沃思尼 | 格瓦思米 | gwathmey
利布 | 利比 | luebbe
哈泽尔 | 黑兹尔 | hazell
克莱农 | 克勒农 | clernon
金德雷德 | 金德里德 | kindred
纳索尔 | 纳托尔 | nuthall
戴格 | 戴伊 | daigh
埃顿 | 埃泰恩 | etain
勒罗伊德 | 利罗伊德 | learoyd
廷肯 | 廷康 | tinkon
德弗雷茨 | 迪弗雷特斯 | defrates
奥尔文厄姆 | 阿尔文厄姆 | alvingham
尤拉姆 | 乌拉姆 | ulam
梅雷迪丝 | 梅雷迪思 | meredith
沙德伯格 | 谢德伯格 | schadeberg
蒂利 | 泰利 | tiley
格罗布 | 格罗比 | grobe
塔塔利诺 | 塔尔塔利诺 | tartaglino
亚历山大 | 达历山大 | d'alexander
鲍德斯顿 | 鲍尔德斯顿 | balderston
兰姆 | 拉姆 | lambe
卡德韦尔 | 考德威尔 | caldwell
泽米娜 | 泽米纳 | zemina
坎特伯里 | 坎特伯雷 | canterbury
塔肯 | 泰肯 | tacon
柯尔施 | 基尔希 | kirsch
古特马特 | 古特穆思 | gutermuth
弗森 | 费尔森 | ferson
托皮 | 托毕 | torpey
玛乔林 | 马乔林 | marjolin
泰希曼 | 泰克曼 | teichmann
普鲁德姆 | 普鲁多姆 | prudhomme
坎比 | 坎贝 | cumbey
赫姆尔 | 赫姆利 | hermle
蒙根 | 蒙贡 | mongon
亨佩尔 | 亨普尔 | hempel
艾罗 | 艾罗尔特 | ayrault
赖蒂娜 | 赖蒂纳 | rytina
里亚 | 雷 | rea
布赖登索尔 | 布赖登塔尔 | breidenthal
罗林格 | 罗林杰 | rollinger
德卢吉 | 德路易吉 | deluigi
科切雷斯 | 科克里斯 | cocheres
鲁德 | 鲁阿兹 | ruadh
格里特黑德 | 格雷特黑德 | greathead
巴斯凯特 | 巴斯克特 | baskette
埃塞雷达 | 埃塞丽达 | ethelreda
迪恩娜 | 迪恩纳 | dienna
博里尔 | 博雷尔 | boreel
布雷洪 | 布里恩 | brehon
盖尔 | 圭尔 | guire
厄丘克 | 尤尔丘克 | yurchuck
坦尼肯 | 滕尼肯 | tennican
科佩斯蒂克 | 科普斯蒂克 | copestick
麦金泰尔 | 麦金太尔 | mcintire
利夫内 | 莱文 | levene
克拉尔斯 | 克拉雷斯 | clares
朱林科 | 祖林科 | dzurinko
切普林斯基 | 西普林斯基 | cieplinski
索约纳 | 索杰纳 | sojourner
克努贝尔 | 努贝尔 | knubel
卡诺肯 | 卡诺坎 | carnochan
罗克辛 | 罗克西娜 | roxinne
萨尼普 | 萨格尼普 | sagnip
古妮拉 | 古尼拉 | gunilla
比哈里尔 | 贝哈里尔 | beharriell
朗彻姆 | 朗香 | longchamp
威尔希特 | 威尔海特 | willhite
洛伦兹 | 洛伦茨 | lorenz
特普尔 | 蒂普尔 | tepoel
贾莫 | 贾伊莫 | giaimo
库尔吉安 | 库尔金 | kuljian
克鲁克尚克 | 克鲁克香克 | crookshank
哈米利恩 | 哈米里恩 | hamilyon
利安妮 | 利安娜 | leanne
弗兰库姆 | 弗兰克姆 | frankum
基尔库西 | 基尔科西 | kilcoursie
雷森诺弗 | 里曾诺弗 | reasonover
查肯 | 查康 | chacon
雷布萨门 | 里布萨门 | rebsamen
克拉霍尔 | 克劳霍尔 | crawhall
托菲琴 | 托菲肯 | torphichen
哈鲁普 | 哈勒普 | harrup
沃格斯塔夫 | 瓦格斯塔夫 | wagstaffe
戈特尔斯 | 戈瑟尔斯 | goethals
黑特姆 | 哈特姆 | hatem
瓜尔蒂埃 | 瓜尔蒂耶里 | gualtieri
泽兰 | 齐伦 | zeran
比贝尔 | 比布尔 | biebel
奥尔兹泰尔 | 奥尔德斯泰尔 | oldstyle
西门斯 | 西门子 | siemens
普利本 | 普利邦 | plybon
拜克纳 | 比克纳 | beichner
恩霍尔姆 | 恩格霍姆 | engholm
惠特洛 | 怀特洛 | whytlaw
迪尤斯 | 德瓦斯 | dewas
兰内伯格 | 兰恩伯格 | ranneberger
桑德威克 | 桑威克 | sandwick
威思 | 韦思 | wyeth
施魏基尔德 | 施韦柴尔德 | schweichild
斯坦霍普 | 斯坦诺普 | stanhope
英沃尔兹塔德 | 英沃斯塔德 | ingvoldstad
森纳 | 桑戈尔 | senghor
布赖豪斯 | 布里格豪斯 | brighouse
克伦布哈尔 | 克伦巴尔 | krumbhaar
斯彭泽 | 斯潘塞 | spenser
莫拉尔 | 莫勒 | morar
弗里利 | 弗赖利 | friley
赖兰斯 | 赖伦斯 | rylance
鲍托尔 | 鲍塔尔 | boutall
奥德伯格 | 奥尔德伯格 | oldberg
贝尔兹 | 比尔兹 | beards
哈勒尔 | 哈拉尔 | harral
厄文 | 欧文 | ervin
哈扎德 | 哈泽德 | hazard
达姆谢克 | 达梅谢克 | dameshek
穆谢特 | 马希特 | mushet
杜切斯 | 达切斯 | dutchess
布鲁姆利 | 布伦利 | brumley
佩费克特 | 珀费克特 | perfect
比尔特 | 伯特 | birt
明 | 米恩 | min
菲格雷斯 | 菲格斯 | figures
埃格 | 埃加 | eggar
特库姆西 | 特库姆塞 | tecumseh
埃万杰莉塔 | 埃万杰利斯塔 | evangelista
韦布利 | 韦伯利 | webley
帕门蒂尔 | 帕尔芒捷 | parmentier
丁格利斯 | 迪安杰利斯 | deangelis
格里诺尔特 | 格里纳沃尔特 | greenawalt
麦格拉斯里奇 | 麦格拉斯里克 | macglasrich
索恩顿 | 桑顿 | thornton
巴洛克 | 巴洛赫 | balloch
切尔内斯基 | 切尔涅斯基 | chernesky
克龙 | 克朗 | kron
贝尔沃 | 贝尔维 | bellevue
布劳恩 | 布朗 | braun
特里利文 | 特里莱文 | treleaven
格罗斯密斯 | 格罗史密斯 | grossmith
比内尔 | 比尤内尔 | buesnel
哈格迈耶 | 哈格迈尔 | hagemeyer
阿拉蒙 | 阿拉芒 | allamong
西米恩 | 西明 | siemien
罗万德 | 罗安德 | rowand
普里亚尔 | 普赖尔 | prial
布利萨克 | 布利萨茨 | blisac
马尼斯 | 马内斯 | maness
拜德斯 | 比德兹 | bidez
艾威尔 | 厄维尔 | irwil
威尔梅特 | 薇尔梅特 | wilmett
霍米特 | 霍梅特 | homet
纳兰乔 | 纳兰霍 | naranjo
布雷兰 | 布里兰 | breland
奥金达希 | 奥金达基 | auchindachie
卡尼特 | 卡内特 | kanet
卡尔 | 卡利 | karle
阿德莉娜 | 阿德利娜 | adelina
斯特尔特 | 斯泰尔特 | stelter
科克伦 | 科克兰 | cockran
保斯 | 波斯 | paus
朱皮特 | 丘辟特 | jupiter
迪伊特里希 | 多伊特里希 | deutrich
托厄里 | 托尔里 | towery
马德林 | 马德琳 | madlin
威舍 | 维舍 | wischer
戴加德 | 迪格 | dygard
西克雷斯特 | 西克里斯特 | secrest
拉扎 | 拉扎尔 | lazar
麦高恩 | 麦古恩 | macgoun
佩茨 | 皮特斯 | petes
皮克斯 | 皮尔克斯 | pearkes
派伦斯 | 佩伦斯 | peirens
费尔哈文 | 费尔黑文 | fairhaven
索恩伯格 | 索恩伯勒 | thornburgh
特雷德格 | 特里迪加 | tredegar
佩洛 | 佩洛特 | pelot
埃瑟 | 阿瑟 | acer
阿蒂盖尔 | 阿蒂格尔 | attygalle
马西娅 | 玛西娅 | mathea
卡姆 | 凯姆 | kaim
彼得鲁斯卡 | 彼特鲁斯卡 | petruska
弗恩 | 维恩 | verne
尤迪切洛 | 尤迪塞洛 | iudicello
韦姆 | 瓦伊姆 | waim
鲁兰 | 鲁伦 | ruellan
拉赫特 | 拉克特 | lachter
拉哈布 | 雷哈布 | rahab
麦金纳尼 | 麦基纳尼 | macinerney
斯蒂格勒 | 施蒂格勒 | stigler
特威宁 | 特文宁 | twining
弗洛尔迪尤 | 弗劳尔迪 | flowerdew
盖兰 | 格兰 | gellan
吉梅内斯 | 希门尼斯 | jimenez
普勒 | 普拉 | pullar
韦尔纳 | 沃尔纳 | woellner
杜因特 | 德温特 | dewint
范福桑 | 范福森 | vanfossan
布拉德洛夫 | 布拉德洛 | bradlaugh
尼斯克伦 | 尼斯肯 | kniskern
布鲁因 | 布勒因 | bruyn
塔米海尔 | 塔米希尔 | tamihere
库劳 | 库罗 | courau
麦格罗瑟 | 麦格鲁瑟 | macgreuther
柯蒂尼厄斯 | 柯特纽斯 | curtenius
阿斯基思 | 阿斯奎思 | asquith
赫利娜 | 赫莉娜 | helina
帕策尔 | 普策尔 | putzel
斯特朗奇 | 斯特朗 | stronge
埃沃伊 | 伊沃伊 | evoy
戴伦弗思 | 迪伦弗思 | dyhrenfurth
坦盖 | 坦圭 | tanguay
拉斯布里奇 | 拉斯布里杰 | rusbridger
杜布拉斯 | 杜布拉 | dubras
亚兹明 | 亚斯明 | yazmin
劳德代尔 | 劳德戴尔 | lauderdale
奥尔德温 | 阿尔德温 | aldwin
伯贝奇 | 伯比奇 | burbage
科尔尼特 | 科尔内特 | collnette
波洛斯 | 普洛斯 | poulos
莱万多 | 柳安多 | lewando
韦德勒 | 维德勒 | vedeler
弗里岑 | 弗里曾 | fritzen
麦克米克尔 | 麦克迈克尔 | mcmichael
贝勒 | 贝尔赫 | bailhe
斯科克罗夫特 | 斯考克罗夫特 | scowcroft
根瑟特 | 金瑟特 | gensert
麦卡尔 | 麦考尔 | mackal
阿利曼 | 阿利芒 | allemang
赛克 | 赛什 | saich
沃克 | 沃恩克 | warnke
皮奥特罗夫斯基 | 彼得罗夫斯基 | piotrowski
贾恩 | 扬 | jahn
康加尔顿 | 康高尔顿 | congalton
杜克斯 | 杜阿克斯 | duax
戴森霍费尔 | 戴森霍弗 | deisenhofer
沙滕克 | 沙滕柯克 | schattenkerk
法隆 | 法伦 | falloon
奥斯威 | 奥斯威尤 | oswiu
米隆 | 米伦 | millon
艾利 | 艾莉 | eily
埃克恩 | 伊肯 | ekern
菲利恩 | 菲利翁 | filion
莫普斯 | 莫皮斯 | moppes
菲茨蒙斯 | 菲齐蒙斯 | fitzimons
阿尔维 | 阿利维 | alevey
帕塞尔 | 帕斯尔 | parcell
索尔 | 苏尔 | soul
尤多娜 | 尤多纳 | udona
迪多 | 戴德奥 | dedeo
塞达 | 西达 | theda
麦克雷思 | 麦克勒思 | mackereth
帕珀马斯特 | 佩珀马斯特 | papermaster
贝伦德斯 | 贝伦兹 | berendes
埃拉齐姆 | 伊拉齐姆 | erazim
施雷德 | 施拉德 | schrade
伯克 | 比尔克 | birck
巴托尔森 | 巴托尔松 | bartholdson
英格林 | 英林 | yingling
钱努廷 | 查纽廷 | chanutin
埃塞克 | 伊塞克 | esek
梅耶霍弗 | 迈尔霍费尔 | maierhofer
马伦普尔 | 马伦普雷 | malempre
阿尔顿 | 阿里顿 | arreton
莫尔菲 | 莫菲 | morfee
贝哈 | 贝亚 | beha
埃斯特斯 | 埃斯蒂斯 | estes
博尔多 | 波尔多 | bordeaux
德西德里厄斯 | 德西迪里厄斯 | desiderius
塔尔戈特 | 索尔戈特 | thalgott
布里克斯 | 布雷克斯 | breaks
舍恩巴克 | 舍恩巴赫 | schoenbach
马尼尔 | 马尼耶 | magnier
奥尔特林彻姆 | 奥特林厄姆 | altrincham
艾尔纳姆 | 埃努姆 | aernum
麦基里维 | 麦基雷维 | macilrevie
艾兴格琳 | 艾肯格林 | eichengreen
莱夫勒 | 莱弗勒 | leffler
科卡姆 | 科克姆 | corkum
黑文纳 | 哈文纳 | havenner
格威卡德斯 | 格威查德斯 | gwychardus
莫布斯比 | 莫布兹比 | mobsby
南迪 | 农迪 | nundy
赛尔斯 | 西尔斯 | cyres
阿奎奥 | 阿夸约 | aquayo
弗雷林休森 | 弗里林海森 | frelinghuysen
帕杰利斯 | 帕盖利斯 | pargellis
奥尔施塔特 | 阿尔斯塔特 | alstadt
布雷斯劳夫斯基 | 布雷斯拉夫斯基 | breslawsky
达夫尼 | 达夫妮 | daphne
瓦恩 | 瓦因 | vine
麦克莱夫 | 麦克拉夫 | mcclave
斯蒂尔斯 | 斯泰尔斯 | stiles
麦康奇 | 麦康希 | macconchy
桑德姆 | 桑达姆 | sandham
里穆斯基 | 里莫斯基 | rimouski
马宁 | 曼宁 | maning
布莱胡特 | 布拉胡特 | blachut
赫明 | 亨明 | hemming
特文加德姆 | 蒂文加杜姆 | tirvengadum
杰内罗 | 吉尼罗 | genero
比斯特 | 比伊斯特 | buist
拉拉莫尔 | 拉腊莫尔 | laramore
福韦尔 | 福尔韦尔 | faulwell
哈克 | 黑克 | hake
哈谢根 | 哈舍根 | hashagen
赖尔斯 | 赖亚尔斯 | ryalls
特里梅因 | 特里曼 | tremain
梅伦 | 默龙 | merron
鲁兹 | 吕埃 | ruez
怀曼 | 威曼 | wiman
拉德布罗克 | 拉德布鲁克 | ladbroke
奥斯莱格 | 奥恩斯莱格 | oenslager
哈加丁 | 哈格丁 | hargadine
莱克姆 | 利克希姆 | leikhim
沃奇沙夫特 | 沃特沙夫特 | wirtschafter
伊默斯 | 伊穆斯 | imus
托奇 | 托克 | toch
杜恩特 | 德温特 | dewenter
哈雷尔 | 哈勒尔 | harrel
斯普勒 | 施普勒 | spuhler
克里比尔 | 克雷比尔 | krehbiel
阿马尼 | 阿尔马尼 | armani
弗莱布 | 弗莱比 | flebbe
汤布斯 | 图姆斯 | tombs
达夫隆 | 杜弗隆 | duflon
谢里克 | 谢雷克 | sherek
哈纳 | 哈娜 | hana
贝恩 | 本 | benn
麦基利肯 | 麦基利坎 | mackillican
多里 | 多丽 | dorrie
法诺夫 | 法纳夫 | faneuf
罗克 | 罗奇 | roch
巴尔尼尔 | 巴尼尔 | balniel
菲林 | 法尔林 | firing
克莱姆 | 克莱米 | klemme
费尔 | 费雷 | ferre
安娜贝尔 | 安娜贝勒 | annabelle
布瓦文 | 博伊文 | boivin
福伊西 | 福西 | feusi
曾伯格 | 宗伯格 | zumberg
萨加 | 塞格尔 | sagar
恩格兰 | 英格兰 | england
艾琳妮 | 艾琳 | irene
利弗塞奇 | 利弗西奇 | liverseidge
基劳森 | 西劳森 | cilawson
阿布 | 阿贝 | abbe
博瓦斯方坦 | 博伊斯方丹 | boisfontaine
麦卡黑蒂 | 麦克哈蒂 | mccahearty
昂格斯 | 安格斯 | aongus
塞弗里 | 萨弗里 | savery
布赖滕菲尔德 | 布赖滕费尔德 | breitenfeld
伯格哈德 | 伯格哈特 | burghard
伊普 | 厄普 | earp
蒙多尔 | 蒙多 | mondor
格尔泽 | 盖尔泽 | gelzer
施赖纳 | 施里纳 | shriner
斯塔布尔菲尔德 | 斯塔布菲尔德 | stubblefield
弗皮利奥 | 韦皮勒 | verpilleux
汤南德 | 汤恩德 | townend
伊内斯 | 伊内兹 | inez
杰彭 | 杰波恩 | jepoen
麦肯恩 | 麦肯 | mackeng
伯肯霍尔茨 | 伯肯霍尔兹 | birkenholtz
默蒂斯 | 默特斯 | mertes
勒克特 | 勒基特 | luckett
古莎 | 古沙 | gousha
伊德 | 伊德尔 | eader
维诺格拉德 | 维诺格勒 | vinograd
安纳格莫尔 | 安纳克莫尔 | annaghmore
斯图德曼 | 斯蒂德曼 | studeman
勒利恩 | 勒林 | lelean
布里森 | 布赖森 | bridson
蒂林厄斯特 | 蒂林哈斯特 | tillinghast
珀里斯坦 | 皮里斯坦 | pearistine
纳尔米 | 纳米 | narmi
马达维克 | 马达维赫 | mhadavikh
戈勒布 | 戈卢布 | golub
达拉克 | 杜拉奇 | dullach
杜普卡克 | 杜普恰克 | dupcak
布拉登 | 布拉顿 | bradon
贝姆 | 巴姆 | bame
普利梅尔 | 普莱梅尔 | plymale
布罗梅特 | 布罗米特 | bromet
皮科瓦亚克 | 皮乔维亚克 | piechowiak
隆巴德 | 伦巴德 | lumbard
阿查博尔 | 阿查巴尔 | archabal
格罗贝格 | 格罗伯格 | groberg
普法勒 | 法伊勒 | pfeiler
霍莫尔卡 | 霍穆尔卡 | homolka
海斯伯格 | 海斯堡 | heisborg
费尔德布里尔 | 费德布里尔 | feldbrill
杰农 | 热农 | gernon
斯顿特 | 斯坦特 | stunt
埃利斯 | 埃莉丝 | elyse
伦格利 | 伦利 | lungley
克勒勒 | 克雷勒 | kroehler
谢米宁特 | 切米宁特 | cheminint
阿尔曼 | 奥尔曼 | alman
克丽扎 | 克里扎 | kryza
法斯纳特 | 法斯纳克特 | fasnacht
布根 | 巴根 | bugan
佩奇 | 皮奇 | pechey
施瓦姆 | 施万布 | schwamb
奥里 | 奥赖 | ory
艾尔弗里克 | 阿尔弗里克 | aelfric
艾尔加 | 艾尔格 | eylgar
耶伊 | 伊 | yee
索纳曼 | 索恩曼 | sonnemann
奥赞妮 | 奥赞 | ozanne
德汉 | 德哈恩 | dehaan
雷诺 | 雷纳 | raynor
弗西瓦尔 | 费西瓦尔 | fercival
松塔格 | 桑塔格 | sontag
塔利奥 | 图利奥 | tullio
福伊茜 | 福伊西 | foisie
麦肯 | 梅肯 | macon
戴维 | 达维 | davee
克莱弗 | 克拉弗 | claver
桑萨姆 | 桑森 | sansum
吉吉 | 吉盖 | giggey
达科姆 | 戴科姆 | dacombe
邦廷 | 邦坦 | bontein
多本 | 多宾 | doben
杰穆思 | 格穆思 | germuth
泰恩什 | 坦什 | tainsh
克雷斯皮涅 | 克雷皮尼 | crespigny
赫梅尔辛 | 休梅尔辛 | humelsine
马夸里 | 麦夸里 | maquarie
比尔基 | 伯基 | buerki
斯瓦德什 | 斯沃德什 | swadesh
巴贝尔 | 贝布尔 | babell
克拉丽达 | 克拉里达 | clarida
博德温 | 博德瓦恩 | bordwine
布朗塔斯 | 布龙塔斯 | brountas
梅耶森 | 迈耶森 | mayerson
德雷沃吉拉 | 德沃尔吉拉 | drevorguilla
奥弗拉赫蒂 | 奥弗莱厄蒂 | o'flahertie
塞维 | 西维 | sevey
鲍沃 | 鲍尔 | bouwer
克拉恩 | 克拉汉 | crahan
博克尔 | 博克 | boker
斯肯特 | 森特 | scent
埃肖 | 埃舒 | eshoo
戴布尔 | 戴贝尔 | deibel
马辛库斯 | 马辛克斯 | marcinkus
佩雷兹 | 佩雷斯 | perez
维泽 | 维佐尔 | vizor
西塔罗 | 塞塔罗 | setaro
蒂利 | 蒂莉 | tillie
赖格 | 里格 | riger
道德 | 多德 | dowd
阿利森 | 艾莉森 | alyson
德雷塞尔 | 德雷斯尔 | dressel
朱利 | 朱莉 | julie
埃德格利 | 埃奇利 | edgley
丹尼翁 | 达尼恩 | danyon
马休伦 | 马胡兰 | mahuran
克里布斯 | 克雷布斯 | krebs
佩耶 | 派尔 | peyer
波兰 | 普兰 | poulain
蔡伊 | 切赫 | czeh
西尔瓦纳斯 | 西尔维纳斯 | silvanus
埃克斯坦斯 | 埃克斯滕斯 | exstance
艾恩斯 | 安斯 | aines
普萨特里 | 普萨泰里 | pusateri
尼恩 | 奈恩 | nyhen
霍拉修斯 | 霍雷修斯 | horatius
埃迈尔 | 埃米尔 | emyr
沃克特 | 瓦克特 | wackett
罗巴蒂斯 | 罗巴茨 | robartes
阿格内洛 | 阿涅洛 | agnello
伊莱 | 艾莱 | ilay
内西尤 | 纳休 | nathiew
麦凯尔弗里什 | 麦克尔弗里什 | macelfrish
斯蒂格利茨 | 施蒂格利茨 | stiglitz
塞西利厄斯 | 塞西莉厄斯 | cecilius
纳登 | 内登 | naden
哈姆斯 | 黑姆斯 | hammes
查格尔斯 | 查格利斯 | chagles
麦凯克伦 | 麦凯琴 | maceachen
加南吉安 | 加南吉扬 | ganangiyan
古拉德 | 戈拉德 | goulard
考沃特 | 科沃特 | cowart
格罗杰 | 格罗格 | grogger
埃夫勒 | 埃弗勒 | effler
罗埃尔 | 罗亚尔 | royale
惠特塞特 | 惠特西特 | whitsett
赫克 | 赫德基 | hedke
勒克龙 | 莱克龙 | leckrone
布雷斯纳安 | 布雷斯纳汉 | bresnahan
波 | 鲍 | pow
拉克索尔 | 拉克斯尔 | wraxhall
曼柳斯 | 曼利厄斯 | manlius
佩恩 | 佩因 | pain
鲍夫曼 | 鲍曼 | baughman
布里梅科姆 | 布里马科姆 | brimacombe
莱托克 | 勒托克 | letocq
谢拉 | 希拉 | shelagh
内格尔 | 尼格尔 | negel
乔弗里翁 | 乔夫里翁 | joffrion
博恩 | 贝尼 | boehne
德沃拉克 | 德沃夏克 | dvorak
梅约斯 | 梅杰斯 | majors
塔吉 | 塔姬 | taggy
巴克纳 | 巴赫纳 | bachner
蒂格雷特 | 泰格雷特 | tigrett
卡迪尤 | 卡迪厄 | cadieux
托莱斯特拉普 | 托尔斯特拉普 | tollestrup
凯嫩 | 凯南 | kainen
德普图克 | 德普塔克 | deptuck
莱利 | 利 | ley
格尔 | 吉尔 | gehl
迪斯特伯格 | 杜斯特伯格 | duesterberg
利德福 | 利德福德 | lydford
希彻尔 | 希切尔 | hitchell
菲恩 | 费恩 | feane
科宁 | 科奈恩 | conein
巴尔诺 | 巴诺 | barno
格雷博 | 格里博 | grebow
弗里斯 | 弗雷斯 | frece
朗莱因 | 朗莱恩 | longhlein
埃尔斯 | 埃利斯 | elles
德斯巴拉茨 | 德巴拉茨 | desbarats
沃拉克 | 沃勒克 | wallack
卡尔尼 | 卡奈尔尼 | carnearney
坦嫩鲍姆 | 特南鲍姆 | tennenbaum
霍奇根 | 霍根 | hodgan
卡奇亚 | 卡夏 | cachia
萨里特 | 萨雷特 | sarett
阿杰里斯 | 阿吉里斯 | argeris
明尼特 | 明妮特 | minnette
安斯帕克 | 安斯帕赫尔 | anspacher
贾西诺夫斯基 | 贾西诺斯基 | jasinowski
沃尔西奥夫 | 瓦尔塞奥夫 | waltheof
拉苏亚诺 | 拉普阿诺 | rapuano
塔伯特 | 塔尔伯特 | talbert
安德雷斯 | 安德烈斯 | andress
埃尔斯皮 | 伊丽莎白 | elspie
哈根 | 黑根 | hagan
维特拉切尔 | 维特拉西尔 | vytlacil
托普尔 | 托佩尔 | topple
塔姆斯 | 泰晤士 | thames
斯维克 | 斯韦克 | svec
斯坦布勒 | 斯坦伯勒 | stanbrough
肯奈尔德 | 肯奈德 | kennaird
莱克拉斯 | 勒克拉 | lecras
安德琳 | 安德林 | andelin
斯普赖尔 | 斯普雷耶 | spreyer
艾克纳 | 艾希纳 | eichner
费拉奥 | 费劳 | ferrao
奥弗拉赫蒂 | 奥弗莱厄蒂 | o'flaherty
博内斯蒂尔 | 博恩斯蒂尔 | bonesteel
克里恩 | 克林 | crean
萨马罗 | 萨马鲁 | samaroo
维妮塔 | 维尼塔 | vinita
皮尔克 | 珀基 | pyrke
恩布林 | 恩布琳 | emblin
卡尔索普 | 考尔索普 | calthorpe
森 | 特森 | thesen
吉尔德豪姆 | 吉尔多姆 | guildhaume
埃夫尤 | 埃维尤 | evjue
法诺伊尔 | 法纳尔 | faneuil
雷塔 | 里塔 | rheta
波 | 普 | poo
伯尼特 | 伯内特 | burnett
里查特 | 理查特 | richart
朗尼格 | 朗内加 | runnegar
麦克莱恩 | 麦克林 | mcclean
扬杰 | 扬格 | younger
多尔杰 | 德尔格 | dolger
赫贝斯特赖特 | 赫布斯特雷特 | herbestreit
赫尔斯顿 | 赫尔斯特恩 | hellstern
诺埃布 | 诺韦布 | norweb
普尔斯顿 | 普利斯顿 | puleston
埃杰曼 | 埃格曼 | egerman
奥尔盖尔 | 奥尔盖耶 | allgaier
迪林 | 迪尔林 | deerlin
科森 | 科瑟恩 | cothern
埃尔斯 | 埃尔威斯 | elwes
塔弗 | 塔沃尔 | tavor
韦尔 | 韦伊尔 | weiher
韦特 | 维特尔 | vetter
赫米恩 | 赫米奥娜 | hermione
约翰森 | 约翰逊 | johnson
杭德里奇 | 杭德里克 | honderich
利伯廷 | 利伯蒂娜 | libertine
达利佩尔兹 | 达莱佩泽 | dallepezze
迈尔斯特拉普 | 迈尔斯特勒普 | meilstrup
朗斯莱特斯 | 朗斯利特斯 | launceletus
埃德利 | 埃德尔 | ederle
阿迪奥 | 阿德奥 | addeo
韦恩 | 惠恩 | whayne
布菲 | 巴菲 | buffey
德拉埃 | 德拉鲁 | delarue
格恩斯巴克 | 根斯巴克 | gernsback
比尔 | 伯尔 | birr
韦因 | 韦恩 | wain
邓坎森 | 邓肯森 | duncanson
高迪安 | 高迪恩 | gaudian
迪尔 | 代尔 | diel
迪思里希 | 迪特里希 | diethrich
迪海 | 德海 | dehay
克里斯坦 | 克里斯廷 | kristine
布拉米尔斯 | 布拉迈尔斯 | blamires
沃索 | 瓦索 | wasow
列昂提耶夫 | 列昂季耶夫 | leontiev
吉亚迪 | 吉亚尔迪 | ghiardi
阿勒姆 | 奥勒姆 | allam
博迪科姆 | 博迪库姆 | bodycombe
施韦尔布 | 施韦布 | schwelb
伊森诺尔 | 艾泽努尔 | izenour
比雷 | 布雷 | buhre
雅科布斯坦 | 雅各布斯坦 | jacobstein
戈 | 高 | gow
鲁纳夫 | 雷纳夫 | ranulph
特里里斯 | 特里赖斯 | trerise
帕尼特 | 帕内特 | panet
罗恩 | 龙尼 | ronne
平科特 | 平肖 | pinchot
伊尔格 | 伊尔克 | ilg
查森 | 蔡森 | chasen
科佩拉 | 科皮拉 | coppela
朱拉布基安 | 朱拉布奇安 | joorabchian
斯顿博 | 斯通博 | stombaugh
斯拉特里 | 斯莱特里 | slattery
埃尔马思 | 厄马思 | earmarth
希拉克 | 希莱克 | shillaker
贝格尔曼 | 比格尔曼 | begelman
梅约 | 梅奥 | mayo
达纳万特 | 杜纳万特 | dunavant
基珀斯 | 凯珀斯 | kuipers
梅因多尔德 | 梅因唐纳德 | maindonald
麦卡勒里 | 麦卡利里 | mcalery
哈兹尔廷 | 黑兹尔坦 | hazeltine
米希尔 | 迈伊尔 | mighill
赫曼 | 希曼 | heman
恩斯拉德 | 恩斯鲁德 | ensrud
布罗瑟 | 布拉泽 | brother
赛恩 | 锡恩 | thynne
弗里斯 | 弗里亚斯 | freas
平尼 | 派尼 | piney
布里安 | 布赖恩 | brian
多克勒 | 多克拉 | dockwra
勒滕德尔 | 勒滕德 | letendre
杰斯 | 杰西 | jesse
莱韦斯丘 | 莱韦斯克 | levesque
奥德里 | 奥德丽 | audrey
约瓦诺维奇 | 约万诺维奇 | yovanovitch
皮厄什 | 皮尤什 | piyush
丹尼罗 | 达尼罗 | daniero
英奇金 | 英奇昆 | inchiquin
津巴尔多 | 津巴多 | zimbardo
多嫩费尔德 | 多宁费尔德 | donenfeld
沃尔德雷普 | 沃尔德里普 | waldrep
德马西奥 | 德马肖 | demascio
穆科夫斯基 | 穆科斯基 | mukowski
泽凯拉 | 泽克拉 | zechella
考莉 | 凯莉 | kallie
斯凯特 | 斯卡特 | skate
布古德 | 布古尔 | bougourd
塞文 | 西文 | sevin
内泽克 | 内姆泽克 | nemzek
庞纳彼珀拉 | 庞南佩鲁马 | ponnamperuma
米曾 | 迈曾 | mizen
洛梅尔 | 隆梅尔 | lommel
马赫 | 马奇 | much
金尼弗 | 珍妮弗 | gennifer
查萨尼斯 | 沙萨涅 | chassagnes
艾尤托 | 阿尤托 | aiuto
鲍夫鲁德 | 鲍赫鲁德 | boughrood
吉隆 | 吉伦 | gillon
多沃德 | 道尔德 | doward
基尔里 | 基里 | kearey
沃克 | 瓦克尔 | wacker
弗兰兹 | 弗朗兹 | franz
米泽尔 | 米泽勒 | mizelle
托雷斯 | 托里斯 | torres
沃利本 | 沃莱本 | wohlleben
普法尔茨格拉夫 | 法尔茨格拉夫 | pfaltzgraff
玛丽恩 | 马里恩 | maryon
沃申科 | 瓦申科 | washenko
博尼特 | 博内特 | bonett
伊利特 | 艾利特 | ilett
马库斯 | 马库塞 | marcuse
欧明格 | 艾尔明格 | irminger
伊布斯利 | 耶布斯利 | yeabsley
阿伦 | 艾伦 | allen
布贾克 | 布亚克 | bujake
约瑟姆 | 乔撒姆 | jotham
加诺 | 加诺特 | garnaut
温切尔西亚 | 温切尔西 | winchelsea
古卡斯 | 古奥卡斯 | guokas
科萨塔 | 科苏塔 | cossutta
迪特特 | 迪泰特 | dittert
达尔菲 | 德菲 | durfee
克里维利 | 克里韦利 | crivelli
菲查尔温 | 菲茨艾尔温 | fitzailwyn
埃迪生 | 埃迪森 | eddison
希金博瑟姆 | 希金博特姆 | higinbotham
登宁 | 丹宁 | denning
比柳 | 比利厄 | bilyeu
毛尔 | 莫尔 | maule
马杰 | 马季 | marj
布加斯 | 巴加斯 | bugas
比罗尔 | 伯罗尔 | berall
施威默 | 施维默 | schwimmer
凯特伦 | 卡特伦 | catron
斯威特基 | 斯威凯 | switkay
兹巴斯基 | 兹巴尔斯基 | zbarskiy
贝格尔 | 贝尔 | beighle
梅奥 | 梅约 | maio
卡通 | 卡顿 | kartun
西利耶 | 特威利尔 | thuillier
戴亚曼特 | 迪亚曼特 | diamant
戈特格鲁 | 戈特格特鲁 | gottgetereu
赫伦布兰德 | 海伦布兰德 | hellenbrand
厄布 | 厄尔布 | erb
锡茜 | 锡西 | cissie
莱兰 | 利兰 | lelland
弗雷德丽卡 | 弗雷德里卡 | fredrica
温泽尔 | 温策尔 | wenzel
巴蒙特 | 贝蒙特 | bamont
奥尔德希泽 | 奥尔迪泽 | aldhizer
洛弗林 | 洛夫林 | lovering
纳吉恩 | 纳金 | nagean
贝格尔 | 比格尔 | begel
道兹韦尔 | 多德斯韦尔 | dowdeswell
达尔 | 杜尔 | durr
托宁 | 索宁 | thorning
米齐 | 梅齐 | meazey
格鲁乔 | 格劳乔 | groucho
戴伦弗思 | 迪伦弗思 | dhyrenfurth
扬克威奇 | 扬克维奇 | yankwich
萨奇曼 | 塞奇曼 | sageman
克尔切维尔 | 克切维尔 | kercheville
德西雷 | 德西蕾 | desiree
凯利 | 丘利 | kewley
麦金图夫 | 麦金塔夫 | mcinturff
莫尔福德 | 莫维兹 | morfudd
桑克利 | 尚克利 | sankley
怀斯坦 | 威斯坦 | wystan
吉尔休利 | 吉尔胡利 | gilhuly
博德温 | 鲍德温 | bodwine
勒斯 | 卢斯 | luss
欧斯 | 奥恩斯 | owns
鲍科姆 | 鲍库姆 | bawcombe
莱苏夫 | 勒瑟夫 | lesurf
查伦格 | 查林杰 | challenger
塞特 | 撒特 | thaete
弗朗西娅 | 弗朗西亚 | francia
亨特雷斯 | 亨特里斯 | huntress
图奥萨宁 | 蒂乌萨宁 | tiusanen
赛博尔德 | 西博尔德 | seybold
米尔德万 | 米尔德文 | mildvan
金凯尔尼 | 金凯尼 | kincairney
马斯曼 | 穆斯曼 | mussman
沃尔朗德 | 沃尔龙德 | walrond
蒙塔文 | 蒙塔冯 | montavon
萨奇 | 萨特杰 | satge
贾尼斯 | 贾尼西 | janisse
迪西 | 达西 | duthie
加汉 | 加恩 | gahan
德拉波 | 德拉珀 | drapeau
梅尔谢默 | 梅尔斯海默 | melsheimer
巴里克 | 巴威克 | barwick
霍奇加特 | 霍贾特 | hodgart
德斯博伊斯 | 德布瓦 | desbois
斯韦布 | 斯韦比 | swaebe
弗鲁伊特 | 弗鲁特 | fruit
伊利恩 | 伊尔伦 | illearn
阿布洛姆 | 阿布隆 | ablom
埃斯梅尔 | 伊斯梅尔 | esmail
沃滕伯格 | 瓦滕伯格 | wattenberg
阿迪内特 | 阿迪尼特 | adinet
吉尔克雷斯特 | 吉尔克里斯特 | gilchrest
霍伊贝克 | 胡尔贝克 | houiellebecq
布希 | 布舍 | busche
卡梅尔福德 | 卡姆尔福德 | camelford
毕伊 | 布伊 | buie
马尔沙恩 | 马尔夏恩 | mulshine
埃莱克特拉 | 伊莱克特拉 | electra
查费茨 | 查菲茨 | chafetz
瑟米厄斯 | 瑟缪斯 | sermeus
艾克瑟 | 伊克瑟 | ixer
安杰尔斯 | 安杰利斯 | angeles
耶曼斯 | 伊曼斯 | yeamans
艾恩 | 伊坎 | icahn
罗伊尔 | 鲁埃尔 | reuel
森 | 图恩 | thun
泰瑟 | 特瑟 | tether
海森 | 希森 | hyson
吉诺尔 | 格瑙尔 | genauer
克莱夫 | 克拉夫 | clave
蒙托纳 | 蒙顿纳 | montonna
卡莎 | 卡沙 | kasha
利多姆 | 利德姆 | leedom
马拉布尔 | 梅拉伯 | malabre
苏里纳 | 苏雷纳 | surena
利希特瓦特 | 利希特瓦尔特 | lichtwardt
奥弗罗尔 | 奥费拉尔 | o'ferrall
马琴 | 梅琴 | machen
希登 | 黑登 | headon
塔舍罗 | 塔什罗 | taschereau
埃廷杰 | 埃廷格 | ettinger
福尔维 | 法尔维 | falvey
查彭 | 沙蓬 | chapone
克里斯皮安 | 克里斯皮尼安 | crispinian
林迪 | 琳迪 | lynndie
卡林 | 卡莱恩 | carline
艾利 | 艾尔利 | airlie
甘博尔 | 甘博亚 | gamboa
康伯 | 库默 | comber
赫施 | 胡希 | husch
阿克利 | 埃克利 | akeley
尤泽 | 尤伊泽 | ueyser
奥拉 | 奥尔拉 | orla
西拉 | 赛拉 | thyra
阿达布 | 阿达博 | addabbo
卡丹 | 卡登 | kadane
阿夫伯里 | 埃夫伯里 | avebury
图奥希 | 图伊 | tuohey
维利拉洛博斯 | 比利亚洛沃斯 | villalobos
卢什 | 勒什 | lush
迪达姆 | 迪德姆 | deedham
纳尔 | 诺尔 | nall
格特威思 | 格特沃思 | gutwirth
格维茨 | 格威茨 | gurwitz
德梅特 | 德梅特尔 | demaitre
贝里 | 比尔里 | beary
塞吉恩 | 塞金 | seguin
达姆勒 | 杜姆勒 | dumler
莱奥尼达斯 | 利奥尼达斯 | leonidas
海恩菲尔德 | 汉费尔德 | hainfeld
沃拉 | 瓦拉 | walla
伊尔德赫姆 | 埃尔德姆 | ealdhelm
斯托尼克 | 斯托尔内克 | stalnecker
马杰里 | 马格丽 | margery
德尔维斯 | 德尔夫斯 | delves
贝尔沃尔德 | 贝瓦尔德 | baerwald
盖伊 | 贾伊 | ghey
雷姆斯 | 里姆斯 | rheims
蒙特姆 | 蒙特卡姆 | montcalm
普拉格 | 普拉奇 | plugge
基约 | 凯乔 | kejoa
博斯顿 | 波士顿 | boston
哈芬 | 赫法恩 | huffine
瑟希 | 塞希 | sershey
拉克斯克里思 | 拉克斯弗里思 | laxfrith
埃诺 | 伊诺 | eno
塞利格曼 | 塞利希曼 | seligmann
加韦德 | 加维德 | gaved
科奇尼希 | 科奇尼格 | kotschnig
斯特雷姆劳 | 斯特里姆劳 | stremlau
德朗古尔 | 德罗姆古尔 | dromgoole
拜尔 | 贝耶尔 | beier
塞瓦克 | 瑟瓦奇 | serwach
埃斯琳 | 阿斯林 | acelin
萨比 | 萨德贝 | sudbay
阿菲 | 埃菲 | afee
西德博特姆 | 赛德博特姆 | sidebotham
格德 | 格尔德 | gerd
埃克洛夫 | 埃克勒夫 | eklof
博格泰特 | 博格蒂尔 | boghatyr
芬格勒 | 芬勒 | fengler
阿利尼安 | 阿莱尼安 | alleynian
伊德弗里德 | 埃德弗里德 | eadfrid
奥因 | 约恩 | eoin
索 | 托 | thau
西德尼 | 西妮 | sydni
法克托 | 法克特 | factor
朱埃特 | 朱厄特 | jouett
班顿 | 贝恩顿 | baynton
塞格尔 | 西格尔 | seigel
约克威廉斯 | 约克威廉 | yorkwilliams
弗拉利克 | 弗雷利克 | fralick
塞尔娜 | 塞尔纳 | serna
伦嫩 | 伦南 | lennen
罗杰特 | 罗热 | roget
阿尔多纳斯 | 奥尔多纳斯 | aldonas
弗雷伊 | 弗雷 | frej
阿伯恩 | 阿本 | abern
伊登 | 艾登 | idden
迪安尼斯 | 迪亚尼斯 | dianis
希格内特 | 希格尼特 | hignett
谢夫茨伯里 | 沙夫茨伯里 | shaftesbury
杜庞特 | 杜邦 | dupont
克利姆克 | 克利姆基 | klimcke
赫尔布尔 | 赫布尔 | helble
比尔布勒 | 比尔伯勒 | bilbrough
昂布雷特 | 昂布里特 | umbreit
布劳恩 | 布朗 | browne
凯高 | 凯加鲁 | caegarw
赫沃斯 | 休沃斯 | huvos
勒热 | 利热 | leasure
萨姆斯塔格 | 扎姆斯塔格 | samstag
贾格斯 | 贾格尔斯 | jaggers
萨基纳 | 萨金娜 | sakinah
勒福 | 勒方 | lefaune
拉夫斯洪 | 拉夫肖恩 | rafshoon
贝曼 | 比曼 | beman
谢费特 | 索伊弗特 | seufert
斯坦纳姆 | 斯塔纳姆 | stanham
阿克申 | 埃克申 | action
马因沙因 | 梅恩沙因 | maienschein
齐默曼 | 齐梅曼 | zimmeman
桑兹 | 桑德斯 | sondes
班恩 | 班 | bang
穆普森 | 马普森 | mupson
埃尔利 | 埃尔勒 | ehrle
勒克赫斯特 | 卢克赫斯特 | luckhurst
范迪维耶 | 范迪维尔 | vandivier
卡罗尔 | 卡萝尔 | carole
爱丁格 | 埃丁格 | edinger
德维尔 | 德韦尔 | deveulle
麦高兰 | 麦戈兰 | mcgauran
登帕赛 | 登帕西 | dempasay
马格尼 | 马格内 | magnay
朗伊诺 | 朗吉诺 | longino
格林斯特德 | 格林斯蒂德 | grinstead
阿尔文 | 奥尔文 | allvine
莱因尼斯 | 莱因德尼斯 | rhindness
克纳夫 | 纳夫 | knaff
米多斯 | 梅多斯 | meadows
帕德西 | 帕齐 | pudsey
罗尔夫斯 | 罗卢夫斯 | rolufs
塞尔诺维奇 | 切尔诺维奇 | cernovitch
奈斯利 | 尼斯利 | knisely
莱加特 | 莱格特 | legatt
尼科莱迪斯 | 尼古拉迪斯 | nikolaidis
戈利特利 | 戈莱特利 | golightly
芒尼克森 | 芒尼克海森 | munnikhuysen
奇尔德 | 蔡尔德 | child
贾科威茨 | 尤尔科维茨 | jurkowitz
鲁宾斯坦 | 鲁本斯坦 | rubenstein
舒 | 舍韦 | schewe
麦金金 | 麦克琼金 | mcjunkin
普 | 格普 | gup
拉贝特 | 拉贝 | rabet
吉格雷 | 吉格尔 | giguere
麦克法迪安 | 麦克法迪恩 | mcfadyean
卢内德 | 莉内德 | luned
库明 | 卡明 | cumin
科克兰 | 科克伦 | cochrane
布扎娜 | 布尔扎纳 | brzana
莫尔霍尔特 | 莫霍尔特 | molholt
阿加西亚 | 阿加西娅 | agacia
西克斯 | 赛克斯 | sikes
奥瑟顿 | 奥尔瑟顿 | altherton
布雷恩特里 | 布伦特里 | braintree
钱伯尔辛 | 钱伯辛 | chamberlsin
格辛格 | 格青杰 | getsinger
欧维特 | 艾尔薇特 | irvette
艾舍伍德 | 伊舍伍德 | isherwood
德尼奥 | 迪奈欧 | denio
卡琳娜 | 卡伦娜 | karenna
基尔 | 基利 | kille
奥西尼尔 | 奥塞内尔 | othenel
马尼奥利亚 | 马格诺利娅 | magnolia
埃勒斯米尔 | 埃尔斯米尔 | ellesmere
巴洛雷亚 | 巴洛伊拉 | baloyra
戴西 | 黛西 | daisy
沃塞姆 | 沃特海姆 | wertheim
克里斯特戈 | 克里斯戈 | christgau
奥科因 | 奥库安 | aucoin
彼得罗 | 佩特罗 | petro
诺科伊 | 诺基 | norquoy
马克厄姆 | 梅卡姆 | makeham
齐默 | 泽默 | zemmer
斯特罗布里奇 | 斯特劳布里奇 | strawbridge
希肯布珀 | 希肯卢珀 | hickenlooper
巴尔塔瑟 | 巴尔塔泽 | baltassar
迪克 | 杜凯 | duque
海尔卡伊 | 海尔基 | heilkay
弗利金格 | 弗利金杰 | flickinger
泽比纳 | 泽拜纳 | zebina
布拉夫 | 布劳 | blough
格拉斯戈 | 格拉斯哥 | glasgow
赫琴格 | 赫金杰 | hechinger
哈恩迪 | 哈内迪 | harnedy
斯梅耶 | 斯梅奇 | smaje
奥利文特 | 奥利万特 | ollivant
布利肯施塔夫 | 布利肯斯塔夫 | blickenstaff
麦克尔莫尔 | 麦克勒莫尔 | mclemore
麦克费德兰 | 麦克费德伦 | macphedran
奥迪吉尔 | 奥迪吉耶 | audigier
赫蒙 | 哈蒙 | hummon
伯特豪德 | 伯绍德 | berthoud
奥尔卡尔德 | 阿尔卡德 | alcalde
比奥利 | 比利 | beoley
迪恩 | 丁 | din
古比托希 | 古比托西 | gubitoshi
比塔 | 比塔尔 | bitar
达尔维奇 | 达利奇 | dulwich
格罗塞斯特 | 格罗斯泰特 | grosseteste
施蒂贝林 | 斯蒂贝林 | stiebeling
洛基尔 | 洛希尔 | lochiel
弗里尔 | 弗雷耶 | freyere
斯康菲尔德 | 舍恩菲尔德 | schonfield
斯托尔普曼 | 施托尔普曼 | stolpman
米丁 | 梅丁 | medin
弗兰普欣 | 弗兰普申 | framption
博雷特 | 博里特 | borrett
迈克尔约翰 | 米克尔约翰 | meiklejohn
费切姆 | 费克姆 | feachem
拉坎潘 | 拉康帕涅 | lacampagne
索维奇 | 索瓦热 | sauvage
赫曼 | 赫尔曼 | herman
凯特 | 奈特 | knight
古布尔曼 | 古贝尔曼 | gubelmann
科帕德 | 科珀德 | coppard
斯塔尔斯 | 斯泰尔斯 | stares
埃尔齐 | 埃尔扎伊 | elzay
韦格索 | 维格索 | vegso
索尔韦因 | 索尔温 | sauerwein
巴思 | 巴特 | barthe
埃斯科菲 | 伊斯科菲 | escoffey
吉利亚姆 | 吉列姆 | gilliam
皮埃勒 | 皮埃尔 | pierre
博施威茨 | 博希威茨 | boschwitz
哈德格里 | 哈迪格里 | hardegree
皮尔 | 珀尔 | pearl
维拉雷尔 | 维拉里尔 | villarreal
伊格莱维奇 | 伊格尔维奇 | iglewicz
洛西安 | 洛西恩 | lowthian
多姆安 | 多米扬 | domjan
阿巴斯特尼亚 | 阿巴斯蒂尼亚 | abastenia
阿利斯 | 阿莱斯 | allies
海伊泽 | 哈伊泽 | huyser
康马格 | 康马杰 | commager
卡拉佩兰 | 卡拉佩琴 | carapetyan
布里宁 | 布赖宁 | bryning
格利多尔 | 格利德尔 | gleadall
麦克琴 | 麦克钦 | mccheane
克拉布里 | 克拉布特里 | crabtree
埃里特 | 埃雷特 | ehret
特洛 | 特略 | tello
博切特 | 博塞特 | botset
威克斯蒂德 | 威克斯第德 | wicksteed
斯科格伦 | 斯科格隆 | skoglund
海尔兹 | 希尔兹 | hilds
拉萨尔 | 拉萨 | lassar
温塔尔 | 温特尔 | weintal
贾夫 | 贾菲 | jaffe
斯塔姆 | 施塔姆 | stamm
法扎 | 法扎尔 | fazar
多恩 | 杜恩 | doune
马塞尔 | 玛塞勒 | marcelle
尤文斯 | 尤温斯 | uwins
赫赫尔斯基 | 切赫尔斯基 | cehelsky
尤莱维奇 | 乌莱维奇 | ulevich
达尔斯特龙 | 达尔斯特伦 | dahlstrom
勒肯 | 卢肯 | lukken
德黑斯 | 德海斯 | dehayes
马顿 | 梅顿 | maton
希拉 | 夏伊拉 | shyla
比恩 | 比汉 | beehan
肯利 | 肯里 | kenrie
法尔肯海姆 | 福尔肯海姆 | falkenheim
洛恩 | 洛温 | lowen
伊利希 | 伊利格 | illig
贝默赛德 | 比默赛德 | bemersyde
米姆诺 | 明诺 | mimno
罗明 | 罗梅因 | romeyn
扬格斯本德 | 扬哈斯本 | younghusband
夏皮 | 沙比 | sharpey
莱西奇 | 勒萨热 | lesage
巴布利斯 | 布勃利斯 | bublys
伯特霍尔夫 | 伯索夫 | bertholf
戴文波特 | 达文波特 | davenport
舒特利夫 | 舒特莱夫 | shurtleff
斯波特德 | 斯波蒂德 | spotted
乔齐 | 乔茜 | jozy
迪安 | 戴安 | dian
赞布鲁姆 | 赞布勒姆 | zambrum
马霍恩 | 马洪 | mahone
劳克哈夫 | 劳卡夫 | laukhuff
米尔希 | 米尔海 | milhy
卡德根 | 卡杜根 | cadwgan
博希尔 | 博舍尔 | boshier
博维 | 博韦 | bovee
赫克顿 | 赫克通 | hektoen
莱维 | 利瓦伊 | levi
查斯 | 蔡斯 | chayes
克里亚 | 克雷 | crea
乔尔万 | 朱尔万 | joulwan
库佐克 | 库佐克雷亚 | cuzzocrea
韦德伍德 | 韦奇伍德 | wedgwood
阿德基森 | 阿基森 | adkisson
施莱 | 施利 | schlie
伊菲根 | 伊菲吉妮 | iphigene
塞金格 | 塞金杰 | seckinger
泰菲恩 | 泰维恩 | teifion
亚历克西斯 | 亚历克西丝 | alexys
本贾明 | 本杰明 | benjamin
拉罗姆 | 拉勒姆 | larom
古茨威勒 | 古茨维勒 | gutzwiller
拉金 | 勒德金 | ludgin
阿尔皮娜 | 阿尔皮纳 | alpina
韦勒尔 | 沃雷尔 | werrell
福尔兹 | 福尔茨 | folz
德福德 | 德福特 | deford
博比萨德 | 博比苏德 | bobisud
图尔 | 特尔 | tourle
图利特 | 塔利特 | tulett
斯塔克 | 斯图克 | stucke
尚伯格 | 舍恩伯格 | schonberger
兰贝利特 | 兰伯利特 | lambelet
康希尼克 | 康施尼克 | konschnik
盖伊 | 贾伊 | gye
利希滕斯坦 | 利克滕斯坦 | liechtenstein
安鲁斯凯维奇 | 安德鲁斯克维奇 | andruskevich
托德雷斯 | 托德雷亚斯 | todreas
布金 | 布尔金 | bourgin
比 | 布埃 | bue
奥尔钦 | 阿尔钦 | alchin
阿韦斯 | 阿维丝 | aveis
黑吉斯 | 海吉斯 | haigis
基珀 | 凯珀 | kuiper
斯特兰格 | 斯特兰杰 | stranger
阿伦 | 阿龙 | aaron
马尔克斯 | 马尔库斯 | malkus
齐恩 | 蔡恩 | zion
格尔巴赫 | 盖尔博 | gelbach
布雷克兰 | 布里克兰 | brekland
布瓦拉 | 布阿哈拉 | buachalla
沃尔克 | 沃克 | walke
考特尼 | 考特妮 | kourtney
库尔 | 屈尔 | kuehl
麦克雷迪 | 麦克拉迪 | mccrady
比利尔 | 比埃 | billiere
库利希 | 库利格 | kulig
埃尔坎 | 埃尔肯 | elkan
普钦斯基 | 普辛斯基 | pucinski
杰拉特 | 贾勒特 | jarratt
尼科利 | 尼古拉 | nicolay
塔图莱斯 | 塔图尔斯 | tatooles
撒尔肯 | 萨尔肯 | thalken
基米特 | 金米特 | kimmitt
克罗斯门 | 克罗斯蒙 | croasmun
乔登斯 | 乔丹斯 | jordans
赖津 | 里津 | ryzin
库德韦尔 | 库尔德韦尔 | couldwell
索利兹 | 索莱 | saulez
斯坦西克 | 斯坦奇克 | stanczyk
保林 | 波林 | paulin
巴托莱缪 | 巴托洛缪 | bartholemeu
塔尼娅 | 塔妮娅 | tania
西克 | 瑟克 | cirker
德文特 | 德温特 | derwent
恩德科特 | 恩迪科特 | endecott
阿尔文 | 阿尔温 | alwin
霍伊塞尔 | 休塞尔 | heusel
莱弗勒 | 莱弗拉尔 | leflar
罗莎佩普 | 罗萨皮普 | rosapepe
赫宁伯格 | 赫宁堡 | heningburg
巴萨德 | 巴萨德雷 | basadre
福伊尔泽格 | 福伊尔齐格 | feuerzeig
派约特 | 派奥特 | pyott
塞勒斯 | 塞拉斯 | sellars
梅勒普斯 | 梅拉普斯 | mellups
巴尔西格 | 巴尔西杰 | balsiger
希拉伯 | 希莱伯 | shillaber
斯卡普西特 | 斯卡尔普西特 | sculpsit
斯蒂夫斯 | 斯特弗斯 | steffes
卡斯特尔伯里 | 卡斯尔伯里 | castelberry
吉尔鲍德 | 吉尔博 | guillebaud
贝歇特 | 贝谢 | bechet
梅利奥尔 | 梅莉奥尔 | melior
鲁马塞特 | 罗马塞特 | roumasset
比阿特丽娅 | 比阿特丽西娅 | beatricia
福法尔 | 福法 | forfar
梅努欣 | 梅纽因 | menuhin
凯格 | 基格 | keig
菲阿尔卡 | 菲亚尔卡 | fialka
赫米斯 | 赫姆斯 | hemmes
艾萨科 | 伊萨科夫 | isakow
克伦西克 | 赫伦奇克 | chrencik
尼莎 | 尼萨 | neysa
彭沃尔特 | 佩恩沃尔特 | pennwalt
库塞维茨基 | 科乌谢维茨基 | koussevitzky
布勒宁 | 布罗宁 | broening
伊尔特德 | 伊尔蒂德 | illtud
弗罗泽 | 弗勒泽 | froese
阿什利 | 阿什莉 | ashleigh
切尼里 | 切纳里 | chenery
弗莱赫蒂 | 弗莱厄蒂 | flaherty
诺克斯 | 努克斯 | nokes
恰鲁奇 | 基亚鲁奇 | chiarucci
休尔默 | 瑟默 | thuermer
舍格尔斯 | 舍加尔斯 | shergals
杜克诺伊 | 迪克努瓦 | duquenoy
托里约斯 | 托里霍斯 | torrijos
柯彻 | 基尔舍 | kircher
斯托尔曾巴赫 | 斯托曾巴赫 | stolzenbach
柯蒂斯 | 柯蒂兹 | curtiz
盖格 | 杰格 | jeger
马德里德 | 马德里 | madrid
多恩 | 唐 | donn
凯特尔比 | 基特尔比 | ketelbey
怀甘特 | 威甘特 | wygant
博弗里 | 博韦里 | boverie
夏普 | 沙普 | shapp
阿莱格拉 | 阿利格拉 | allegra
阿姆谢伊茨 | 阿姆谢维茨 | amshewitz
奥法雷尔 | 奥法雷 | o'farrell
利宁 | 吕宁 | luening
特金 | 图尔金 | turkin
阿斯登 | 阿斯普登 | aspden
乔西 | 约瑟 | josee
施赖伯 | 施里伯 | shriber
迈斯兰 | 迈斯拉恩 | meislahn
德拜尔 | 德比尔 | derbyl
利昂内尔 | 莱昂内尔 | lionel
格尔纳 | 盖尔纳 | gellner
克肖尔 | 塞克索尔 | sexauer
高因 | 高英 | gowing
亨尼卡特 | 亨尼克特 | hunnicutt
本尼 | 贝恩 | benne
科斯 | 库斯 | coes
斯库斯 | 斯丘斯 | skuce
舍内曼 | 舍尼曼 | schoeneman
维尼斯 | 维内斯 | veness
穆斯 | 缪斯 | muse
霍伊克斯布罗克 | 哈维克斯布罗克 | hawixbrock
冈希利 | 贡希利 | goonhilly
哈里尔 | 哈丽尔 | harriel
塞塞尔 | 塞斯尔 | sessel
尼奥基基斯 | 尼奥纳基斯 | nionakis
费尔马纳 | 费尔曼纳 | fairmaner
霍金森 | 霍奇金森 | hodgkinson
托马利娅 | 托马利亚 | tomalia
法尔斯 | 法伊尔斯 | fyles
阿尔西夫龙 | 阿尔西弗龙 | alciphron
达纳根 | 杜纳根 | dunagan
特雷西 | 特蕾西 | tracey
特克塞拉 | 特谢拉 | texeira
古 | 吉奥克 | giauque
库蒂斯 | 柯蒂斯 | kurtis
乌斯勒 | 奥斯勒 | oursler
埃尼德 | 伊妮德 | enid
西金特 | 瑟金特 | searjeant
拉金 | 莱金 | laging
尚伯格 | 舍恩伯格 | schonberg
米特塞夫 | 米采夫 | mitseff
范格 | 范杰 | fanger
布兰肯 | 布兰昌 | blanchan
霍尔迪曼德 | 哈尔迪曼德 | haldimand
吉廉斯 | 吉利亚姆 | guilliams
多奇 | 道奇 | dodge
梅莉娅 | 米利亚 | melia
弗赖里克 | 弗赖雷克 | freireich
菲克 | 费克 | feake
戈梅普普拉 | 戈梅斯普拉塔 | gomezplata
布乔伊斯 | 布儒瓦 | bourgeois
罗伊巴尔 | 罗伊鲍尔 | roybal
萨吉塔里厄斯 | 萨吉泰里厄斯 | sagittarius
比克 | 贝克 | beek
福斯 | 富斯 | fuoss
雷努德 | 伦瓦尔 | renouard
希拉斯 | 希勒斯 | heelas
卡尔德卢 | 考尔德克拉夫 | caldcleugh
克拉格 | 克莱格 | clague
贾西纳 | 杰西纳 | jacyna
切希尔 | 切斯希尔 | chesshyre
劳斯伯格 | 劳恩斯伯格 | lounsburg
布雷钦 | 布里金 | brechin
古德勒姆 | 古德哈姆 | gooderham
亚格 | 耶格尔 | yager
霍普 | 霍伊普 | heup
阿德查尼奇 | 阿德查尼克 | ardcharnich
贝迪利恩 | 贝迪利翁 | bedillion
斯迈思 | 史密斯 | smyth
赖道特 | 赖德奥特 | rideout
麦考斯兰 | 麦考斯伦 | mcauslan
皮阿罗斯 | 皮特罗斯 | peatross
马特奥 | 马泰奥 | matteo
多罗西 | 多萝西 | dorothy
斯陶布 | 斯托布 | staub
斯塔宾 | 斯图宾 | stubbing
奥尔弗森 | 阿尔弗森 | alverson
索洛蒂斯 | 索尔特斯 | solotesz
内赫特 | 纳赫特 | nacht
德马托 | 德马尔托 | desmarteau
特里索韦 | 特雷撒韦 | trethaway
谢尔普 | 谢普 | shairp
伯泽尔 | 伯塞尔 | birdsell
索恩代克 | 桑代克 | thorndike
马沙姆 | 马香 | marsham
奥伯赫尔曼 | 奥伯黑尔曼 | oberhelman
多内休 | 多尼休 | donehue
赫内利 | 亨内利 | hennelly
帕特里亚赫 | 佩特里亚克 | patriach
莱斯 | 莱什 | leisz
海内曼 | 海涅曼 | heinemann
里查兹 | 理查兹 | richards
艾奇森 | 艾奇逊 | eytchison
丹罗伊瑟 | 丹罗伊特 | dannreuther
法斯尔 | 法塞尔 | fascell
巴恩比 | 巴恩贝 | barnebey
梅林达 | 梅琳达 | melinda
弗伦泽 | 弗伦策 | frenzer
康西尔 | 康斯尔 | council
海因鲍姆 | 欣鲍姆 | sheinbaum
费布里克 | 法布里克 | fabrick
沃拉尼厄斯 | 瓦拉尼厄斯 | waranius
哈默特 | 赫默特 | hummert
迈西 | 梅西 | meysey
雷津 | 拉津 | razeen
古夫 | 高夫 | gough
巴塔格尔 | 巴塔杰尔 | battagel
埃韦克 | 埃厄克 | earwaker
格林达尔 | 格林德尔 | grindal
塞弗林豪斯 | 塞夫林豪斯 | sevringhaus
贾科特特 | 贾科泰 | jacottet
布里利 | 布里厄利 | brealey
麦科尚纳格 | 麦科尚奈格 | maco'shannaig
麦克廷格 | 马赫廷格 | machtinger
梅贝 | 梅布 | mabe
康杰 | 康格 | conger
卡特塞尔 | 卡瑟尔 | cuthell
迪尤斯 | 德威斯 | dewees
基茨哈伯 | 基察伯 | kitzhaber
布雷齐尔 | 布雷热 | brazier
芬尼 | 菲尼 | phinney
里维特 | 里韦特 | rivet
奥尔迪 | 阿尔迪 | alday
阿曼杜斯 | 阿曼达斯 | amandus
西纳 | 西纳尔 | synar
康科拉尔 | 康科勒 | concholar
卢娜 | 卢纳 | luna
杜纳利 | 达纳利 | dunalley
默茨基 | 默茨克 | mertzke
塞法蒂 | 瑟法蒂 | serfaty
肖伊勒 | 朔伊勒 | scheuler
特鲁曼 | 杜鲁门 | truman
迪奥 | 德奥 | deo
拉思 | 雷思 | rathe
哈尔巴克 | 哈尔巴赫 | halbach
拉特 | 鲁尔特 | rurt
赫利 | 赫尔利 | hurleigh
克罗嫩贝格 | 克罗嫩伯格 | kronenberg
克里奇顿 | 克赖顿 | crichton
格温妮德 | 格威内思 | gwynedd
沃姆尔多夫 | 沃梅尔多夫 | womeldorph
鲍希 | 布谢 | bouchey
波威尔斯 | 鲍威尔斯 | powels
罗雷姆 | 罗勒姆 | rorem
沃蒂埃 | 沃捷 | vautier
安德里欧 | 安德里厄 | andrieux
阿莱恩 | 阿林 | alleine
贝克 | 贝克尔 | becker
纳奇马诺夫 | 纳赫马诺夫 | nachmanoff
怀索基 | 维索茨基 | wysocki
比弗 | 贝弗 | bever
斯莫尔佩斯 | 斯莫尔皮斯 | smallpeice
里夫尔 | 里弗尔 | riffle
唐西娅 | 唐西亚 | donsia
杜克罗 | 迪克罗 | ducrow
沃尔克 | 沃克 | walk
沃尔克 | 沃克 | walker
麦迪森 | 麦迪逊 | madison
麦科拉姆 | 麦科勒姆 | mccollam
斯坦达洛夫特 | 斯坦德洛夫特 | standaloft
德沃查克 | 德沃夏克 | dvorchak
费布里坎特 | 法布里坎特 | fabricant
科赫伦 | 库格伦 | coughran
多克特 | 多克托 | docktor
法莱恩 | 法林 | filene
卢尔 | 勒尔 | lull
菲内尔 | 芬内尔 | feennell
皮克普 | 皮卡普 | pickup
塞门扎 | 西门扎 | semenza
哈森富斯 | 哈森弗斯 | hasenfus
加托夫 | 加特霍夫 | garthoff
阿夫雷特 | 阿夫里特 | avrett
彼得龙 | 佩特龙 | petrone
格里桑蒂 | 格里桑迪 | grisanti
梅尔斯 | 马雷斯 | mares
庞滕尼 | 庞特尼 | pounteney
安奈琳 | 阿内林 | aneirin
高利 | 高恩利 | gownley
劳本盖尔 | 劳本盖耶 | laubengayer
阿图鲁斯 | 阿图罗斯 | arturous
布兰肯巴克 | 布兰肯贝克 | blankenbaker
拉腊比 | 拉勒比 | larabee
埃斯坎达里安 | 伊斯坎达里安 | eskandarian
霍金 | 霍奇金 | hodgkin
盖格 | 盖杰 | gager
科尔奎特 | 科尔基特 | colquitt
达什曼 | 杜什曼 | dushman
雷兹通 | 雷德斯通 | redstone
伊德博尔德 | 埃德博尔德 | eadbald
贝松 | 贝森 | bessone
塞科夫斯基 | 赛科夫斯基 | saikowski
休伊代尔 | 舍代尔 | suirdale
哈莫尔 | 哈默 | hamor
普普 | 普珀 | puppe
施米德 | 施密德 | schmid
塔默格尔 | 塔穆格尔 | tarmugl
哈克威尔 | 黑克威尔 | hakewill
冈萨雷兹 | 冈萨雷斯 | gonzalez
莫纳 | 莫娜 | mona
格雷恩 | 格兰妮 | grainne
布拉德斯里特 | 布拉德斯特里特 | bradstreet
麦克斯蒂法恩 | 麦克斯蒂奥芬 | macstiofain
亚里莫维奇 | 雅里莫维奇 | yarymovych
登尼斯顿 | 丹尼斯顿 | denniston
塞尼奥尔 | 西尼尔 | senior
哈特齐德 | 哈齐德 | hartsid
博伊斯拉根 | 博勒根 | boisragon
里伯特 | 雷巴特 | rebut
索热 | 索热尔 | saussure
费里比 | 费尔比 | ferebee
科克森 | 考克森 | coxon
斯克鲁塔托 | 斯克鲁泰特 | scrutator
格里泽 | 格赖泽 | griser
阿尔贝克 | 奥尔贝克 | allbeck
许尔霍尔德 | 许霍尔茨 | schuerholz
肖克 | 肖基尔 | showkeir
威克泽 | 威克瑟 | wichser
科尔赫普 | 科尔黑普 | kohlhepp
杰里什 | 格里什 | gerrish
劳科 | 罗科 | ruocco
加诺尔 | 加诺 | ganor
鲍德施维勒 | 巴尔德施维勒 | baldeschwieler
斯洛尼姆 | 斯洛宁 | slonim
马撒 | 玛莎 | martha
鲍杜因 | 鲍德温 | bauduin
珀塞克 | 佩塞克 | perseck
维伦 | 瓦伊伦 | viron
皮尔森 | 皮尔逊 | pirsson
索尔茨 | 肖尔茨 | soults
奇瑟姆 | 奇塔姆 | cheatham
乔西亚斯 | 乔赛亚斯 | josias
埃夫瓦德 | 埃瓦德 | evvard
格鲁尔德 | 杰罗尔德 | gerould
杰格 | 耶格 | jaegher
加弗 | 盖弗 | gaver
瑟金 | 西尔金 | sirkin
康诺米 | 科诺米 | conomy
柯兰 | 柯伦 | curran
瓦伦朱拉 | 巴伦苏埃拉 | valenzuela
肖尔斯 | 肖沃斯 | showers
沃迪 | 韦迪 | wadey
阿格鲁 | 阿古 | agwu
弗拉克斯 | 弗勒克斯 | flux
林恩 | 林 | linn
德赖克 | 德里克 | driker
里查德 | 理查德 | richard
罗伯森 | 罗伯逊 | robertson
达肯 | 达坎 | dakan
利维克 | 莱夫奥克 | liveoak
普鲁斯曼 | 普拉斯曼 | prusman
基弗 | 凯弗 | keifer
吉安 | 吉亨 | gehan
施努克尼 | 施努克内 | schnukne
阿格尔 | 阿高尔 | argall
温纳斯特伦 | 温纳斯特鲁姆 | wennerstrum
利德克 | 利迪克 | luedecke
普吕内克 | 普伦尼克 | pluenneke
赫希特里特 | 赫什特里特 | hirschtritt
贝拉德 | 贝拉尔 | berard
怀格姆 | 威格姆 | wigham
麦吉恩蒂 | 麦金蒂 | mcguinty
皮珀 | 派珀 | piper
豪杰 | 豪格 | hauger
德沃尔金 | 德沃金 | dworkin
阿特尔西 | 阿特莱西 | attlesey
加格宾 | 加涅班 | gagnebin
阿克雷斯 | 阿克斯 | acres
霍 | 豪 | howe
赫维茨 | 赫威茨 | herwitz
克兰德 | 克兰 | kland
德雷斯克 | 德赖斯克 | dreiske
马马杜克 | 马默杜克 | marmaduke
普赖尔 | 普里尔 | preil
比勒姆 | 比鲁姆 | biroum
奎伦 | 奎林 | quillen
贝思 | 贝丝 | beth
拜霍尔特 | 伯霍尔特 | byrholdt
约赫 | 约埃 | yohe
恩格弗 | 恩弗 | engfer
亚特龙 | 亚特隆 | yatron
斯凯姆 | 斯基姆 | skym
格瓦托斯基 | 格瓦尔托夫斯基 | gewartowski
埃查德 | 伊查德 | eachard
布思利 | 布思莱 | buthlay
安杰莉娜 | 安杰利娜 | angelina
明希 | 明施 | minsch
布兰恩 | 布兰 | brann
普伦蒂 | 普朗蒂 | prunty
维西 | 维齐 | veysey
施塔尔 | 斯塔尔 | stahl
沃尔斯通尔斯托夫特 | 沃斯通克拉夫特 | wollstonecraft
奥卡恩 | 奥凯恩 | o'kane
阿曼 | 阿尔曼 | arman
贝德尔 | 比德尔 | bedel
阿德尼 | 埃德尼 | adney
莫利诺尔 | 莫勒瑙尔 | mollenauer
芬维西 | 芬韦西 | fenvessy
帕奇 | 帕克 | pach
盖尔德 | 格尔德 | gelder
贝尔基 | 贝尔克 | behlke
萨森 | 萨瑟恩 | southern
巴查尔 | 巴卡尔 | bachar
奥尔博 | 阿尔博 | allbaugh
加米特 | 加梅特 | gamet
德利乔治 | 德利乔治斯 | deligiorgis
加雷尔 | 加勒尔 | garel
奥尔 | 奥利 | ole
巴德温 | 布德温 | budwine
迪奥 | 戴奥 | dio
布罗尔施 | 布勒尔施 | broelsch
塞韦尔 | 萨维尔 | savele
莱维 | 利维 | levie
格龙基 | 格朗茨基 | groncki
加康 | 加肯 | garcon
德姆里奇 | 德姆里克 | daemmrich
肖尔德勒 | 斯科德勒 | scholderer
迪比 | 达比 | duby
贝尔比 | 比尔比 | beilby
纽尼梅克 | 努尼梅克 | nunemaker
阿尼斯 | 安妮斯 | anis
阿布林 | 埃布林 | ablin
班德 | 班德尔 | bander
罗索尔 | 罗塞尔 | rossall
埃奇逊 | 艾奇逊 | etcheson
福塞特 | 福西特 | fawssett
吉尔德福德 | 吉尔福德 | guildford
阿加斯 | 阿加丝 | agase
阿蒂耶 | 阿提耶 | atiyeh
伦芬特 | 朗方 | lenfant
尤弗罗辛 | 尤弗罗西尼 | euphrosyne
杰雷迈亚 | 杰里迈亚 | jeremiah
艾耶斯特 | 艾尔斯特 | ayerst
艾亚拉 | 阿亚拉 | ayala
佩特里兹 | 佩特里迪斯 | petrides
科德尔 | 科德 | corder
戴文 | 达文 | davern
罗莎妮 | 罗珊 | rozanne
洛格 | 洛奇 | lorge
豪希卡 | 豪施卡 | hauschka
埃莉娜 | 埃琳娜 | elena
杜尤 | 杜韦 | duwe
布雷德 | 布里德 | breder
利班 | 莱班 | leban
穆拉尔特 | 缪拉尔持 | muralt
萨洛梅 | 萨洛米 | salome
玛丽萨 | 马里萨 | marisa
肖纳 | 肖娜 | shauna
鲍尔廷豪斯 | 博尔廷豪斯 | boultinghouse
尤金尼亚 | 尤金妮亚 | eugenia
梅德瓦多斯基 | 梅德瓦多夫斯基 | medwadowski
希厄特 | 海厄特 | hieatt
费茨 | 菲茨 | fites
科格尔 | 科格德尔 | cogdell
特里布瓦瑟 | 特里布沃瑟 | triebwasser
惠契利夫 | 惠特克利夫 | whitchliffe
卡利斯尔 | 卡莱尔 | carlisle
怀森 | 威森 | wison
利蒂卡 | 莱蒂卡 | letica
德赫特 | 德克特 | dechert
德夫尼 | 迪夫尼 | deveney
海姆索思 | 海姆塞特 | heimsoth
弗德里 | 维德里 | verdery
希伯德 | 希巴德 | hibbard
盖斯特菲尔德 | 盖斯特费尔德 | geistfeld
塔利亚费罗 | 托利弗 | taliaferro
威尔怀德 | 威尔海德 | wilhide
莱塞特 | 莱西特 | lycett
莱贡 | 利根 | lygon
奥利克西维 | 奥莱克休 | oleksiw
阿莱斯 | 阿莱 | allez
卡德瓦拉迪 | 卡德瓦拉德 | cadwaladyr
萨尔温 | 西尔温 | sulwen
法迪安 | 法迪恩 | fadyean
德雷南 | 德雷宁 | drennen
德彻 | 德谢尔 | decher
特鲁齐 | 特拉齐 | truzzi
托里 | 托丽 | tori
卡里洛 | 卡里略 | carrillo
比比 | 毕比 | beeby
凯莉 | 卡利 | cali
波兰 | 波伦 | pollan
盖滕拜因 | 盖滕宾 | gaitenbein
