戈尼娅 | 戈尼亚 | gonia
布雷金里奇 | 布雷肯里奇 | breckinridge
锡德 | 切德 | cedd
玛莉 | 马利 | maly
阿尔西尼加 | 阿西涅加 | arciniega
斯特拉西恩 | 斯特拉森 | strathearn
皮内 | 皮奈 | pinay
梅雷斯曼 | 米尔斯曼 | meresman
弗兰宗 | 弗兰曾 | franzon
伊兹比基 | 伊兹比茨基 | izbicky
埃卡韦斯特 | 埃沙韦斯特 | echaveste
费尔伯恩 | 费尔贝恩 | fairbairn
米尔黑德 | 缪尔黑德 | muirhead
舒普 | 肖普 | shoupp
普安 | 普汉 | puhan
芒斯巴克 | 蒙斯巴克 | maunsbach
沃塞尔 | 瓦塞尔 | wassell
瑟金特 | 萨金特 | seargent
亨巴克 | 亨巴赫 | heimbach
杰米马 | 杰迈玛 | jemima
海 | 希 | hie
莫杜特 | 莫德维 | mauduit
惠塔克 | 惠特克 | whitacre
艾特 | 艾厄特 | eyet
厄德利 | 亚德利 | yeardley
博比 | 鲍比 | bobbie
麦基尔文娜 | 麦基尔温纳 | macilvenna
麦克费伦 | 麦克弗伦 | mcpherren
埃德尔霍赫 | 埃德尔霍克 | edelhoch
博查尔 | 博索尔 | botsal
瓦格尼 | 韦恩 | wagne
多特曼 | 多伊特曼 | deutermann
厄德曼 | 厄尔德曼 | erdman
戈伦比夫斯基 | 戈伦别夫斯基 | golembiewski
格雷戈尔 | 格雷瓜尔 | gregoire
迈卡亚 | 迈凯亚 | micajah
莱德洛 | 莱德劳 | laidlaw
雷马克斯 | 拉马克斯 | raemakers
皮凯弗 | 皮卡弗 | piccaver
苏布林 | 萨布林 | subrin
斯克拉顿 | 斯克鲁顿 | scrutton
费尔本 | 费尔伯恩 | fairburn
津嫩 | 津宁 | zinnen
费登 | 法登 | faden
布盖兹 | 布尔盖兹 | bourgaize
佩莱蒂尔 | 佩尔蒂埃 | pelletier
帕塞尔 | 帕斯尔 | parcel
霍诺里 | 霍诺丽 | honori
伊米施 | 伊梅施 | imesch
西明顿 | 赛明顿 | symington
马豪尔特 | 玛奥 | mahault
费克 | 菲克 | fike
加布尔 | 加伯 | gabbour
科菲 | 乔菲 | cioffi
韦克特尔 | 瓦赫特尔 | wachtel
塔利费弗罗 | 塔利亚费罗 | tagliaferro
舒格 | 沙格 | shugg
夏维尔 | 希维尔 | shivell
拉凯伊斯 | 拉雪兹 | lachaise
达维格多 | 达维多尔 | d'avigdor
玛吉 | 马吉 | magi
哈巴德 | 哈伯德 | hubbard
曼纳韦 | 马纳韦 | mannaway
梅根 | 米恩 | meighen
维迪斯科 | 弗迪斯科 | verdisco
艾索德 | 伊佐德 | izod
阿福蒂特 | 阿富尔蒂特 | affourtit
米塞尔 | 米赛尔 | misael
赫默里克 | 亨默里克 | hemmerich
詹宁斯 | 杰宁斯 | jenyns
斯特姆斯 | 斯泰姆斯 | stames
博厄克 | 博哈克 | bohac
塔伦斯 | 塔兰斯 | tarrance
比布 | 毕比 | beebe
考尔德尔 | 考德尔 | caldell
博查特 | 博哈特 | borchardt
卡明 | 卡迈恩 | carmine
巴特伦 | 巴特拉姆 | bartram
麦康 | 麦肯 | mccon
麦卡里 | 麦凯里 | mccarey
克雷扬 | 克雷恩 | crayon
因南特 | 因方特 | infant
卡赫 | 卡尔 | karrh
亨内肯斯 | 亨尼肯斯 | hennekens
贾弗 | 贾埃弗 | giaever
贾米 | 杰米 | jamie
鲍尔霍恩 | 巴尔霍恩 | ballhorn
布斯马 | 伯斯马 | bursma
斯特格斯 | 斯特奇斯 | sturges
莫克萨姆 | 莫克塞姆 | moxam
米德尔巴什 | 米德尔布什 | middlebush
阿什多恩 | 阿什当 | ashdown
比克姆 | 比卡姆 | bickham
夏尔曼 | 沙伊尔曼 | shireman
梅索利 | 梅索伊 | meszoly
埃森斯 | 埃森丝 | essence
利布 | 利比 | luebbe
哈兹尔 | 黑兹尔 | hazell
奥迪恩 | 奥迪翁 | audion
金德雷德 | 金德里德 | kindred
纽索尔 | 纳托尔 | nuthall
埃廷 | 埃泰恩 | etain
勒罗伊德 | 利罗伊德 | learoyd
德尔里戈 | 德尔列戈 | delriego
巴策 | 巴策尔 | batzer
莱思科特 | 利思科特 | lythcott
廷肯 | 廷康 | tinkon
德弗雷茨 | 迪弗雷特斯 | defrates
奥尔文厄姆 | 阿尔文厄姆 | alvingham
尤拉姆 | 乌拉姆 | ulam
达劳 | 达罗 | darraugh
蒂利 | 泰利 | tiley
格罗布 | 格罗比 | grobe
塔塔利诺 | 塔尔塔利诺 | tartaglino
亚历山大 | 达历山大 | d'alexander
兰姆 | 拉姆 | lambe
考尔韦韦尔 | 考德威尔 | caldwell
泽米娜 | 泽米纳 | zemina
坎特伯里 | 坎特伯雷 | canterbury
塔肯 | 泰肯 | tacon
基尔施 | 基尔希 | kirsch
古特穆特 | 古特穆思 | gutermuth
弗森 | 费尔森 | ferson
托皮 | 托毕 | torpey
泰奇曼 | 泰克曼 | teichmann
普鲁赫姆 | 普鲁多姆 | prudhomme
坎比 | 坎贝 | cumbey
赫姆尔 | 赫姆利 | hermle
蒙根 | 蒙贡 | mongon
亨佩尔 | 亨普尔 | hempel
艾罗 | 艾罗尔特 | ayrault
雷亚 | 雷 | rea
布赖登索尔 | 布赖登塔尔 | breidenthal
德卢吉 | 德路易吉 | deluigi
科彻里斯 | 科克里斯 | cocheres
霍斯伯格 | 霍斯伯勒 | horsburgh
贝尔索 | 贝尔思 | belth
鲁德 | 鲁阿兹 | ruadh
格里特黑德 | 格雷特黑德 | greathead
马尔特比 | 莫尔特比 | maltby
埃塞蕾达 | 埃塞丽达 | ethelreda
默钦斯顿 | 默奇斯顿 | merchiston
迪恩娜 | 迪恩纳 | dienna
博里尔 | 博雷尔 | boreel
布雷恩 | 布里恩 | brehon
吉尔 | 圭尔 | guire
厄丘克 | 尤尔丘克 | yurchuck
坦尼肯 | 滕尼肯 | tennican
麦金泰尔 | 麦金太尔 | mcintire
加勒特 | 加雷特 | garrette
利文 | 莱文 | levene
克莱尔斯 | 克拉雷斯 | clares
朱林科 | 祖林科 | dzurinko
维普林斯基 | 西普林斯基 | cieplinski
索肖尔纳 | 索杰纳 | sojourner
克努贝尔 | 努贝尔 | knubel
卡诺肯 | 卡诺坎 | carnochan
吉海诺 | 吉赫诺 | giheno
罗克辛 | 罗克西娜 | roxinne
伦斯莱尔 | 伦塞勒 | rensselaer
伊登斯 | 埃登斯 | edens
比哈里尔 | 贝哈里尔 | beharriell
朗坎姆 | 朗香 | longchamp
贝德纳夫斯基 | 贝德纳尔斯基 | bednarski
皮什 | 佩什 | peche
洛伦兹 | 洛伦茨 | lorenz
特普尔 | 蒂普尔 | tepoel
贾莫 | 贾伊莫 | giaimo
库吉安 | 库尔金 | kuljian
吉耶 | 吉利特 | guillet
哈米利恩 | 哈米里恩 | hamilyon
基尔库西 | 基尔科西 | kilcoursie
里森诺弗 | 里曾诺弗 | reasonover
查肯 | 查康 | chacon
雷布萨门 | 里布萨门 | rebsamen
托尔菲亨 | 托菲肯 | torphichen
斯卡尔特 | 斯卡尔普特 | sculpt
霍尔克特 | 霍尔基特 | halkett
沃格斯塔夫 | 瓦格斯塔夫 | wagstaffe
黑特姆 | 哈特姆 | hatem
泽兰 | 齐伦 | zeran
比贝尔 | 比布尔 | biebel
奥尔德施泰尔 | 奥尔德斯泰尔 | oldstyle
西门斯 | 西门子 | siemens
普莱本 | 普利邦 | plybon
斯温斯鲁德 | 斯温斯拉德 | swensrud
拜克纳 | 比克纳 | beichner
恩戈尔姆 | 恩格霍姆 | engholm
惠特洛 | 怀特洛 | whytlaw
桑德威克 | 桑威克 | sandwick
威思 | 韦思 | wyeth
施韦歇尔德 | 施韦柴尔德 | schweichild
斯坦霍普 | 斯坦诺普 | stanhope
英沃尔施塔德 | 英沃斯塔德 | ingvoldstad
森戈尔 | 桑戈尔 | senghor
布赖豪斯 | 布里格豪斯 | brighouse
克伦布尔 | 克伦巴尔 | krumbhaar
莫拉尔 | 莫勒 | morar
弗里利 | 弗赖利 | friley
赖兰斯 | 赖伦斯 | rylance
吉尔德施利夫 | 吉尔德斯利夫 | gildersleeve
鲍托尔 | 鲍塔尔 | boutall
哈扎德 | 哈泽德 | hazard
马谢特 | 马希特 | mushet
杜切斯 | 达切斯 | dutchess
布拉姆利 | 布伦利 | brumley
比尔特 | 伯特 | birt
菲格雷斯 | 菲格斯 | figures
埃加尔 | 埃加 | eggar
特库姆什 | 特库姆塞 | tecumseh
伊万杰丝塔 | 埃万杰利斯塔 | evangelista
韦布利 | 韦伯利 | webley
帕门蒂尔 | 帕尔芒捷 | parmentier
丁杰利斯 | 迪安杰利斯 | deangelis
格里诺尔特 | 格里纳沃尔特 | greenawalt
麦格拉里奇 | 麦格拉斯里克 | macglasrich
索恩顿 | 桑顿 | thornton
巴洛克 | 巴洛赫 | balloch
切尔尼斯基 | 切尔涅斯基 | chernesky
克龙 | 克朗 | kron
贝利沃 | 贝尔维 | bellevue
凯肖恩 | 基肖恩 | keyshawn
德尔钱普斯 | 德尔尚 | delchamps
布劳恩 | 布朗 | braun
拉德拉姆 | 拉德勒姆 | rudderham
特里利文 | 特里莱文 | treleaven
阿文特 | 埃文特 | avent
比内尔 | 比尤内尔 | buesnel
阿迪 | 埃迪 | adye
哈格迈耶 | 哈格迈尔 | hagemeyer
凯夏 | 凯蒂娅 | katia
阿拉蒙 | 阿拉芒 | allamong
西米恩 | 西明 | siemien
罗万德 | 罗安德 | rowand
普里亚尔 | 普赖尔 | prial
布利萨克 | 布利萨茨 | blisac
拜兹 | 比德兹 | bidez
厄威尔 | 厄维尔 | irwil
威尔梅特 | 薇尔梅特 | wilmett
霍米特 | 霍梅特 | homet
纳兰乔 | 纳兰霍 | naranjo
布雷兰 | 布里兰 | breland
奥金达奇 | 奥金达基 | auchindachie
卡尔 | 卡利 | karle
阿德莉娜 | 阿德利娜 | adelina
斯特尔特 | 斯泰尔特 | stelter
明韦尔 | 米恩韦尔 | meanwell
科克伦 | 科克兰 | cockran
格尔 | 瓜尔 | guare
朱皮特 | 丘辟特 | jupiter
多伊特里奇 | 多伊特里希 | deutrich
托厄里 | 托尔里 | towery
马德林 | 马德琳 | madlin
威舍 | 维舍 | wischer
肖茨 | 肖恩茨 | shontz
戴加 | 迪格 | dygard
伍斯特 | 沃里斯特 | woreester
巴利克 | 巴利奇 | balich
库比特 | 丘比特 | cubitt
福尔迪西 | 福尔德西 | foldessy
西克雷斯特 | 西克里斯特 | secrest
蒂特 | 图特 | tuteur
拉扎 | 拉扎尔 | lazar
佩茨 | 皮特斯 | petes
珀克斯 | 皮尔克斯 | pearkes
费尔哈文 | 费尔黑文 | fairhaven
索恩伯格 | 索恩伯勒 | thornburgh
特里德格 | 特里迪加 | tredegar
阿蒂盖尔 | 阿蒂格尔 | attygalle
马西娅 | 玛西娅 | mathea
卡姆 | 凯姆 | kaim
费布勒 | 法布勒 | fabler
彼得鲁斯卡 | 彼特鲁斯卡 | petruska
弗恩 | 维恩 | verne
韦姆 | 瓦伊姆 | waim
鲁兰 | 鲁伦 | ruellan
拉赫特 | 拉克特 | lachter
拉哈布 | 雷哈布 | rahab
麦金纳尼 | 麦基纳尼 | macinerney
埃根 | 伊根 | egan
斯蒂格勒 | 施蒂格勒 | stigler
特威宁 | 特文宁 | twining
西达勒斯 | 西达劳斯 | sidarouss
弗洛厄尤 | 弗劳尔迪 | flowerdew
盖兰 | 格兰 | gellan
吉米内斯 | 希门尼斯 | jimenez
普勒 | 普拉 | pullar
韦尔纳 | 沃尔纳 | woellner
科尔帕齐 | 科帕齐 | corpazzi
布拉德劳 | 布拉德洛 | bradlaugh
布鲁因 | 布勒因 | bruyn
塔米海尔 | 塔米希尔 | tamihere
麦格罗瑟 | 麦格鲁瑟 | macgreuther
柯特尼厄斯 | 柯特纽斯 | curtenius
斯特朗奇 | 斯特朗 | stronge
埃沃伊 | 伊沃伊 | evoy
迪伦富思 | 迪伦弗思 | dyhrenfurth
特鲁塞尔 | 特拉塞尔 | trussel
坦盖 | 坦圭 | tanguay
杜布拉斯 | 杜布拉 | dubras
亚兹明 | 亚斯明 | yazmin
劳德代尔 | 劳德戴尔 | lauderdale
伯贝奇 | 伯比奇 | burbage
泽纳 | 策纳 | zaehner
波洛斯 | 普洛斯 | poulos
勒万多 | 柳安多 | lewando
克莱恩 | 克莱因 | clyne
麦克沃尼什 | 麦克瓦尼什 | macvarnish
韦德勒 | 维德勒 | vedeler
休林斯 | 赫林斯 | hulings
弗里岑 | 弗里曾 | fritzen
贝尔希 | 贝尔赫 | bailhe
斯科克罗夫特 | 斯考克罗夫特 | scowcroft
金泽特 | 金瑟特 | gensert
麦卡尔 | 麦考尔 | mackal
阿勒芒 | 阿利芒 | allemang
赛奇 | 赛什 | saich
皮奥特罗夫斯基 | 彼得罗夫斯基 | piotrowski
贾恩 | 扬 | jahn
康戈尔顿 | 康高尔顿 | congalton
杜瓦克斯 | 杜阿克斯 | duax
迪布林 | 杜布林 | dubrin
沙滕克克 | 沙滕柯克 | schattenkerk
库德尔 | 库尔德尔 | kuldell
法隆 | 法伦 | falloon
奥斯维 | 奥斯威尤 | oswiu
索茜 | 索西 | southee
米隆 | 米伦 | millon
艾利 | 艾莉 | eily
埃克恩 | 伊肯 | ekern
菲利恩 | 菲利翁 | filion
莫普斯 | 莫皮斯 | moppes
阿莱维 | 阿利维 | alevey
帕塞尔 | 帕斯尔 | parcell
索尔 | 苏尔 | soul
德迪奥 | 戴德奥 | dedeo
特达 | 西达 | theda
麦克里思 | 麦克勒思 | mackereth
布拉夫 | 布洛 | bullough
奥瑟 | 奥泽 | orser
佩普利 | 帕普利 | papley
帕珀马斯特 | 佩珀马斯特 | papermaster
贝伦德斯 | 贝伦兹 | berendes
道布利迪 | 道布尔迪 | doubleday
施雷德 | 施拉德 | schrade
奇丝特 | 奇斯特 | chiste
安格尔 | 安杰尔 | angel
伯克 | 比尔克 | birck
巴索尔森 | 巴托尔松 | bartholdson
麦克斯波兰 | 麦克斯波伦 | macsporran
英格林 | 英林 | yingling
查努廷 | 查纽廷 | chanutin
埃塞克 | 伊塞克 | esek
梅尔霍弗 | 迈尔霍费尔 | maierhofer
安加罗 | 安加罗拉 | angarola
马伦普尔 | 马伦普雷 | malempre
阿勒顿 | 阿里顿 | arreton
贝哈 | 贝亚 | beha
法尔布伦斯 | 法尔布兰斯 | firebrance
安嫩贝格 | 安嫩伯格 | annenberg
博尔多 | 波尔多 | bordeaux
德西德里厄斯 | 德西迪里厄斯 | desiderius
塔尔戈特 | 索尔戈特 | thalgott
马尼尔 | 马尼耶 | magnier
奥特里纳姆 | 奥特林厄姆 | altrincham
纳帕施特克 | 纳帕斯特克 | naparstek
艾纳姆 | 埃努姆 | aernum
麦基勒维 | 麦基雷维 | macilrevie
艾肯格琳 | 艾肯格林 | eichengreen
莱夫勒 | 莱弗勒 | leffler
科卡姆 | 科克姆 | corkum
拉文 | 雷文 | raven
黑文纳 | 哈文纳 | havenner
多尔兹 | 德尔兹 | doelz
莫布斯比 | 莫布兹比 | mobsby
南迪 | 农迪 | nundy
赛雷斯 | 西尔斯 | cyres
西波伦 | 西波隆 | cipollone
赛丝 | 赛斯 | sise
弗雷林休森 | 弗里林海森 | frelinghuysen
帕吉利斯 | 帕盖利斯 | pargellis
莱普尔 | 勒普尔 | lepoer
奥尔施塔特 | 阿尔斯塔特 | alstadt
博尼法修斯 | 博尼费修斯 | bonifacius
达夫尼 | 达夫妮 | daphne
瓦恩 | 瓦因 | vine
里加利亚 | 雷加利亚 | regalia
麦克莱夫 | 麦克拉夫 | mcclave
罗曾塔尔斯 | 罗森塔尔斯 | rozentals
麦康基 | 麦康希 | macconchy
桑德姆 | 桑达姆 | sandham
里穆斯基 | 里莫斯基 | rimouski
马宁 | 曼宁 | maning
布莱胡特 | 布拉胡特 | blachut
赫明 | 亨明 | hemming
特文加登 | 蒂文加杜姆 | tirvengadum
卡尔斯密斯 | 卡尔史密斯 | carlsmith
马米 | 玛米 | mami
比斯特 | 比伊斯特 | buist
拉拉莫尔 | 拉腊莫尔 | laramore
福韦尔 | 福尔韦尔 | faulwell
哈克 | 黑克 | hake
哈沙根 | 哈舍根 | hashagen
里尔斯 | 赖亚尔斯 | ryalls
梅伦 | 默龙 | merron
格鲁科特 | 格劳科特 | groucott
鲁兹 | 吕埃 | ruez
拉德布罗克 | 拉德布鲁克 | ladbroke
利斯蒂格 | 卢斯蒂格 | luistig
恩斯莱格 | 奥恩斯莱格 | oenslager
哈加丁 | 哈格丁 | hargadine
利希姆 | 利克希姆 | leikhim
沃奇夫特 | 沃特沙夫特 | wirtschafter
艾默斯 | 伊穆斯 | imus
托赫 | 托克 | toch
杜文特 | 德温特 | dewenter
加瓦尔特 | 加沃尔特 | gawalt
哈雷尔 | 哈勒尔 | harrel
斯普勒 | 施普勒 | spuhler
夏里斯 | 查里斯 | charies
阿马尼 | 阿尔马尼 | armani
汤姆斯 | 图姆斯 | tombs
达夫伦 | 杜弗隆 | duflon
梅罗维奇 | 迈罗维奇 | meirovitch
谢里克 | 谢雷克 | sherek
贝恩 | 本 | benn
梅纳厄姆 | 梅纳汉 | menaham
麦基利肯 | 麦基利坎 | mackillican
多里 | 多丽 | dorrie
法诺夫 | 法纳夫 | faneuf
拉德克 | 拉德斯克 | radesk
罗克 | 罗奇 | roch
多勒 | 多拉夫 | dorough
巴尔尼尔 | 巴尼尔 | balniel
菲林 | 法尔林 | firing
克莱姆 | 克莱米 | klemme
费尔 | 费雷 | ferre
安娜贝尔 | 安娜贝勒 | annabelle
福伊西 | 福西 | feusi
江伯格 | 宗伯格 | zumberg
萨加 | 塞格尔 | sagar
恩格兰 | 英格兰 | england
科伦吉 | 科隆吉 | colonghi
莱弗塞奇 | 利弗西奇 | liverseidge
塔尔曼 | 托尔曼 | tallman
阿布 | 阿贝 | abbe
博伊斯福坦 | 博伊斯方丹 | boisfontaine
麦卡哈蒂 | 麦克哈蒂 | mccahearty
塞弗里 | 萨弗里 | savery
布赖滕菲尔德 | 布赖滕费尔德 | breitenfeld
迪波特 | 杜波特 | duport
托伦斯 | 托兰斯 | torrance
韦斯特摩兰 | 威斯特摩兰 | westmoreland
厄尔普 | 厄普 | earp
蒙多尔 | 蒙多 | mondor
格尔泽 | 盖尔泽 | gelzer
施赖纳 | 施里纳 | shriner
斯塔布尔菲尔德 | 斯塔布菲尔德 | stubblefield
弗皮利克 | 韦皮勒 | verpilleux
戴门特 | 迪亚门特 | diament
托南德 | 汤恩德 | townend
伊内斯 | 伊内兹 | inez
杰彭 | 杰波恩 | jepoen
麦克恩 | 麦肯 | mackeng
伯肯霍尔茨 | 伯肯霍尔兹 | birkenholtz
默茨 | 默特斯 | mertes
卢克特 | 勒基特 | luckett
斯皮尔 | 斯珀尔 | spurr
伊德 | 伊德尔 | eader
维诺格拉德 | 维诺格勒 | vinograd
安纳盖尔 | 安纳克莫尔 | annaghmore
斯图德曼 | 斯蒂德曼 | studeman
利莲 | 勒林 | lelean
布里森 | 布赖森 | bridson
蒂林赫斯特 | 蒂林哈斯特 | tillinghast
马达维克 | 马达维赫 | mhadavikh
戈勒布 | 戈卢布 | golub
达拉克 | 杜拉奇 | dullach
佐尔德 | 索尔德 | szold
贝德尔 | 比德尔 | bedell
杜普卡克 | 杜普恰克 | dupcak
布雷登 | 布拉顿 | bradon
贝姆 | 巴姆 | bame
莱西 | 利西 | leisy
普利马尔 | 普莱梅尔 | plymale
布罗梅特 | 布罗米特 | bromet
皮科威亚克 | 皮乔维亚克 | piechowiak
沃尔纳 | 沃纳 | woerner
奥雷斯肯 | 奥雷斯坎 | orescan
格罗贝格 | 格罗伯格 | groberg
西比尔 | 塞比尔 | sebire
法勒 | 法伊勒 | pfeiler
霍莫尔卡 | 霍穆尔卡 | homolka
海斯伯格 | 海斯堡 | heisborg
费尔布里尔 | 费德布里尔 | feldbrill
杰农 | 热农 | gernon
斯顿特 | 斯坦特 | stunt
埃利斯 | 埃莉丝 | elyse
克勒勒 | 克雷勒 | kroehler
谢米宁 | 切米宁特 | cheminint
韦林 | 瓦林 | wahlin
赫尔姆霍特 | 赫尔姆霍尔特 | helmholdt
布根 | 巴根 | bugan
佩基 | 皮奇 | pechey
施瓦姆 | 施万布 | schwamb
奥里 | 奥赖 | ory
艾尔弗里克 | 阿尔弗里克 | aelfric
艾尔加 | 艾尔格 | eylgar
艾 | 伊 | yee
斯蒂普尼 | 斯特普尼 | stepney
奥珊娜 | 奥赞 | ozanne
德汉 | 德哈恩 | dehaan
松塔格 | 桑塔格 | sontag
塔利奥 | 图利奥 | tullio
克拉兹 | 克鲁兹 | cruz
麦康 | 梅肯 | macon
赫福特 | 赫弗特 | herfurt
古德里 | 格德里 | guedry
戴维 | 达维 | davee
戈希 | 戈伊 | gohey
克莱弗 | 克拉弗 | claver
桑瑟姆 | 桑森 | sansum
吉吉 | 吉盖 | giggey
多本 | 多宾 | doben
杰穆特 | 格穆思 | germuth
泰恩什 | 坦什 | tainsh
克雷斯皮尼 | 克雷皮尼 | crespigny
布莱克斯兰 | 布拉克斯兰 | blaxland
马夸里 | 麦夸里 | maquarie
比尔基 | 伯基 | buerki
斯韦兹 | 斯沃德什 | swadesh
巴贝尔 | 贝布尔 | babell
布朗塔斯 | 布龙塔斯 | brountas
梅耶森 | 迈耶森 | mayerson
德雷沃吉拉 | 德沃尔吉拉 | drevorguilla
奥弗拉赫蒂 | 奥弗莱厄蒂 | o'flahertie
塞维 | 西维 | sevey
鲍沃 | 鲍尔 | bouwer
克雷恩 | 克拉汉 | crahan
博克尔 | 博克 | boker
埃舒奥 | 埃舒 | eshoo
马辛库斯 | 马辛克斯 | marcinkus
佩雷兹 | 佩雷斯 | perez
蒂利 | 蒂莉 | tillie
赖格 | 里格 | riger
怀斯曼 | 威斯曼 | wieseman
阿利森 | 艾莉森 | alyson
德雷塞尔 | 德雷斯尔 | dressel
朱利 | 朱莉 | julie
芬格胡特 | 芬格赫特 | fingerhut
丹尼恩 | 达尼恩 | danyon
马胡伦 | 马胡兰 | mahuran
皮尔 | 派尔 | peyer
蔡赫 | 切赫 | czeh
西尔瓦纳斯 | 西尔维纳斯 | silvanus
卡莱斯顿 | 卡尔斯顿 | carleston
埃克斯坦斯 | 埃克斯滕斯 | exstance
艾恩斯 | 安斯 | aines
普萨特里 | 普萨泰里 | pusateri
尼亨 | 奈恩 | nyhen
克利瑟 | 克莱瑟 | cleather
沃克特 | 瓦克特 | wackett
罗巴特斯 | 罗巴茨 | robartes
阿内洛 | 阿涅洛 | agnello
伊莱 | 艾莱 | ilay
内西尤 | 纳休 | nathiew
胡达克 | 赫达克 | hudak
斯蒂格利茨 | 施蒂格利茨 | stiglitz
西西利厄斯 | 塞西莉厄斯 | cecilius
哈姆斯 | 黑姆斯 | hammes
雷贝尔 | 里贝尔 | rebel
查格尔斯 | 查格利斯 | chagles
加纳吉安 | 加南吉扬 | ganangiyan
古拉德 | 戈拉德 | goulard
阿尔特曼 | 奥尔特曼 | altmann
考沃特 | 科沃特 | cowart
格罗杰 | 格罗格 | grogger
布里斯 | 布赖斯 | brise
洛林达 | 洛琳达 | lorinda
埃夫勒 | 埃弗勒 | effler
惠特塞特 | 惠特西特 | whitsett
唐纳尔 | 多纳尔 | donal
明顿 | 明特恩 | minturn
瓦斯默 | 沃斯默 | wasmer
布雷斯纳安 | 布雷斯纳汉 | bresnahan
波 | 鲍 | pow
拉克索尔 | 拉克斯尔 | wraxhall
曼柳斯 | 曼利厄斯 | manlius
鲍夫曼 | 鲍曼 | baughman
布里梅科姆 | 布里马科姆 | brimacombe
莱托克 | 勒托克 | letocq
谢拉 | 希拉 | shelagh
内格尔 | 尼格尔 | negel
乔弗里翁 | 乔夫里翁 | joffrion
伯恩 | 贝尼 | boehne
格鲁尔 | 格劳尔 | grouer
德沃拉克 | 德沃夏克 | dvorak
福伊尔弗克 | 福伊尔沃克 | feuerwerker
塔吉 | 塔姬 | taggy
麦科克 | 麦科奇 | mccoch
蒂姆韦尔 | 泰姆韦尔 | timewell
巴克纳 | 巴赫纳 | bachner
图德霍 | 塔杜 | tudhoe
卡迪尤 | 卡迪厄 | cadieux
卡嫩 | 凯南 | kainen
德普图克 | 德普塔克 | deptuck
格尔 | 吉尔 | gehl
莱德福德 | 利德福德 | lydford
科宁 | 科奈恩 | conein
巴尔诺 | 巴诺 | barno
格雷博 | 格里博 | grebow
朗莱因 | 朗莱恩 | longhlein
埃勒斯 | 埃利斯 | elles
卡尼尼 | 卡奈尔尼 | carnearney
坦嫩鲍姆 | 特南鲍姆 | tennenbaum
霍奇根 | 霍根 | hodgan
卡奇亚 | 卡夏 | cachia
莫森 | 莫桑 | morsan
阿杰里斯 | 阿吉里斯 | argeris
明内特 | 明妮特 | minnette
斯通卡德 | 斯顿卡德 | stunkard
安斯帕彻 | 安斯帕赫尔 | anspacher
雅西诺夫斯基 | 贾西诺斯基 | jasinowski
沃尔索奥夫 | 瓦尔塞奥夫 | waltheof
托比特 | 托贝特 | torbett
安德雷斯 | 安德烈斯 | andress
埃尔斯皮 | 伊丽莎白 | elspie
哈根 | 黑根 | hagan
托普尔 | 托佩尔 | topple
泰姆斯 | 泰晤士 | thames
斯维克 | 斯韦克 | svec
斯坦布勒 | 斯坦伯勒 | stanbrough
肯奈尔德 | 肯奈德 | kennaird
勒克拉斯 | 勒克拉 | lecras
安德琳 | 安德林 | andelin
斯普雷尔 | 斯普雷耶 | spreyer
艾克纳 | 艾希纳 | eichner
杜雷 | 杜里 | durey
奥弗拉赫蒂 | 奥弗莱厄蒂 | o'flaherty
博内斯蒂尔 | 博恩斯蒂尔 | bonesteel
克里恩 | 克林 | crean
皮尔克 | 珀基 | pyrke
恩布林 | 恩布琳 | emblin
明维埃尔 | 明维尔 | minvielle
卡尔索普 | 考尔索普 | calthorpe
西森 | 特森 | thesen
吉尔德豪姆 | 吉尔多姆 | guildhaume
埃维 | 埃维尤 | evjue
威尔科夫斯基 | 维尔科夫斯基 | wilkowski
法纽伊尔 | 法纳尔 | faneuil
雷塔 | 里塔 | rheta
波 | 普 | poo
伯尼特 | 伯内特 | burnett
里查特 | 理查特 | richart
鲁尼格 | 朗内加 | runnegar
安特尔兹 | 安索尔兹 | ahntholz
卡莎 | 卡撒 | cartha
多尔杰 | 德尔格 | dolger
希尔斯密斯 | 希尔史密斯 | shearsmith
赫比斯特赖特 | 赫布斯特雷特 | herbestreit
普莱斯顿 | 普利斯顿 | puleston
埃杰曼 | 埃格曼 | egerman
埃尔韦斯 | 埃尔威斯 | elwes
塔弗 | 塔沃尔 | tavor
韦赫 | 韦伊尔 | weiher
韦特 | 维特尔 | vetter
赫米恩 | 赫米奥娜 | hermione
约翰森 | 约翰逊 | johnson
杭德里奇 | 杭德里克 | honderich
劳赫林 | 劳克林 | laughlin
利伯廷 | 利伯蒂娜 | libertine
达莱佩兹 | 达莱佩泽 | dallepezze
博纳维娅 | 博纳维亚 | bonavia
迈尔斯特拉普 | 迈尔斯特勒普 | meilstrup
埃德利 | 埃德尔 | ederle
阿迪奥 | 阿德奥 | addeo
科莫尼亚克 | 科莫尼亚雷克 | komoniarek
格恩斯巴克 | 根斯巴克 | gernsback
瓦图凯蒂斯 | 韦图凯蒂斯 | vaitukaitis
比尔 | 伯尔 | birr
温 | 韦恩 | wain
邓坎森 | 邓肯森 | duncanson
迪尔 | 代尔 | diel
维多尔 | 维多 | vidor
迪思里希 | 迪特里希 | diethrich
迪海 | 德海 | dehay
克里斯坦 | 克里斯廷 | kristine
布拉米尔斯 | 布拉迈尔斯 | blamires
迈斯利希 | 迈斯利奇 | meislich
当西 | 当齐 | dauntsey
沃索 | 瓦索 | wasow
吉尔迪 | 吉亚尔迪 | ghiardi
阿勒姆 | 奥勒姆 | allam
博迪科姆 | 博迪库姆 | bodycombe
施韦尔布 | 施韦布 | schwelb
伊泽诺尔 | 艾泽努尔 | izenour
布尔 | 布雷 | buhre
特雷里斯 | 特里赖斯 | trerise
帕尼特 | 帕内特 | panet
龙恩 | 龙尼 | ronne
平乔 | 平肖 | pinchot
范杰特 | 范格特 | fanget
伊尔格 | 伊尔克 | ilg
查森 | 蔡森 | chasen
科佩拉 | 科皮拉 | coppela
朱拉奇安 | 朱拉布奇安 | joorabchian
斯拉特里 | 斯莱特里 | slattery
厄尔马思 | 厄马思 | earmarth
希拉克 | 希莱克 | shillaker
贝格尔曼 | 比格尔曼 | begelman
梅约 | 梅奥 | mayo
安蒂维尔 | 安特维尔 | antevil
杜纳文特 | 杜纳万特 | dunavant
基珀斯 | 凯珀斯 | kuipers
麦卡勒里 | 麦卡利里 | mcalery
哈兹尔廷 | 黑兹尔坦 | hazeltine
米希尔 | 迈伊尔 | mighill
赫曼 | 希曼 | heman
布罗瑟 | 布拉泽 | brother
辛恩 | 锡恩 | thynne
弗里斯 | 弗里亚斯 | freas
皮尼 | 派尼 | piney
布里安 | 布赖恩 | brian
勒滕德尔 | 勒滕德 | letendre
杰斯 | 杰西 | jesse
利夫斯丘 | 莱韦斯克 | levesque
奥德里 | 奥德丽 | audrey
约瓦诺维奇 | 约万诺维奇 | yovanovitch
安德里尔 | 安德里奥尔 | andriole
斯马比 | 斯梅比 | smaby
英奇金 | 英奇昆 | inchiquin
勒彭内克 | 勒佩内克 | lepennec
多嫩费尔德 | 多宁费尔德 | donenfeld
沃尔德雷普 | 沃尔德里普 | waldrep
德马西奥 | 德马肖 | demascio
穆科夫斯基 | 穆科斯基 | mukowski
泽谢拉 | 泽克拉 | zechella
考莉 | 凯莉 | kallie
斯凯特 | 斯卡特 | skate
布古德 | 布古尔 | bougourd
塞文 | 西文 | sevin
欣恩 | 希恩 | shinn
庞纳佩拉马 | 庞南佩鲁马 | ponnamperuma
米曾 | 迈曾 | mizen
洛梅尔 | 隆梅尔 | lommel
马赫 | 马奇 | much
金尼弗 | 珍妮弗 | gennifer
查萨金斯 | 沙萨涅 | chassagnes
厄尔利 | 厄利 | earley
艾尤托 | 阿尤托 | aiuto
博夫鲁德 | 鲍赫鲁德 | boughrood
吉隆 | 吉伦 | gillon
基尔里 | 基里 | kearey
韦克 | 瓦克尔 | wacker
弗兰兹 | 弗朗兹 | franz
米泽尔 | 米泽勒 | mizelle
托雷斯 | 托里斯 | torres
沃勒本 | 沃莱本 | wohlleben
福尔茨格拉夫 | 法尔茨格拉夫 | pfaltzgraff
沃申科 | 瓦申科 | washenko
博尼特 | 博内特 | bonett
多伊施希尔 | 多伊施尔 | deuschl
马库斯 | 马库塞 | marcuse
厄明杰 | 艾尔明格 | irminger
阿伦 | 艾伦 | allen
布杰克 | 布亚克 | bujake
伊森巴德 | 伊桑巴德 | isambard
乔塔姆 | 乔撒姆 | jotham
温切尔西娅 | 温切尔西 | winchelsea
古卡斯 | 古奥卡斯 | guokas
迪特特 | 迪泰特 | dittert
费滕 | 法滕 | phaten
杜尔菲 | 德菲 | durfee
菲查伊尔温 | 菲茨艾尔温 | fitzailwyn
爱迪生 | 埃迪森 | eddison
希金博瑟姆 | 希金博特姆 | higinbotham
登宁 | 丹宁 | denning
塞雷斯 | 塞尔斯 | sayres
比利尤 | 比利厄 | bilyeu
马奇 | 马季 | marj
斯蒂文顿 | 史蒂文顿 | steventon
布加斯 | 巴加斯 | bugas
埃奇达尔 | 埃奇代尔 | edgedal
林兹顿 | 林斯滕 | lindsten
本内特 | 贝内特 | bennete
贝罗尔 | 伯罗尔 | berall
凯特伦 | 卡特伦 | catron
斯威特凯 | 斯威凯 | switkay
兹巴斯基 | 兹巴尔斯基 | zbarskiy
贝格尔 | 贝尔 | beighle
西利耶 | 特威利尔 | thuillier
弗里达 | 弗雷达 | freda
法拉古特 | 法拉格特 | farragut
科德 | 科尔德 | coard
德加拉迪迪安 | 德加拉贝迪安 | dergarabedian
戈特杰鲁 | 戈特格特鲁 | gottgetereu
布罗厄斯 | 布罗斯 | broas
赫伦布兰德 | 海伦布兰德 | hellenbrand
厄布 | 厄尔布 | erb
西茜 | 锡西 | cissie
莱兰 | 利兰 | lelland
奇瓦泰罗 | 奇瓦特罗 | chivatero
温泽尔 | 温策尔 | wenzel
杜格 | 杜奇 | dooge
巴蒙特 | 贝蒙特 | bamont
奥尔德海泽 | 奥尔迪泽 | aldhizer
洛弗林 | 洛夫林 | lovering
道兹韦尔 | 多德斯韦尔 | dowdeswell
米齐 | 梅齐 | meazey
斯廷纳 | 斯蒂纳 | stiner
戴伦富思 | 迪伦弗思 | dhyrenfurth
拉费蒂 | 拉菲蒂 | laffeaty
格洛布斯 | 格洛伯斯 | globus
扬克威奇 | 扬克维奇 | yankwich
萨奇曼 | 塞奇曼 | sageman
德西里 | 德西蕾 | desiree
凯利 | 丘利 | kewley
卡德拉 | 夸德拉 | cuadra
休希 | 休伊什 | huish
比昂 | 拜昂 | bion
麦金图夫 | 麦金塔夫 | mcinturff
莫福德 | 莫维兹 | morfudd
桑克利 | 尚克利 | sankley
罗梅因 | 罗曼 | romaine
萨马拉 | 赛马拉 | saemala
怀斯坦 | 威斯坦 | wystan
吉尔卢利 | 吉尔胡利 | gilhuly
博德瓦恩 | 鲍德温 | bodwine
勒斯 | 卢斯 | luss
欧恩斯 | 奥恩斯 | owns
鲍科姆 | 鲍库姆 | bawcombe
莱因斯 | 莱恩斯 | lines
莱苏夫 | 勒瑟夫 | lesurf
查伦杰 | 查林杰 | challenger
塞特 | 撒特 | thaete
赛伊 | 西赫 | sih
弗朗西娅 | 弗朗西亚 | francia
亨特雷斯 | 亨特里斯 | huntress
陶苏森 | 蒂乌萨宁 | tiusanen
米尔万 | 米尔德文 | mildvan
马斯曼 | 穆斯曼 | mussman
蔡菲 | 查菲 | chafee
沃罗德 | 沃尔龙德 | walrond
蒙塔文 | 蒙塔冯 | montavon
萨奇 | 萨特杰 | satge
贾尼斯 | 贾尼西 | janisse
比基特 | 比克特 | bicket
加汉 | 加恩 | gahan
德拉波 | 德拉珀 | drapeau
巴里克 | 巴威克 | barwick
霍奇特 | 霍贾特 | hodgart
格雷巴尔 | 格拉巴 | grabar
弗鲁伊特 | 弗鲁特 | fruit
伊勒恩 | 伊尔伦 | illearn
阿布洛姆 | 阿布隆 | ablom
埃斯迈尔 | 伊斯梅尔 | esmail
沃滕伯格 | 瓦滕伯格 | wattenberg
阿迪内特 | 阿迪尼特 | adinet
邓科姆 | 邓库姆 | duncombe
吉尔克雷斯特 | 吉尔克里斯特 | gilchrest
迪克 | 迪克尔 | dicker
佩特金 | 彼得金 | peterkin
霍耶尔贝克 | 胡尔贝克 | houiellebecq
布希 | 布舍 | busche
卡梅尔福德 | 卡姆尔福德 | camelford
勒金比尔 | 卢金比尔 | lukingbeal
比伊 | 布伊 | buie
马尔欣 | 马尔夏恩 | mulshine
米查拉克 | 迈克拉克 | michalak
埃莱克拉 | 伊莱克特拉 | electra
查费茨 | 查菲茨 | chafetz
瑟米厄斯 | 瑟缪斯 | sermeus
艾卡恩 | 伊坎 | icahn
雷埃尔 | 鲁埃尔 | reuel
森 | 图恩 | thun
泰瑟 | 特瑟 | tether
克兰德 | 克林德 | cleander
海森 | 希森 | hyson
沃姆索 | 沃姆泽 | wormsor
吉诺尔 | 格瑙尔 | genauer
穆里 | 缪里 | murie
克莱夫 | 克拉夫 | clave
蒙东纳 | 蒙顿纳 | montonna
卡莎 | 卡沙 | kasha
马拉布尔 | 梅拉伯 | malabre
苏里纳 | 苏雷纳 | surena
马比 | 梅比 | mabie
利希特瓦特 | 利希特瓦尔特 | lichtwardt
奥弗罗尔 | 奥费拉尔 | o'ferrall
马琴 | 梅琴 | machen
希登 | 黑登 | headon
塔谢罗 | 塔什罗 | taschereau
埃廷杰 | 埃廷格 | ettinger
福尔维 | 法尔维 | falvey
杜拉德 | 达拉德 | durrad
沙彭 | 沙蓬 | chapone
林迪 | 琳迪 | lynndie
多努努尔 | 多诺莫尔 | donoughmore
奇德尔 | 切德尔 | chedell
甘博阿 | 甘博亚 | gamboa
巴蒂泽尔 | 巴蒂扎尔 | bartizal
康伯 | 库默 | comber
赫施 | 胡希 | husch
阿克利 | 埃克利 | akeley
奥拉 | 奥尔拉 | orla
布朗丁 | 布隆丁 | blondin
卡丹 | 卡登 | kadane
斯特罗索尔 | 斯特罗萨尔 | strohsahl
阿夫伯里 | 埃夫伯里 | avebury
维利亚博斯 | 比利亚洛沃斯 | villalobos
卢什 | 勒什 | lush
迪达姆 | 迪德姆 | deedham
斯特朗伯格 | 斯特龙伯格 | stromberg
格维茨 | 格威茨 | gurwitz
德梅特 | 德梅特尔 | demaitre
哈特内特 | 哈特尼特 | hartnett
托姆兰 | 汤姆林 | tomline
贝里 | 比尔里 | beary
达姆勒 | 杜姆勒 | dumler
莱奥尼达斯 | 利奥尼达斯 | leonidas
海因菲尔德 | 汉费尔德 | hainfeld
斯托内克 | 斯托尔内克 | stalnecker
萨莱尔 | 萨勒 | saller
马杰里 | 马格丽 | margery
贝沃尔德 | 贝瓦尔德 | baerwald
盖伊 | 贾伊 | ghey
雷姆斯 | 里姆斯 | rheims
费罗扎德 | 费罗祖德 | ferozud
普拉格 | 普拉奇 | plugge
凯乔亚 | 凯乔 | kejoa
博斯顿 | 波士顿 | boston
赫芬 | 赫法恩 | huffine
瑟希 | 塞希 | sershey
埃诺 | 伊诺 | eno
塞利格曼 | 塞利希曼 | seligmann
加韦德 | 加维德 | gaved
科奇尼希 | 科奇尼格 | kotschnig
斯特雷姆劳 | 斯特里姆劳 | stremlau
拜尔 | 贝耶尔 | beier
斯普赖耶 | 斯普赖尔 | spryer
塞瓦克 | 瑟瓦奇 | serwach
艾斯琳 | 阿斯林 | acelin
福尔克斯 | 福克斯 | foulkes
戈茨曼 | 戈特斯曼 | gottesman
杰肯斯 | 格肯斯 | gerckens
阿菲 | 埃菲 | afee
西德博特姆 | 赛德博特姆 | sidebotham
格德 | 格尔德 | gerd
埃克洛夫 | 埃克勒夫 | eklof
博格特 | 博格蒂尔 | boghatyr
芬格勒 | 芬勒 | fengler
埃德弗丽德 | 埃德弗里德 | eadfrid
奥因 | 约恩 | eoin
索 | 托 | thau
西德尼 | 西妮 | sydni
泰尔曼 | 图尔曼 | tureman
德西德拉塔 | 德西德蕾塔 | desiderata
茹伊特 | 朱厄特 | jouett
班顿 | 贝恩顿 | baynton
塞格尔 | 西格尔 | seigel
约克威廉斯 | 约克威廉 | yorkwilliams
弗拉利克 | 弗雷利克 | fralick
塞尔娜 | 塞尔纳 | serna
罗格特 | 罗热 | roget
克莱恩 | 克莱因 | klein
弗雷伊 | 弗雷 | frej
伊登 | 艾登 | idden
希尼特 | 希格尼特 | hignett
沙夫特伯里 | 沙夫茨伯里 | shaftesbury
杜庞特 | 杜邦 | dupont
克利姆克 | 克利姆基 | klimcke
赫尔布利 | 赫布尔 | helble
比尔布勒 | 比尔伯勒 | bilbrough
特拉皮耶 | 特拉皮尔 | trapier
昂布赖特 | 昂布里特 | umbreit
布劳恩 | 布朗 | browne
凯高 | 凯加鲁 | caegarw
胡沃斯 | 休沃斯 | huvos
萨姆斯塔格 | 扎姆斯塔格 | samstag
贾格斯 | 贾格尔斯 | jaggers
格伦巴克 | 格伦巴赫 | grumbach
凯克 | 西克 | cyker
凯斯 | 基斯 | keys
萨基纳 | 萨金娜 | sakinah
勒丰 | 勒方 | lefaune
拉夫向 | 拉夫肖恩 | rafshoon
贝曼 | 比曼 | beman
谢弗特 | 索伊弗特 | seufert
斯特里文斯 | 斯特雷文斯 | strevens
斯坦纳姆 | 斯塔纳姆 | stanham
麦克韦登 | 麦克瓦登 | mcvadon
阿克申 | 埃克申 | action
迈因沙因 | 梅恩沙因 | maienschein
齐米曼 | 齐梅曼 | zimmeman
桑兹 | 桑德斯 | sondes
唐 | 班 | bang
穆普森 | 马普森 | mupson
埃尔 | 埃尔勒 | ehrle
拉克赫斯特 | 卢克赫斯特 | luckhurst
范迪维耶 | 范迪维尔 | vandivier
卡罗尔 | 卡萝尔 | carole
爱丁杰 | 埃丁格 | edinger
德维尔 | 德韦尔 | deveulle
麦高兰 | 麦戈兰 | mcgauran
登帕赛 | 登帕西 | dempasay
格拉特 | 格鲁特 | grutt
马格纳伊 | 马格内 | magnay
法尔康布里奇 | 福尔肯布里奇 | falconbridge
马库斯 | 马克斯 | marcuss
格林斯特德 | 格林斯蒂德 | grinstead
内奇曼 | 纳奇曼 | nacheman
林德尼斯 | 莱因德尼斯 | rhindness
克纳夫 | 纳夫 | knaff
米多斯 | 梅多斯 | meadows
帕德西 | 帕齐 | pudsey
罗勒夫斯 | 罗卢夫斯 | rolufs
塞尔诺维奇 | 切尔诺维奇 | cernovitch
莱加特 | 莱格特 | legatt
尼古莱迪斯 | 尼古拉迪斯 | nikolaidis
戈利特利 | 戈莱特利 | golightly
芒尼克森 | 芒尼克海森 | munnikhuysen
尤尔科威茨 | 尤尔科维茨 | jurkowitz
休 | 舍韦 | schewe
麦金金 | 麦克琼金 | mcjunkin
古普 | 格普 | gup
拉贝特 | 拉贝 | rabet
麦克法迪安 | 麦克法迪恩 | mcfadyean
卢内德 | 莉内德 | luned
乔莫 | 肖莫 | chomeau
科克兰 | 科克伦 | cochrane
布扎扎 | 布尔扎纳 | brzana
莫尔霍尔特 | 莫霍尔特 | molholt
阿加西亚 | 阿加西娅 | agacia
布雷恩特里 | 布伦特里 | braintree
钱伯尔辛 | 钱伯辛 | chamberlsin
盖青格 | 格青杰 | getsinger
艾韦特 | 艾尔薇特 | irvette
霍尼斯 | 霍尔尼斯 | holness
艾舍伍德 | 伊舍伍德 | isherwood
德尼奥 | 迪奈欧 | denio
基尔 | 基利 | kille
奥思内尔 | 奥塞内尔 | othenel
马尼奥利亚 | 马格诺利娅 | magnolia
埃莱斯米尔 | 埃尔斯米尔 | ellesmere
戴西 | 黛西 | daisy
戈迪夫 | 戈德夫 | godefe
蒙泰罗 | 蒙蒂罗 | monteiro
克里斯特高 | 克里斯戈 | christgau
奥科因 | 奥库安 | aucoin
帕尼思 | 帕内思 | paneth
彼得罗 | 佩特罗 | petro
亨萨克 | 亨塞克 | hunsaker
诺阔伊 | 诺基 | norquoy
马克厄姆 | 梅卡姆 | makeham
齐默 | 泽默 | zemmer
斯特罗布里奇 | 斯特劳布里奇 | strawbridge
巴尔塔瑟 | 巴尔塔泽 | baltassar
杜克 | 杜凯 | duque
安弗丽德 | 安弗里德 | amfrid
弗利金格 | 弗利金杰 | flickinger
泽比纳 | 泽拜纳 | zebina
格拉斯戈 | 格拉斯哥 | glasgow
赫钦格 | 赫金杰 | hechinger
哈恩迪 | 哈内迪 | harnedy
斯梅耶 | 斯梅奇 | smaje
奥利文特 | 奥利万特 | ollivant
戈洛琴科 | 戈洛夫琴科 | golovchenko
麦克利莫尔 | 麦克勒莫尔 | mclemore
麦克费德兰 | 麦克费德伦 | macphedran
奥迪吉尔 | 奥迪吉耶 | audigier
赫蒙 | 哈蒙 | hummon
伯特瑟德 | 伯绍德 | berthoud
奥尔卡德 | 阿尔卡德 | alcalde
博奥利 | 比利 | beoley
古比托希 | 古比托西 | gubitoshi
比塔 | 比塔尔 | bitar
耶登 | 伊登 | yeadon
麦克斯帕兰 | 麦克斯帕伦 | mcsparran
达尔威奇 | 达利奇 | dulwich
格罗塞特 | 格罗斯泰特 | grosseteste
施蒂贝林 | 斯蒂贝林 | stiebeling
利基耶尔 | 洛希尔 | lochiel
弗里尔 | 弗雷耶 | freyere
斯斯莫尔伍德 | 斯莫尔伍德 | smallwood
斯康菲尔德 | 舍恩菲尔德 | schonfield
杰亚克 | 齐亚克 | dziak
斯托尔普曼 | 施托尔普曼 | stolpman
弗兰普欣 | 弗兰普申 | framption
博雷特 | 博里特 | borrett
迈克尔约翰 | 米克尔约翰 | meiklejohn
费切姆 | 费克姆 | feachem
拉坎帕涅 | 拉康帕涅 | lacampagne
索维奇 | 索瓦热 | sauvage
赫曼 | 赫尔曼 | herman
古布尔曼 | 古贝尔曼 | gubelmann
科帕德 | 科珀德 | coppard
皮基特 | 皮克特 | picket
埃尔扎 | 埃尔扎伊 | elzay
巴思 | 巴特 | barthe
埃斯科菲 | 伊斯科菲 | escoffey
吉利亚姆 | 吉列姆 | gilliam
博施威茨 | 博希威茨 | boschwitz
哈德格里 | 哈迪格里 | hardegree
皮尔 | 珀尔 | pearl
洛西安 | 洛西恩 | lowthian
多姆安 | 多米扬 | domjan
阿巴斯滕尼娅 | 阿巴斯蒂尼亚 | abastenia
奥利斯 | 阿莱斯 | allies
海泽 | 哈伊泽 | huyser
康梅杰 | 康马杰 | commager
卡拉佩蒂安 | 卡拉佩琴 | carapetyan
麦基恩 | 麦克钦 | mccheane
切尔滕纳姆 | 切尔特纳姆 | cheltenham
克拉布里 | 克拉布特里 | crabtree
埃里特 | 埃雷特 | ehret
特洛 | 特略 | tello
纽伯勒 | 纽伯格 | newburgh
威克斯蒂德 | 威克斯第德 | wicksteed
斯科格伦 | 斯科格隆 | skoglund
麦克文 | 麦克韦恩 | macvean
拉萨尔 | 拉萨 | lassar
万诺伊 | 范诺伊 | vannoy
温塔尔 | 温特尔 | weintal
贾夫 | 贾菲 | jaffe
斯塔姆 | 施塔姆 | stamm
法扎 | 法扎尔 | fazar
马塞尔 | 玛塞勒 | marcelle
尤因斯 | 尤温斯 | uwins
塞切尔斯基 | 切赫尔斯基 | cehelsky
乌尔维奇 | 乌莱维奇 | ulevich
达尔斯特龙 | 达尔斯特伦 | dahlstrom
勒肯 | 卢肯 | lukken
马顿 | 梅顿 | maton
夏拉 | 夏伊拉 | shyla
比恩 | 比汉 | beehan
肯利 | 肯里 | kenrie
法尔肯海姆 | 福尔肯海姆 | falkenheim
洛恩 | 洛温 | lowen
伊利希 | 伊利格 | illig
贝默赛德 | 比默赛德 | bemersyde
米姆诺 | 明诺 | mimno
罗明 | 罗梅因 | romeyn
布雷克斯亚 | 布雷克斯皮尔 | breakspear
扬格斯本德 | 扬哈斯本 | younghusband
沙皮 | 沙比 | sharpey
莱萨奇 | 勒萨热 | lesage
杰普萨 | 杰普撒 | jeptha
巴布利斯 | 布勃利斯 | bublys
锡德福德 | 塞德福德 | thedford
伯特霍尔夫 | 伯索夫 | bertholf
舒特利夫 | 舒特莱夫 | shurtleff
乔齐 | 乔茜 | jozy
黛安 | 戴安 | dian
赞布鲁姆 | 赞布勒姆 | zambrum
马霍恩 | 马洪 | mahone
劳克霍夫 | 劳卡夫 | laukhuff
米尔希 | 米尔海 | milhy
卡德根 | 卡杜根 | cadwgan
博希尔 | 博舍尔 | boshier
雅伯 | 贾伯 | jabber
博维 | 博韦 | bovee
赫克顿 | 赫克通 | hektoen
莱维 | 利瓦伊 | levi
纳撒尼尔 | 纳撒内尔 | nathanael
乔尔万 | 朱尔万 | joulwan
库佐克里亚 | 库佐克雷亚 | cuzzocrea
阿德基森 | 阿基森 | adkisson
施莱 | 施利 | schlie
伊菲根 | 伊菲吉妮 | iphigene
泰菲恩 | 泰维恩 | teifion
亚历克西斯 | 亚历克西丝 | alexys
本贾明 | 本杰明 | benjamin
戈尼娅 | 戈尼亚 | gonya
菲什利斯 | 菲谢利斯 | fischelis
拉罗姆 | 拉勒姆 | larom
坎佩因 | 坎佩恩 | campaigne
古茨怀勒 | 古茨维勒 | gutzwiller
勒金 | 勒德金 | ludgin
阿尔皮娜 | 阿尔皮纳 | alpina
韦雷尔 | 沃雷尔 | werrell
福尔兹 | 福尔茨 | folz
德福德 | 德福特 | deford
齐尼基 | 齐尔尼基 | ziernicki
博比萨德 | 博比苏德 | bobisud
图尔 | 特尔 | tourle
图利特 | 塔利特 | tulett
斯塔克 | 斯图克 | stucke
尚伯格 | 舍恩伯格 | schonberger
兰贝利特 | 兰伯利特 | lambelet
盖伊 | 贾伊 | gye
利希滕斯坦 | 利克滕斯坦 | liechtenstein
安德鲁克斯维奇 | 安德鲁斯克维奇 | andruskevich
托德里亚斯 | 托德雷亚斯 | todreas
布金 | 布尔金 | bourgin
泰林厄姆 | 蒂林厄姆 | tyringham
比伊 | 布埃 | bue
斯拉克斯 | 斯莱克斯 | slacks
阿维斯 | 阿维丝 | aveis
黑吉斯 | 海吉斯 | haigis
奎珀 | 凯珀 | kuiper
阿伦 | 阿龙 | aaron
马尔克斯 | 马尔库斯 | malkus
齐恩 | 蔡恩 | zion
格尔巴克 | 盖尔博 | gelbach
卢夫特 | 勒夫特 | luft
布雷克兰 | 布里克兰 | brekland
布哈拉 | 布阿哈拉 | buachalla
里丁斯 | 赖丁斯 | ridings
沃尔克 | 沃克 | walke
考特尼 | 考特妮 | kourtney
库尔 | 屈尔 | kuehl
比利埃 | 比埃 | billiere
曼恩 | 曼 | mann
赫齐娜 | 赫齐纳 | herzina
施纳克 | 施努克 | schnuck
普钦斯基 | 普辛斯基 | pucinski
佩金 | 帕金 | pagin
贾拉特 | 贾勒特 | jarratt
尼科利 | 尼古拉 | nicolay
梅尔森 | 默森 | merson
塔尔肯 | 萨尔肯 | thalken
基米特 | 金米特 | kimmitt
乔登斯 | 乔丹斯 | jordans
利瑟特 | 利撒特 | leathart
赖津 | 里津 | ryzin
纳马特 | 纳马思 | namath
伯娜 | 伯纳 | berna
索莱兹 | 索莱 | saulez
斯坦齐克 | 斯坦奇克 | stanczyk
巴索尔缪 | 巴托洛缪 | bartholemeu
塔尼娅 | 塔妮娅 | tania
柯克 | 瑟克 | cirker
德文特 | 德温特 | derwent
妮科尔 | 尼科尔 | nicolle
恩德科特 | 恩迪科特 | endecott
阿尔文 | 阿尔温 | alwin
拉瑟姆 | 莱瑟姆 | lathom
霍塞尔 | 休塞尔 | heusel
莱夫勒 | 莱弗拉尔 | leflar
罗萨佩普 | 罗萨皮普 | rosapepe
赫宁伯格 | 赫宁堡 | heningburg
许恩斯坦 | 舍恩斯坦 | schoenstein
福伊尔策格 | 福伊尔齐格 | feuerzeig
塞勒斯 | 塞拉斯 | sellars
梅卢普斯 | 梅拉普斯 | mellups
马拉赫 | 马拉克 | malach
唐奇恩 | 唐奇安 | donchian
巴尔西格 | 巴尔西杰 | balsiger
希拉伯 | 希莱伯 | shillaber
休马森 | 赫马森 | humason
斯蒂夫斯 | 斯特弗斯 | steffes
吉尔鲍德 | 吉尔博 | guillebaud
贝切特 | 贝谢 | bechet
梅利奥尔 | 梅莉奥尔 | melior
鲁马塞特 | 罗马塞特 | roumasset
布尔特 | 博尔特 | boult
克奇弗 | 克切弗 | kerchever
比阿特里夏 | 比阿特丽西娅 | beatricia
福法尔 | 福法 | forfar
梅努欣 | 梅纽因 | menuhin
舒雷 | 舒尔 | shure
菲阿尔卡 | 菲亚尔卡 | fialka
艾萨科 | 伊萨科夫 | isakow
费尔 | 菲尔 | phear
克伦西克 | 赫伦奇克 | chrencik
妮莎 | 尼萨 | neysa
彭沃尔特 | 佩恩沃尔特 | pennwalt
米柳斯 | 米利厄斯 | milius
科塞维茨基 | 科乌谢维茨基 | koussevitzky
米尼奥 | 米内奥 | mineo
伊尔图德 | 伊尔蒂德 | illtud
弗罗泽 | 弗勒泽 | froese
阿什利 | 阿什莉 | ashleigh
切内里 | 切纳里 | chenery
弗莱赫蒂 | 弗莱厄蒂 | flaherty
诺克斯 | 努克斯 | nokes
恰鲁奇 | 基亚鲁奇 | chiarucci
休默 | 瑟默 | thuermer
舍格尔斯 | 舍加尔斯 | shergals
贝格鲁普 | 贝格特鲁普 | begtrup
杜克诺伊 | 迪克努瓦 | duquenoy
波特尼伊德 | 波特诺伊德 | portnoid
托里戈斯 | 托里霍斯 | torrijos
柯彻 | 基尔舍 | kircher
斯托岑巴赫 | 斯托曾巴赫 | stolzenbach
马德里德 | 马德里 | madrid
唐恩 | 唐 | donn
凯特尔比 | 基特尔比 | ketelbey
怀甘特 | 威甘特 | wygant
博弗里 | 博韦里 | boverie
阿莱格拉 | 阿利格拉 | allegra
赖克沃特 | 里克沃特 | rykwert
奥法雷尔 | 奥法雷 | o'farrell
卢宁 | 吕宁 | luening
特金 | 图尔金 | turkin
蒂尔里 | 蒂里 | thierry
乔西 | 约瑟 | josee
施赖伯 | 施里伯 | shriber
迈斯兰 | 迈斯拉恩 | meislahn
格尔纳 | 盖尔纳 | gellner
西肖尔 | 塞克索尔 | sexauer
高因 | 高英 | gowing
本恩 | 贝恩 | benne
科斯 | 库斯 | coes
舍内曼 | 舍尼曼 | schoeneman
福尔克 | 福克 | foulke
穆斯 | 缪斯 | muse
霍威斯布罗克 | 哈维克斯布罗克 | hawixbrock
冈希利 | 贡希利 | goonhilly
哈里尔 | 哈丽尔 | harriel
塞塞尔 | 塞斯尔 | sessel
费尔马纳 | 费尔曼纳 | fairmaner
霍奇森 | 霍奇金森 | hodgkinson
阿尔西夫龙 | 阿尔西弗龙 | alciphron
达纳根 | 杜纳根 | dunagan
特雷西 | 特蕾西 | tracey
乔克 | 吉奥克 | giauque
埃尼德 | 伊妮德 | enid
沙金特 | 瑟金特 | searjeant
拉金 | 莱金 | laging
尚伯格 | 舍恩伯格 | schonberg
米特切夫 | 米采夫 | mitseff
范格 | 范杰 | fanger
布兰肯 | 布兰昌 | blanchan
霍尔迪曼德 | 哈尔迪曼德 | haldimand
吉廉斯 | 吉利亚姆 | guilliams
多奇 | 道奇 | dodge
麦克尼拉奇 | 麦克尼利奇 | macneilage
斯威恩 | 斯温 | sween
罗明格 | 罗明杰 | rominger
戈梅斯拉塔 | 戈梅斯普拉塔 | gomezplata
布乔伊斯 | 布儒瓦 | bourgeois
罗伊巴尔 | 罗伊鲍尔 | roybal
布许夫 | 布舒夫 | bushueff
萨吉塔里厄斯 | 萨吉泰里厄斯 | sagittarius
比克 | 贝克 | beek
福斯 | 富斯 | fuoss
特怀德尔 | 特威德尔 | twidell
雷努亚德 | 伦瓦尔 | renouard
希拉斯 | 希勒斯 | heelas
考尔德克卢 | 考尔德克拉夫 | caldcleugh
克拉格 | 克莱格 | clague
贾西纳 | 杰西纳 | jacyna
切希尔 | 切斯希尔 | chesshyre
朗斯伯格 | 劳恩斯伯格 | lounsburg
布雷钦 | 布里金 | brechin
古德拉姆 | 古德哈姆 | gooderham
耶格 | 耶格尔 | yager
巴尔恩 | 鲍恩 | balne
霍普 | 霍伊普 | heup
施雷尔 | 施赖尔 | schreyer
阿德钱尼奇 | 阿德查尼克 | ardcharnich
贝迪利恩 | 贝迪利翁 | bedillion
史迈思 | 史密斯 | smyth
里道特 | 赖德奥特 | rideout
麦考斯兰 | 麦考斯伦 | mcauslan
尼思代尔 | 尼斯代尔 | nithsdale
马托 | 马泰奥 | matteo
多罗西 | 多萝西 | dorothy
斯塔宾 | 斯图宾 | stubbing
奥尔弗森 | 阿尔弗森 | alverson
索洛特斯 | 索尔特斯 | solotesz
坎普施勒 | 坎普施罗尔 | kampschror
德斯马托 | 德马尔托 | desmarteau
马吉雷尔 | 马圭雷尔 | maguirel
夏普 | 谢普 | shairp
格赖德 | 格雷德 | greider
索恩代克 | 桑代克 | thorndike
马沙姆 | 马香 | marsham
奥伯赫曼 | 奥伯黑尔曼 | oberhelman
帕特里亚赫 | 佩特里亚克 | patriach
海内曼 | 海涅曼 | heinemann
里查兹 | 理查兹 | richards
艾奇森 | 艾奇逊 | eytchison
布里安特 | 布赖恩特 | briant
丹罗瑟 | 丹罗伊特 | dannreuther
巴恩比 | 巴恩贝 | barnebey
梅林达 | 梅琳达 | melinda
弗伦泽 | 弗伦策 | frenzer
康西尔 | 康斯尔 | council
海因鲍姆 | 欣鲍姆 | sheinbaum
沃拉尼厄斯 | 瓦拉尼厄斯 | waranius
赫马尼克 | 赫马纽克 | hermaniuk
哈默特 | 赫默特 | hummert
维思 | 韦思 | vaeth
拉曾 | 拉津 | razeen
巴塔格尔 | 巴塔杰尔 | battagel
埃韦克 | 埃厄克 | earwaker
格林达尔 | 格林德尔 | grindal
塞弗林豪斯 | 塞夫林豪斯 | sevringhaus
贾科特 | 贾科泰 | jacottet
布雷利 | 布里厄利 | brealey
麦科尚纳格 | 麦科尚奈格 | maco'shannaig
麦克廷格 | 马赫廷格 | machtinger
梅贝 | 梅布 | mabe
康杰 | 康格 | conger
柯尼格 | 凯尼格 | koernig
卡塞尔 | 卡瑟尔 | cuthell
迪威斯 | 德威斯 | dewees
奥琳达 | 奥林达 | orinda
基茨哈伯 | 基察伯 | kitzhaber
布雷齐尔 | 布雷热 | brazier
芬尼 | 菲尼 | phinney
奥尔迪 | 阿尔迪 | alday
阿曼德斯 | 阿曼达斯 | amandus
赛纳 | 西纳尔 | synar
康科拉 | 康科勒 | concholar
卢娜 | 卢纳 | luna
杜纳利 | 达纳利 | dunalley
默茨基 | 默茨克 | mertzke
德莱奥 | 德利奥 | deleo
赫瑟尔斯 | 赫塞尔斯 | hessels
肖勒 | 朔伊勒 | scheuler
特鲁曼 | 杜鲁门 | truman
惠伦 | 惠兰 | whelan
达奇 | 达基 | dachi
迪奥 | 德奥 | deo
拉思 | 雷思 | rathe
霍尔巴克 | 哈尔巴赫 | halbach
戈德温 | 戈尔德温 | goldwyn
加莱尔 | 加利尔 | galil
沃特 | 鲁尔特 | rurt
赫利 | 赫尔利 | hurleigh
克罗嫩贝格 | 克罗嫩伯格 | kronenberg
克里希顿 | 克赖顿 | crichton
格威内德 | 格威内思 | gwynedd
博奇 | 布谢 | bouchey
波威尔斯 | 鲍威尔斯 | powels
罗雷姆 | 罗勒姆 | rorem
安德里厄斯 | 安德里厄 | andrieux
阿莱恩 | 阿林 | alleine
贝克 | 贝克尔 | becker
怀索基 | 维索茨基 | wysocki
扎奇曼 | 扎克曼 | zachmann
亨尼 | 赫尼 | henie
萨里奇 | 瑟里奇 | surridge
唐西娅 | 唐西亚 | donsia
达克罗 | 迪克罗 | ducrow
格里甘蒂 | 格雷甘蒂 | greganti
沃尔克 | 沃克 | walk
沃尔克 | 沃克 | walker
麦科拉姆 | 麦科勒姆 | mccollam
德格雷赫特 | 德格拉赫特 | dergracht
迈尔堡 | 迈尔伯格 | myerburg
斯坦达洛夫特 | 斯坦德洛夫特 | standaloft
埃克伦茨 | 厄克伦茨 | ercklentz
莱恩斯 | 莱昂斯 | lyons
德沃查克 | 德沃夏克 | dvorchak
费布里坎特 | 法布里坎特 | fabricant
考克伦 | 库格伦 | coughran
多克特 | 多克托 | docktor
弗劳西斯 | 弗朗西斯 | fraunces
菲林 | 法林 | filene
拉尔 | 勒尔 | lull
塞门扎 | 西门扎 | semenza
哈森富斯 | 哈森弗斯 | hasenfus
汤明森 | 托明森 | tominson
加托夫 | 加特霍夫 | garthoff
蒂克西耶 | 蒂克西尔 | tixier
蔡恩 | 夏恩 | cheyenne
彼得龙 | 佩特龙 | petrone
格蕾西 | 格雷西 | gracie
格里桑蒂 | 格里桑迪 | grisanti
梅尔斯 | 马雷斯 | mares
庞滕尼 | 庞特尼 | pounteney
安奈林 | 阿内林 | aneirin
劳比克 | 鲁比克 | roubik
冈利 | 高恩利 | gownley
博尔达什 | 博达什 | bordash
卡萨森 | 卡萨森特 | casasent
劳本盖尔 | 劳本盖耶 | laubengayer
阿图鲁斯 | 阿图罗斯 | arturous
布兰肯巴克 | 布兰肯贝克 | blankenbaker
拉拉比 | 拉勒比 | larabee
埃斯坎达里安 | 伊斯坎达里安 | eskandarian
兹洛林斯基 | 兹沃林斯基 | zwolinski
贾洛雷齐 | 贾洛伦齐 | giallorenzi
盖格 | 盖杰 | gager
特穆多 | 塞穆多 | themudo
科尔奎特 | 科尔基特 | colquitt
达什曼 | 杜什曼 | dushman
贝松 | 贝森 | bessone
撒勒 | 塞勒 | thaler
萨科夫斯基 | 赛科夫斯基 | saikowski
塞格雷夫 | 西格雷夫 | segrave
苏代尔 | 舍代尔 | suirdale
哈莫尔 | 哈默 | hamor
博索沃思 | 博索姆沃思 | bosomworth
普普 | 普珀 | puppe
施米德 | 施密德 | schmid
黑尔 | 海尔 | haire
哈克威尔 | 黑克威尔 | hakewill
莫纳 | 莫娜 | mona
格雷恩 | 格兰妮 | grainne
特鲁赫特 | 特鲁哈特 | trueheart
亚里莫维奇 | 雅里莫维奇 | yarymovych
登尼斯顿 | 丹尼斯顿 | denniston
塞尼奥尔 | 西尼尔 | senior
哈特赛德 | 哈齐德 | hartsid
博伊斯拉根 | 博勒根 | boisragon
雷伯特 | 雷巴特 | rebut
索热 | 索热尔 | saussure
科克森 | 考克森 | coxon
斯克鲁塔托 | 斯克鲁泰特 | scrutator
格里泽 | 格赖泽 | griser
哈泽利普 | 黑兹利普 | hazelip
布兰塞特 | 布兰西特 | blanscet
迪文 | 德文 | deven
贝拉尼娅 | 贝拉尼亚 | berania
利宁 | 莱宁 | leining
许霍尔兹 | 许霍尔茨 | schuerholz
科尔赫普 | 科尔黑普 | kohlhepp
博廷 | 博滕 | boateng
鲁奥科 | 罗科 | ruocco
加诺尔 | 加诺 | ganor
鲍德施维勒 | 巴尔德施维勒 | baldeschwieler
鲍兰 | 布兰 | bourland
斯洛尼姆 | 斯洛宁 | slonim
马撒 | 玛莎 | martha
珀塞克 | 佩塞克 | perseck
维伦 | 瓦伊伦 | viron
皮尔森 | 皮尔逊 | pirsson
索尔茨 | 肖尔茨 | soults
杰鲁尔德 | 杰罗尔德 | gerould
杰尔 | 耶格 | jaegher
赫雷肖夫 | 赫雷斯霍夫 | herreshoff
加弗 | 盖弗 | gaver
柯兰 | 柯伦 | curran
瓦伦齐拉 | 巴伦苏埃拉 | valenzuela
肖尔斯 | 肖沃斯 | showers
阿鲁 | 阿古 | agwu
弗拉克斯 | 弗勒克斯 | flux
考斯利 | 库斯利 | cousley
林恩 | 林 | linn
德赖克 | 德里克 | driker
里查德 | 理查德 | richard
罗伯森 | 罗伯逊 | robertson
达肯 | 达坎 | dakan
吉特沙姆 | 吉彻姆 | gitsham
利维瓦克 | 莱夫奥克 | liveoak
普鲁斯曼 | 普拉斯曼 | prusman
基弗 | 凯弗 | keifer
吉汉 | 吉亨 | gehan
施努克尼 | 施努克内 | schnukne
阿盖尔 | 阿高尔 | argall
温纳斯特伦 | 温纳斯特鲁姆 | wennerstrum
利德克 | 利迪克 | luedecke
普吕内克 | 普伦尼克 | pluenneke
赫希特里特 | 赫什特里特 | hirschtritt
布卡齐 | 布卡奇 | bukatzsch
贝拉德 | 贝拉尔 | berard
马尔文农 | 马尔韦农 | mulvenon
巴特伦 | 巴特拉姆 | battram
皮珀 | 派珀 | piper
格劳尔 | 格罗尔 | grower
豪瑟姆 | 豪萨姆 | howsam
德沃尔金 | 德沃金 | dworkin
阿特尔西 | 阿特莱西 | attlesey
加格内宾 | 加涅班 | gagnebin
霍 | 豪 | howe
布莱克米特 | 布莱希施米特 | blechschmidt
赫维茨 | 赫威茨 | herwitz
梅恩斯 | 梅因斯 | mains
克兰德 | 克兰 | kland
马梅杜克 | 马默杜克 | marmaduke
贝约克 | 贝尤克 | bayuk
科尼罗 | 科内罗 | corneiro
奎伦 | 奎林 | quillen
贝思 | 贝丝 | beth
比尔霍尔特 | 伯霍尔特 | byrholdt
约赫 | 约埃 | yohe
恩格弗 | 恩弗 | engfer
亚特伦 | 亚特隆 | yatron
斯凯姆 | 斯基姆 | skym
格瓦托夫斯基 | 格瓦尔托夫斯基 | gewartowski
巴思利 | 布思莱 | buthlay
里尤塔 | 里乌塔 | riutta
普伦蒂 | 普朗蒂 | prunty
奥拉克林 | 奥劳克林 | o'laughlin
梅约拉斯 | 马约拉斯 | mayoras
埃夫利 | 伊夫利 | evelegh
沃尔斯托克拉夫特 | 沃斯通克拉夫特 | wollstonecraft
法夫罗特 | 法夫罗 | favrot
阿曼 | 阿尔曼 | arman
阿米欧 | 阿米奥特 | amiot
贝德尔 | 比德尔 | bedel
阿德尼 | 埃德尼 | adney
莫利诺尔 | 莫勒瑙尔 | mollenauer
芬维西 | 芬韦西 | fenvessy
盖尔德 | 格尔德 | gelder
萨森 | 萨瑟恩 | southern
诺塔奇 | 诺蒂奇 | nottage
巴查尔 | 巴卡尔 | bachar
奥尔博 | 阿尔博 | allbaugh
德利乔戈斯 | 德利乔治斯 | deligiorgis
加雷尔 | 加勒尔 | garel
奥尔 | 奥利 | ole
巴德瓦恩 | 布德温 | budwine
迪奥 | 戴奥 | dio
布鲁尔奇 | 布勒尔施 | broelsch
格龙基 | 格朗茨基 | groncki
米德拉尔斯基 | 米德拉斯基 | midlarsky
沃梅利 | 沃姆利 | wormeley
戴姆里奇 | 德姆里克 | daemmrich
肖尔德勒 | 斯科德勒 | scholderer
迪比 | 达比 | duby
迈泽尔 | 米泽尔 | mizel
贝尔比 | 比尔比 | beilby
博斯金德 | 博斯坎德 | boskind
瑟维尔 | 瑟维耶 | surveyer
米尔 | 缪尔 | muille
纽尼梅克 | 努尼梅克 | nunemaker
阿尼斯 | 安妮斯 | anis
阿布林 | 埃布林 | ablin
班德 | 班德尔 | bander
罗萨尔 | 罗塞尔 | rossall
谢德 | 沙德 | shad
福塞特 | 福西特 | fawssett
阿蒂耶 | 阿提耶 | atiyeh
伦芬特 | 朗方 | lenfant
尤夫罗松 | 尤弗罗西尼 | euphrosyne
杰雷迈亚 | 杰里迈亚 | jeremiah
雷奥赫 | 里奥克 | reoch
艾亚拉 | 阿亚拉 | ayala
卡尔卡诺 | 卡尔卡尼奥 | calcagno
佩特里兹 | 佩特里迪斯 | petrides
科德尔 | 科德 | corder
戴文 | 达文 | davern
罗珊娜 | 罗珊 | rozanne
戈歇尔 | 戈查尔 | gotshal
埃莉娜 | 埃琳娜 | elena
杜伊 | 杜韦 | duwe
布雷德 | 布里德 | breder
麦加恩 | 麦加亨 | mcgahern
利班 | 莱班 | leban
穆拉尔特 | 缪拉尔持 | muralt
巴克韦尔 | 贝克韦尔 | bakewell
萨洛梅 | 萨洛米 | salome
马丽萨 | 马里萨 | marisa
梅德瓦多斯基 | 梅德瓦多夫斯基 | medwadowski
弗莱特伍德 | 弗利特伍德 | fleetwood
希特 | 海厄特 | hieatt
惠奇利夫 | 惠特克利夫 | whitchliffe
朱夫里达 | 朱弗里达 | giuffrida
怀森 | 威森 | wison
德彻特 | 德克特 | dechert
奥利夫 | 奥利芙 | olive
德夫尼 | 迪夫尼 | deveney
海姆索思 | 海姆塞特 | heimsoth
希伯德 | 希巴德 | hibbard
盖斯特菲尔德 | 盖斯特费尔德 | geistfeld
埃格特 | 埃格伯特 | egbert
塔利费罗 | 托利弗 | taliaferro
怀尔海德 | 威尔海德 | wilhide
埃博罗尔 | 埃博拉尔 | eborall
莱塞特 | 莱西特 | lycett
莱根 | 利根 | lygon
奥利克西夫 | 奥莱克休 | oleksiw
阿列斯 | 阿莱 | allez
卡德瓦拉戴尔 | 卡德瓦拉德 | cadwaladyr
萨尔温 | 西尔温 | sulwen
法迪安 | 法迪恩 | fadyean
伯克隆 | 伯克伦 | berklund
德雷南 | 德雷宁 | drennen
德彻 | 德谢尔 | decher
巴特伦 | 巴特拉姆 | buttram
麦库尔 | 麦考尔 | mackoul
特鲁齐 | 特拉齐 | truzzi
阿布迪安 | 阿布迪恩 | abdian
托里 | 托丽 | tori
卡里洛 | 卡里略 | carrillo
马特纳 | 马塞纳 | marthena
凯莉 | 卡利 | cali
