Duprée	杜普雷
Guenièvre	圭妮夫尔
Haidée	海迪
Ibargüen	伊瓦尔根
Irenӓus	艾雷尼厄斯
Klór	克洛尔
Muñoz	穆尼奥斯
O’melveny	奥梅尔维尼
Orde-Powlett	奥德
Peña	培尼亚
Pérault	佩罗
Pérot	佩罗
Péterffy	彼得菲
Prédmore	普雷德莫
Raánan	拉阿南
Ramée	拉梅
Schӧeffel	舍费尔
Schӧem	舍姆
Schӧenbrun	舍恩布伦
Schӧeni	舍尼
Schӧenmann	舍恩曼
Schӧeppel	舍佩尔
Schüerch	许尔希
Schüessler	许斯勒
Schüettinger	许廷格
Schůt	舒特
Strebél	斯特雷贝尔
Tourgée	图尔热
Tourjée	图尔杰
Zídek	齐德克
