布雷金里奇 | 布雷肯里奇 | breckinridge
塞德 | 切德 | cedd
玛莉 | 马利 | maly
阿西尼加 | 阿西涅加 | arciniega
霍普特 | 豪普特 | houpt
西恩 | 西根 | seaghan
斯特拉西恩 | 斯特拉森 | strathearn
派珀特 | 佩珀特 | peipert
梅雷斯曼 | 米尔斯曼 | meresman
弗兰岑 | 弗兰曾 | franzon
伊兹比基 | 伊兹比茨基 | izbicky
埃查维斯特 | 埃沙韦斯特 | echaveste
费尔伯恩 | 费尔贝恩 | fairbairn
沃塞尔 | 瓦塞尔 | wassell
西金特 | 萨金特 | seargent
亨巴克 | 亨巴赫 | heimbach
纳尔迪 | 纳迪 | nardi
杰米马 | 杰迈玛 | jemima
莫杜伊特 | 莫德维 | mauduit
惠塔克 | 惠特克 | whitacre
艾特 | 艾厄特 | eyet
耶德利 | 亚德利 | yeardley
欣奇利夫 | 欣奇克利夫 | hinchcliffe
博比 | 鲍比 | bobbie
迪普斯 | 杜普斯 | dupes
麦基尔文娜 | 麦基尔温纳 | macilvenna
赖因斯 | 赖恩斯 | rines
麦克费伦 | 麦克弗伦 | mcpherren
埃德尔霍赫 | 埃德尔霍克 | edelhoch
博特尔 | 博索尔 | botsal
瓦格尼 | 韦恩 | wagne
厄德曼 | 厄尔德曼 | erdman
戈伦贝夫斯基 | 戈伦别夫斯基 | golembiewski
布罗兰 | 布罗林 | brorein
格雷戈尔 | 格雷瓜尔 | gregoire
米卡亚 | 迈凯亚 | micajah
莱德洛 | 莱德劳 | laidlaw
科姆斯诺夫 | 科梅萨罗夫 | komesaroff
雷马克斯 | 拉马克斯 | raemakers
皮凯弗 | 皮卡弗 | piccaver
苏布林 | 萨布林 | subrin
斯克拉顿 | 斯克鲁顿 | scrutton
津南 | 津宁 | zinnen
佩莱蒂埃 | 佩尔蒂埃 | pelletier
帕塞尔 | 帕斯尔 | parcel
霍诺里 | 霍诺丽 | honori
艾梅施 | 伊梅施 | imesch
埃尔托黑德 | 埃尔顿黑德 | eltonhead
西明顿 | 赛明顿 | symington
特鲁普 | 思鲁普 | throop
马豪 | 玛奥 | mahault
法克 | 菲克 | fike
奥德斯 | 奥杜斯 | audus
加布尔 | 加伯 | gabbour
韦克特尔 | 瓦赫特尔 | wachtel
塔利亚雷罗 | 塔利亚费罗 | tagliaferro
夏夫尔 | 希维尔 | shivell
马金南 | 马基嫩 | makinen
拉凯斯 | 拉雪兹 | lachaise
麦科瑙希 | 麦康瑙希 | mcconaughy
达维格多 | 达维多尔 | d'avigdor
加莱夫 | 加利夫 | galef
达文 | 达温 | darwen
卡斯格伦 | 卡斯格兰 | casgrain
曼纳韦 | 马纳韦 | mannaway
梅根 | 米恩 | meighen
艾佐德 | 伊佐德 | izod
图马 | 托伊马 | teuma
奥夫 | 奥 | ough
阿富里特 | 阿富尔蒂特 | affourtit
米萨尔 | 米赛尔 | misael
赫默里赫 | 亨默里克 | hemmerich
黑伍德 | 希伍德 | heawood
詹宁斯 | 杰宁斯 | jenyns
安瓦里库尔 | 安瓦里普尔 | anvaripour
莱伯恩 | 利伯恩 | liburn
比比 | 毕比 | beebe
考尔德尔 | 考德尔 | caldell
博查特 | 博哈特 | borchardt
卡明 | 卡迈恩 | carmine
巴特伦 | 巴特拉姆 | bartram
派尔 | 皮尔 | peile
麦康 | 麦肯 | mccon
舒克伯格 | 舒克伯勒 | schuckburgh
麦卡里 | 麦凯里 | mccarey
菲达迪斯 | 菲丹迪斯 | fidandis
英芬特 | 因方特 | infant
卡赫 | 卡尔 | karrh
杰罗尔 | 杰拉尔 | gerall
亨内肯斯 | 亨尼肯斯 | hennekens
吉弗 | 贾埃弗 | giaever
克雷 | 克里 | kerrey
贾米 | 杰米 | jamie
鲍尔霍恩 | 巴尔霍恩 | ballhorn
斯特吉斯 | 斯特奇斯 | sturges
莫克萨姆 | 莫克塞姆 | moxam
多 | 道 | daw
阿什多恩 | 阿什当 | ashdown
卡姆 | 卡尔姆 | culme
比克姆 | 比卡姆 | bickham
夏尔曼 | 沙伊尔曼 | shireman
梅佐利 | 梅索伊 | meszoly
吉尔德 | 盖尔德 | geld
福伊希特瓦格 | 福伊希特万格 | feuchtwanger
埃森斯 | 埃森丝 | essence
格沃思米 | 格瓦思米 | gwathmey
巴比罗利 | 巴尔比罗利 | barbirolli
利布 | 利比 | luebbe
施蒂宁 | 斯蒂宁 | stiening
克莱农 | 克勒农 | clernon
金德雷德 | 金德里德 | kindred
德鲁夫 | 德鲁伊夫 | druiff
努索尔 | 纳托尔 | nuthall
佐扎 | 佐尔扎 | zorza
戴格 | 戴伊 | daigh
埃坦 | 埃泰恩 | etain
德尔里戈 | 德尔列戈 | delriego
巴策 | 巴策尔 | batzer
廷肯 | 廷康 | tinkon
德弗雷茨 | 迪弗雷特斯 | defrates
尤拉姆 | 乌拉姆 | ulam
比沃特 | 拜沃特 | bywater
梅恩斯 | 默恩斯 | mearns
格罗布 | 格罗比 | grobe
塔塔利尼诺 | 塔尔塔利诺 | tartaglino
亚历山大 | 达历山大 | d'alexander
兰布 | 拉姆 | lambe
考德韦尔 | 考德威尔 | caldwell
利多尔 | 利德尔 | liddall
泽米娜 | 泽米纳 | zemina
希利 | 赫利 | helie
坎特伯里 | 坎特伯雷 | canterbury
斯蒂克 | 斯特克 | stirk
塔肯 | 泰肯 | tacon
古特穆特 | 古特穆思 | gutermuth
弗森 | 费尔森 | ferson
托皮 | 托毕 | torpey
玛乔林 | 马乔林 | marjolin
洛多维克 | 洛多威克 | lodowicke
泰奇曼 | 泰克曼 | teichmann
普鲁德霍姆 | 普鲁多姆 | prudhomme
基斯塔纳西米 | 基斯特纳萨米 | kistnasamy
坎比 | 坎贝 | cumbey
赫姆尔 | 赫姆利 | hermle
蒙冈 | 蒙贡 | mongon
亨佩尔 | 亨普尔 | hempel
艾罗 | 艾罗尔特 | ayrault
赖蒂娜 | 赖蒂纳 | rytina
弗拉泽 | 弗雷泽 | frazer
雷亚 | 雷 | rea
富加特 | 富盖特 | fugate
罗林格 | 罗林杰 | rollinger
德卢伊吉 | 德路易吉 | deluigi
科切雷斯 | 科克里斯 | cocheres
霍斯伯格 | 霍斯伯勒 | horsburgh
鲁德 | 鲁阿兹 | ruadh
克拉伯 | 克莱伯 | klaber
格里索德 | 格雷特黑德 | greathead
马尔特比 | 莫尔特比 | maltby
埃塞雷达 | 埃塞丽达 | ethelreda
迪恩娜 | 迪恩纳 | dienna
博里尔 | 博雷尔 | boreel
布雷洪 | 布里恩 | brehon
盖尔 | 圭尔 | guire
尤彻克 | 尤尔丘克 | yurchuck
坦尼肯 | 滕尼肯 | tennican
利文 | 莱文 | levene
克拉特 | 克鲁特 | krutter
克拉尔斯 | 克拉雷斯 | clares
朱林科 | 祖林科 | dzurinko
林利索 | 林利思戈 | linlithgow
索茹纳 | 索杰纳 | sojourner
伍兹德 | 伍德赛德 | woodside
克努贝尔 | 努贝尔 | knubel
卡诺肯 | 卡诺坎 | carnochan
吉胡诺 | 吉赫诺 | giheno
罗克辛 | 罗克西娜 | roxinne
伦斯莱尔 | 伦塞勒 | rensselaer
伊登斯 | 埃登斯 | edens
古妮拉 | 古尼拉 | gunilla
比哈里尔 | 贝哈里尔 | beharriell
朗钱普 | 朗香 | longchamp
卡特费罗利 | 卡特鲁费洛 | cutrufello
舒尔金德 | 舒尔坎德 | schulkind
皮什 | 佩什 | peche
威尔怀特 | 威尔海特 | willhite
利金斯 | 莱金斯 | lykins
洛伦兹 | 洛伦茨 | lorenz
特波尔 | 蒂普尔 | tepoel
吉莫 | 贾伊莫 | giaimo
库尔吉安 | 库尔金 | kuljian
哈米利恩 | 哈米里恩 | hamilyon
利恩 | 利安娜 | leanne
格拉伯 | 格雷伯 | graber
弗兰库姆 | 弗兰克姆 | frankum
基尔库西 | 基尔科西 | kilcoursie
纽布兰克 | 纽布兰奇 | newbranch
雷森诺弗 | 里曾诺弗 | reasonover
查肯 | 查康 | chacon
雷布萨门 | 里布萨门 | rebsamen
托菲申 | 托菲肯 | torphichen
布利肯斯弗 | 布利肯斯德弗 | blickensderfer
戈萨尔斯 | 戈瑟尔斯 | goethals
瓜尔蒂里 | 瓜尔蒂耶里 | gualtieri
泽兰 | 齐伦 | zeran
比贝尔 | 比布尔 | biebel
奥尔德斯蒂尔 | 奥尔德斯泰尔 | oldstyle
西门斯 | 西门子 | siemens
普利本 | 普利邦 | plybon
贝克纳 | 比克纳 | beichner
恩戈尔姆 | 恩格霍姆 | engholm
迪瓦斯 | 德瓦斯 | dewas
兰内伯格 | 兰恩伯格 | ranneberger
桑德威克 | 桑威克 | sandwick
威思 | 韦思 | wyeth
施维希尔德 | 施韦柴尔德 | schweichild
斯坦霍普 | 斯坦诺普 | stanhope
英沃尔斯塔德 | 英沃斯塔德 | ingvoldstad
森格 | 桑戈尔 | senghor
布赖格豪斯 | 布里格豪斯 | brighouse
克伦布哈尔 | 克伦巴尔 | krumbhaar
莫拉尔 | 莫勒 | morar
弗里利 | 弗赖利 | friley
赖兰斯 | 赖伦斯 | rylance
赫斯莱普 | 赫斯利普 | heslep
埃文 | 欧文 | ervin
哈扎德 | 哈泽德 | hazard
马谢特 | 马希特 | mushet
布拉姆利 | 布伦利 | brumley
比尔特 | 伯特 | birt
明 | 米恩 | min
菲格雷斯 | 菲格斯 | figures
埃加尔 | 埃加 | eggar
特库姆什 | 特库姆塞 | tecumseh
伊万吉斯塔 | 埃万杰利斯塔 | evangelista
韦布利 | 韦伯利 | webley
帕门蒂尔 | 帕尔芒捷 | parmentier
迪杰利斯 | 迪安杰利斯 | deangelis
蒂克斯通 | 西克斯通 | theakstone
格里诺尔特 | 格里纳沃尔特 | greenawalt
麦格拉斯里奇 | 麦格拉斯里克 | macglasrich
索恩顿 | 桑顿 | thornton
巴洛克 | 巴洛赫 | balloch
切尔内斯基 | 切尔涅斯基 | chernesky
克龙 | 克朗 | kron
西博恩 | 西伯恩 | seaborn
里斯伯格 | 赖斯伯格 | riseberg
拉德姆 | 拉德勒姆 | rudderham
特里利文 | 特里莱文 | treleaven
阿文特 | 埃文特 | avent
比内尔 | 比尤内尔 | buesnel
哈格迈耶 | 哈格迈尔 | hagemeyer
弗卡克 | 弗凯克 | verkaik
西米恩 | 西明 | siemien
罗恩德 | 罗安德 | rowand
普里亚尔 | 普赖尔 | prial
布利萨克 | 布利萨茨 | blisac
马尼斯 | 马内斯 | maness
拜兹 | 比德兹 | bidez
厄威尔 | 厄维尔 | irwil
威尔梅特 | 薇尔梅特 | wilmett
纳拉乔 | 纳兰霍 | naranjo
布雷兰 | 布里兰 | breland
卡尔 | 卡利 | karle
阿德莉娜 | 阿德利娜 | adelina
斯特尔特 | 斯泰尔特 | stelter
明韦尔 | 米恩韦尔 | meanwell
舒克伯格 | 沙克伯勒 | shuckburgh
特雷富西斯 | 特里富西斯 | trefusis
亚历山森 | 亚历山德森 | alexanderson
科克伦 | 科克兰 | cockran
圭尔 | 瓜尔 | guare
朱皮特 | 丘辟特 | jupiter
多伊特里奇 | 多伊特里希 | deutrich
托厄里 | 托尔里 | towery
马德林 | 马德琳 | madlin
威舍 | 维舍 | wischer
卡莉尔 | 卡利尔 | kalil
肖茨 | 肖恩茨 | shontz
弗劳 | 弗劳德 | furlaud
戴加德 | 迪格 | dygard
库比特 | 丘比特 | cubitt
福尔迪西 | 福尔德西 | foldessy
西克雷斯特 | 西克里斯特 | secrest
拉扎 | 拉扎尔 | lazar
麦贡 | 麦古恩 | macgoun
佩茨 | 皮特斯 | petes
皮克斯 | 皮尔克斯 | pearkes
皮伦斯 | 佩伦斯 | peirens
费尔哈文 | 费尔黑文 | fairhaven
特里德格 | 特里迪加 | tredegar
埃塞 | 阿瑟 | acer
艾丽 | 阿利 | alli
阿蒂盖尔 | 阿蒂格尔 | attygalle
马西亚 | 玛西娅 | mathea
费布勒 | 法布勒 | fabler
彼得拉斯卡 | 彼特鲁斯卡 | petruska
弗恩 | 维恩 | verne
韦姆 | 瓦伊姆 | waim
鲁兰 | 鲁伦 | ruellan
拉赫特 | 拉克特 | lachter
拉哈布 | 雷哈布 | rahab
斯蒂格勒 | 施蒂格勒 | stigler
特威宁 | 特文宁 | twining
西达罗斯 | 西达劳斯 | sidarouss
弗洛温杜 | 弗劳尔迪 | flowerdew
盖兰 | 格兰 | gellan
吉梅内斯 | 希门尼斯 | jimenez
杜因特 | 德温特 | dewint
斯威特曼 | 斯韦特曼 | sweatman
范沃森 | 范福森 | vanfossan
加姆齐 | 加梅齐 | garmezy
布鲁因 | 布勒因 | bruyn
塔米哈尔 | 塔米希尔 | tamihere
拉弗莱奇 | 拉弗莱什 | lafleche
麦格罗瑟 | 麦格鲁瑟 | macgreuther
柯特尼厄斯 | 柯特纽斯 | curtenius
阿斯基思 | 阿斯奎思 | asquith
赫利娜 | 赫莉娜 | helina
伊蒂拉格 | 伊泰拉格 | itteilag
斯特朗格 | 斯特朗 | stronge
埃沃伊 | 伊沃伊 | evoy
迪伦富思 | 迪伦弗思 | dyhrenfurth
麦克努尔蒂 | 麦克纳尔蒂 | macenulty
坦吉 | 坦圭 | tanguay
布里尼希 | 布里尼格 | brinig
拉斯布里格 | 拉斯布里杰 | rusbridger
沃思 | 沃西斯 | wathes
杜布拉斯 | 杜布拉 | dubras
亚兹明 | 亚斯明 | yazmin
劳德代尔 | 劳德戴尔 | lauderdale
伯贝奇 | 伯比奇 | burbage
哈斯卢普 | 哈斯勒普 | haslup
科尔尼特 | 科尔内特 | collnette
波洛斯 | 普洛斯 | poulos
伦万多 | 柳安多 | lewando
克莱恩 | 克莱因 | clyne
休林斯 | 赫林斯 | hulings
贝雷 | 贝里 | berrey
弗里岑 | 弗里曾 | fritzen
麦克米切尔 | 麦克迈克尔 | mcmichael
贝尔希 | 贝尔赫 | bailhe
斯科克罗夫特 | 斯考克罗夫特 | scowcroft
麦卡尔 | 麦考尔 | mackal
阿尔曼 | 阿利芒 | allemang
赛奇 | 赛什 | saich
皮奥罗特斯基 | 彼得罗夫斯基 | piotrowski
贾恩 | 扬 | jahn
康加尔顿 | 康高尔顿 | congalton
沙滕克 | 沙滕柯克 | schattenkerk
格林胡特 | 格林赫特 | greenhut
法隆 | 法伦 | falloon
奥斯怀 | 奥斯威尤 | oswiu
兰德威西 | 兰德沃西 | landwirthy
福马尼克 | 福马内克 | formanek
米隆 | 米伦 | millon
艾利 | 艾莉 | eily
埃克恩 | 伊肯 | ekern
菲利恩 | 菲利翁 | filion
赞皮略 | 赞皮耶洛 | zampiello
苏尚 | 舒尚 | shooshan
莫普斯 | 莫皮斯 | moppes
帕塞尔 | 帕斯尔 | parcell
泰博尔特 | 蒂博尔特 | tybalt
索尔 | 苏尔 | soul
门宁 | 门嫩 | mennen
德迪奥 | 戴德奥 | dedeo
麦克雷思 | 麦克勒思 | mackereth
奥瑟 | 奥泽 | orser
帕珀马斯特 | 佩珀马斯特 | papermaster
贝伦德斯 | 贝伦兹 | berendes
杜布尔迪 | 道布尔迪 | doubleday
施雷德 | 施拉德 | schrade
伯克 | 比尔克 | birck
巴托尔森 | 巴托尔松 | bartholdson
英格林 | 英林 | yingling
库普里尔 | 卡普里尔 | cuprill
查努廷 | 查纽廷 | chanutin
埃塞克 | 伊塞克 | esek
梅耶霍弗 | 迈尔霍费尔 | maierhofer
马伦普尔 | 马伦普雷 | malempre
多奇 | 德奇 | doetsch
阿尔顿 | 阿里顿 | arreton
贝哈 | 贝亚 | beha
法尔布伦斯 | 法尔布兰斯 | firebrance
肯尼 | 森尼 | cenni
博尔多 | 波尔多 | bordeaux
德西德里厄斯 | 德西迪里厄斯 | desiderius
塔尔戈特 | 索尔戈特 | thalgott
切克齐安 | 彻克齐安 | cherkezian
马格尼尔 | 马尼耶 | magnier
奥特林希姆 | 奥特林厄姆 | altrincham
埃纳姆 | 埃努姆 | aernum
麦基尔维 | 麦基雷维 | macilrevie
艾肯格琳 | 艾肯格林 | eichengreen
莱夫勒 | 莱弗勒 | leffler
科卡姆 | 科克姆 | corkum
哈夫纳 | 哈文纳 | havenner
格威达斯 | 格威查德斯 | gwychardus
莫布斯比 | 莫布兹比 | mobsby
赛尔斯 | 西尔斯 | cyres
泰夫 | 塔夫 | tave
阿卡杜 | 阿夸约 | aquayo
弗雷林休森 | 弗里林海森 | frelinghuysen
麦克鲁登 | 麦克拉登 | mccrudden
帕杰利斯 | 帕盖利斯 | pargellis
莱珀尔 | 勒普尔 | lepoer
奥尔斯塔特 | 阿尔斯塔特 | alstadt
布雷斯洛夫斯基 | 布雷斯拉夫斯基 | breslawsky
博尼法修斯 | 博尼费修斯 | bonifacius
达夫恩 | 达夫妮 | daphne
麦克莱夫 | 麦克拉夫 | mcclave
麦肯基 | 麦康希 | macconchy
桑德姆 | 桑达姆 | sandham
里穆斯基 | 里莫斯基 | rimouski
马宁 | 曼宁 | maning
布莱胡特 | 布拉胡特 | blachut
赫明 | 亨明 | hemming
蒂文格德姆 | 蒂文加杜姆 | tirvengadum
吉内罗 | 吉尼罗 | genero
比斯特 | 比伊斯特 | buist
拉拉莫尔 | 拉腊莫尔 | laramore
德里南 | 德赖南 | drynan
福韦尔 | 福尔韦尔 | faulwell
哈基 | 黑克 | hake
哈谢根 | 哈舍根 | hashagen
基尔斯 | 赖亚尔斯 | ryalls
特里梅因 | 特里曼 | tremain
梅伦 | 默龙 | merron
安克鲁姆 | 安克拉姆 | ancrum
贝基 | 巴基 | bakey
鲁兹 | 吕埃 | ruez
拉德布罗克 | 拉德布鲁克 | ladbroke
卢伊斯蒂格 | 卢斯蒂格 | luistig
昂斯莱格 | 奥恩斯莱格 | oenslager
哈加丁 | 哈格丁 | hargadine
莱基姆 | 利克希姆 | leikhim
沃特法特 | 沃特沙夫特 | wirtschafter
伊默斯 | 伊穆斯 | imus
托奇 | 托克 | toch
杜万特 | 德温特 | dewenter
彼特菲尔德 | 彼得菲尔德 | peterfield
加瓦尔特 | 加沃尔特 | gawalt
哈雷尔 | 哈勒尔 | harrel
斯普勒 | 施普勒 | spuhler
克雷希尔 | 克雷比尔 | krehbiel
阿马尼 | 阿尔马尼 | armani
弗莱布 | 弗莱比 | flebbe
汤茨 | 图姆斯 | tombs
达夫隆 | 杜弗隆 | duflon
梅罗维奇 | 迈罗维奇 | meirovitch
本恩 | 本 | benn
莫伊西维奇 | 莫伊塞维奇 | moiseiwitsch
梅纳哈姆 | 梅纳汉 | menaham
米尔哈姆 | 米勒姆 | millham
麦基利肯 | 麦基利坎 | mackillican
多里 | 多丽 | dorrie
法诺夫 | 法纳夫 | faneuf
雷德斯克 | 拉德斯克 | radesk
科克拉瑟 | 科尔克拉泽 | colclaser
罗赫 | 罗奇 | roch
多勒 | 多拉夫 | dorough
巴尔尼尔 | 巴尼尔 | balniel
菲林 | 法尔林 | firing
克莱姆 | 克莱米 | klemme
费尔 | 费雷 | ferre
安娜贝尔 | 安娜贝勒 | annabelle
博瓦文 | 博伊文 | boivin
福伊齐 | 福西 | feusi
朱伯格 | 宗伯格 | zumberg
萨加 | 塞格尔 | sagar
恩格兰 | 英格兰 | england
科龙吉 | 科隆吉 | colonghi
西拉森 | 西劳森 | cilawson
艾德斯莫 | 艾兹莫 | eidsmoe
阿布 | 阿贝 | abbe
博瓦斯坦 | 博伊斯方丹 | boisfontaine
麦卡哈蒂 | 麦克哈蒂 | mccahearty
布赖滕菲尔德 | 布赖滕费尔德 | breitenfeld
韦斯特摩兰 | 威斯特摩兰 | westmoreland
伯格哈德 | 伯格哈特 | burghard
埃尔普 | 厄普 | earp
蒙多尔 | 蒙多 | mondor
施赖纳 | 施里纳 | shriner
斯塔布尔德 | 斯塔布菲尔德 | stubblefield
弗皮勒克 | 韦皮勒 | verpilleux
布鲁克特 | 布勒克特 | broekert
迪安蒙特 | 迪亚门特 | diament
汤嫩德 | 汤恩德 | townend
杰庞 | 杰波恩 | jepoen
伯肯霍尔茨 | 伯肯霍尔兹 | birkenholtz
默蒂斯 | 默特斯 | mertes
勒克特 | 勒基特 | luckett
伊德 | 伊德尔 | eader
维诺格拉德 | 维诺格勒 | vinograd
安纳赫尔 | 安纳克莫尔 | annaghmore
斯塔德曼 | 斯蒂德曼 | studeman
勒利恩 | 勒林 | lelean
布里德森 | 布赖森 | bridson
里森 | 里斯滕 | wristen
马达维克 | 马达维赫 | mhadavikh
戈勒布 | 戈卢布 | golub
达拉克 | 杜拉奇 | dullach
肖尔德 | 索尔德 | szold
杜普卡克 | 杜普恰克 | dupcak
布拉登 | 布拉顿 | bradon
贝姆 | 巴姆 | bame
普利马尔 | 普莱梅尔 | plymale
布罗梅特 | 布罗米特 | bromet
皮科瓦克 | 皮乔维亚克 | piechowiak
马利埃 | 马利尔 | mallier
隆巴德 | 伦巴德 | lumbard
惠特伯格 | 惠特伯勒 | whitburgh
贝塞尔 | 贝瑟尔 | bethell
法勒勒 | 法伊勒 | pfeiler
霍莫尔卡 | 霍穆尔卡 | homolka
海斯伯格 | 海斯堡 | heisborg
费尔德布里尔 | 费德布里尔 | feldbrill
杰农 | 热农 | gernon
斯顿特 | 斯坦特 | stunt
伊勒 | 伊尔 | ihle
埃利斯 | 埃莉丝 | elyse
克勒勒 | 克雷勒 | kroehler
切米宁 | 切米宁特 | cheminint
阿尔曼 | 奥尔曼 | alman
克丽扎 | 克里扎 | kryza
赫尔姆霍特 | 赫尔姆霍尔特 | helmholdt
布根 | 巴根 | bugan
施瓦姆 | 施万布 | schwamb
麦克米切尔 | 麦克迈克尔 | macmichael
奥里 | 奥赖 | ory
艾尔弗里克 | 阿尔弗里克 | aelfric
艾尔加 | 艾尔格 | eylgar
耶伊 | 伊 | yee
索南曼 | 索恩曼 | sonnemann
布利斯通 | 布莱斯通 | blystone
奥赞妮 | 奥赞 | ozanne
德汉 | 德哈恩 | dehaan
雷诺 | 雷纳 | raynor
松塔格 | 桑塔格 | sontag
麦克尔汉农 | 麦克尔哈农 | mcelhanon
塔利奥 | 图利奥 | tullio
索利 | 索尔 | sowle
莱威尔 | 勒威尔 | lerwill
福伊齐 | 福伊西 | foisie
麦康 | 梅肯 | macon
德拉丰斯 | 德拉方斯 | delafons
戈希 | 戈伊 | gohey
克莱弗 | 克拉弗 | claver
桑萨姆 | 桑森 | sansum
吉吉 | 吉盖 | giggey
达科姆 | 戴科姆 | dacombe
邦廷 | 邦坦 | bontein
多本 | 多宾 | doben
杰穆特 | 格穆思 | germuth
泰恩什 | 坦什 | tainsh
克雷斯皮尼 | 克雷皮尼 | crespigny
赫梅尔辛 | 休梅尔辛 | humelsine
马夸里 | 麦夸里 | maquarie
比尔基 | 伯基 | buerki
斯沃兹 | 斯沃德什 | swadesh
巴贝尔 | 贝布尔 | babell
博德温 | 博德瓦恩 | bordwine
布朗塔斯 | 布龙塔斯 | brountas
德雷沃尔吉拉 | 德沃尔吉拉 | drevorguilla
奥弗拉海蒂 | 奥弗莱厄蒂 | o'flahertie
塞维 | 西维 | sevey
鲍沃 | 鲍尔 | bouwer
博克尔 | 博克 | boker
麦克罗 | 麦肯罗 | mcenroe
佩雷兹 | 佩雷斯 | perez
蒂利 | 蒂莉 | tillie
赖格 | 里格 | riger
道德 | 多德 | dowd
阿利森 | 艾莉森 | alyson
德雷塞尔 | 德雷斯尔 | dressel
朱利 | 朱莉 | julie
埃德利 | 埃奇利 | edgley
达尼翁 | 达尼恩 | danyon
希克 | 舍克 | shirk
马休伦 | 马胡兰 | mahuran
派耶 | 派尔 | peyer
波兰 | 普兰 | poulain
奇 | 切赫 | czeh
西尔万纳斯 | 西尔维纳斯 | silvanus
埃克斯坦斯 | 埃克斯滕斯 | exstance
艾恩斯 | 安斯 | aines
普萨特里 | 普萨泰里 | pusateri
尼亨 | 奈恩 | nyhen
霍勒修斯 | 霍雷修斯 | horatius
阿格内洛 | 阿涅洛 | agnello
伊莱 | 艾莱 | ilay
内西厄 | 纳休 | nathiew
休达克 | 赫达克 | hudak
塞西利厄斯 | 塞西莉厄斯 | cecilius
纳登 | 内登 | naden
哈姆斯 | 黑姆斯 | hammes
查格尔斯 | 查格利斯 | chagles
加纳吉安 | 加南吉扬 | ganangiyan
古拉德 | 戈拉德 | goulard
格罗杰 | 格罗格 | grogger
怀特莱尔 | 怀特莱瑟 | whiteleather
埃夫勒 | 埃弗勒 | effler
惠策特 | 惠特西特 | whitsett
库兰西克 | 库兰齐克 | kurlantzick
赫德克 | 赫德基 | hedke
勒克龙 | 莱克龙 | leckrone
布雷斯纳安 | 布雷斯纳汉 | bresnahan
波 | 鲍 | pow
拉克歇尔 | 拉克斯尔 | wraxhall
曼柳斯 | 曼利厄斯 | manlius
佩恩 | 佩因 | pain
莱托克 | 勒托克 | letocq
谢拉 | 希拉 | shelagh
内格尔 | 尼格尔 | negel
巴吉特 | 巴杰特 | bardgett
乔弗里翁 | 乔夫里翁 | joffrion
罗克特 | 罗基特 | rockett
伯恩 | 贝尼 | boehne
德沃拉克 | 德沃夏克 | dvorak
福伊弗克 | 福伊尔沃克 | feuerwerker
塔吉 | 塔姬 | taggy
麦科克 | 麦科奇 | mccoch
蒂梅韦尔 | 泰姆韦尔 | timewell
巴克纳 | 巴赫纳 | bachner
图德霍 | 塔杜 | tudhoe
蒂格雷特 | 泰格雷特 | tigrett
纳蒂 | 克努蒂 | knutti
凯嫩 | 凯南 | kainen
德普图克 | 德普塔克 | deptuck
克纳森 | 克努森 | knuthsen
格尔 | 吉尔 | gehl
迪斯特伯格 | 杜斯特伯格 | duesterberg
利德福 | 利德福德 | lydford
默克莱恩 | 默克莱因 | merklein
菲恩 | 费恩 | feane
科奈因 | 科奈恩 | conein
巴尔诺 | 巴诺 | barno
弗里斯 | 弗雷斯 | frece
朗莱因 | 朗莱恩 | longhlein
卡马科 | 卡马乔 | camacho
埃尔斯 | 埃利斯 | elles
德萨拉茨 | 德巴拉茨 | desbarats
卡布尔 | 卡贝尔 | cabell
克兰多尔 | 克兰德尔 | crandall
卡内基 | 卡奈尔尼 | carnearney
霍奇 | 霍根 | hodgan
卡奇亚 | 卡夏 | cachia
莫森 | 莫桑 | morsan
阿杰里斯 | 阿吉里斯 | argeris
明尼特 | 明妮特 | minnette
里哈尔 | 雷哈尔 | rehal
安斯帕彻 | 安斯帕赫尔 | anspacher
贾西诺夫斯基 | 贾西诺斯基 | jasinowski
克雷弗 | 克里弗 | crever
沃尔索夫 | 瓦尔塞奥夫 | waltheof
拉帕诺 | 拉普阿诺 | rapuano
安德雷斯 | 安德烈斯 | andress
埃尔斯皮 | 伊丽莎白 | elspie
哈根 | 黑根 | hagan
维特拉尔 | 维特拉西尔 | vytlacil
麦卡拉克 | 麦柯拉克 | maccurrach
凯特琳萨克 | 卡特林萨克 | katrinsak
托普尔 | 托佩尔 | topple
塔姆斯 | 泰晤士 | thames
斯维克 | 斯韦克 | svec
肯奈尔德 | 肯奈德 | kennaird
勒克拉斯 | 勒克拉 | lecras
斯普雷尔 | 斯普雷耶 | spreyer
艾克纳 | 艾希纳 | eichner
费拉奥 | 费劳 | ferrao
奥弗拉希蒂 | 奥弗莱厄蒂 | o'flaherty
克里恩 | 克林 | crean
萨马罗尤 | 萨马鲁 | samaroo
卡赫特 | 卡彻特 | kachert
皮克 | 珀基 | pyrke
恩布林 | 恩布琳 | emblin
卡尔索普 | 考尔索普 | calthorpe
塞森 | 特森 | thesen
吉尔德豪姆 | 吉尔多姆 | guildhaume
埃夫格 | 埃维尤 | evjue
贾斯珀 | 贾斯帕 | jaspar
威尔科夫斯基 | 维尔科夫斯基 | wilkowski
法尼埃尔 | 法纳尔 | faneuil
雷塔 | 里塔 | rheta
伯尼特 | 伯内特 | burnett
里卡特 | 理查特 | richart
朗尼加 | 朗内加 | runnegar
卡莎 | 卡撒 | cartha
麦克莱恩 | 麦克林 | mcclean
扬格尔 | 扬格 | younger
多尔杰 | 德尔格 | dolger
赫贝斯特雷特 | 赫布斯特雷特 | herbestreit
克拉姆 | 克鲁姆 | krumm
法兹卡斯 | 法泽卡斯 | fazekas
普莱斯顿 | 普利斯顿 | puleston
迪林 | 迪尔林 | deerlin
科森 | 科瑟恩 | cothern
埃尔韦斯 | 埃尔威斯 | elwes
塔弗 | 塔沃尔 | tavor
韦赫 | 韦伊尔 | weiher
维特 | 维特尔 | vetter
赫米恩 | 赫米奥娜 | hermione
斯维尔 | 斯维沃 | svewar
约翰森 | 约翰逊 | johnson
杭德里奇 | 杭德里克 | honderich
劳格林 | 劳克林 | laughlin
利伯丁 | 利伯蒂娜 | libertine
达利佩齐 | 达莱佩泽 | dallepezze
迈尔斯特拉普 | 迈尔斯特勒普 | meilstrup
朗塞莱特斯 | 朗斯利特斯 | launceletus
埃德利 | 埃德尔 | ederle
米德利 | 米奇利 | midgley
科莫尼亚克里克 | 科莫尼亚雷克 | komoniarek
格恩斯巴克 | 根斯巴克 | gernsback
贝塔 | 伯塔 | berta
比尔 | 伯尔 | birr
邓坎森 | 邓肯森 | duncanson
高迪安 | 高迪恩 | gaudian
迪尔 | 代尔 | diel
迪思里克 | 迪特里希 | diethrich
迈斯利克 | 迈斯利奇 | meislich
沃索 | 瓦索 | wasow
霍沃思 | 豪沃思 | howarth
吉尔迪 | 吉亚尔迪 | ghiardi
阿勒姆 | 奥勒姆 | allam
博迪科姆 | 博迪库姆 | bodycombe
施韦尔布 | 施韦布 | schwelb
伊泽诺尔 | 艾泽努尔 | izenour
特里里斯 | 特里赖斯 | trerise
帕尼特 | 帕内特 | panet
平科特 | 平肖 | pinchot
范热 | 范格特 | fanget
伊尔格 | 伊尔克 | ilg
查森 | 蔡森 | chasen
科佩拉 | 科皮拉 | coppela
朱拉布基安 | 朱拉布奇安 | joorabchian
斯拉特里 | 斯莱特里 | slattery
埃尔马思 | 厄马思 | earmarth
希拉克 | 希莱克 | shillaker
梅约 | 梅奥 | mayo
达纳文特 | 杜纳万特 | dunavant
基珀斯 | 凯珀斯 | kuipers
梅恩唐德 | 梅因唐纳德 | maindonald
麦卡勒里 | 麦卡利里 | mcalery
黑兹尔廷 | 黑兹尔坦 | hazeltine
尤卡丽丝塔 | 尤卡里斯塔 | eucharista
迈希尔 | 迈伊尔 | mighill
赫曼 | 希曼 | heman
布罗瑟 | 布拉泽 | brother
金索尔万 | 金索尔文 | kinsolving
辛 | 锡恩 | thynne
弗里斯 | 弗里亚斯 | freas
皮尼 | 派尼 | piney
莱滕德尔 | 勒滕德 | letendre
杰斯 | 杰西 | jesse
莱韦斯丘 | 莱韦斯克 | levesque
奥德里 | 奥德丽 | audrey
约瓦诺维奇 | 约万诺维奇 | yovanovitch
派什什 | 皮尤什 | piyush
丹尼罗 | 达尼罗 | daniero
德赖伯格 | 德赖伯勒 | dryburgh
莱彭内克 | 勒佩内克 | lepennec
津巴尔多 | 津巴多 | zimbardo
多南费尔德 | 多宁费尔德 | donenfeld
沃尔德雷普 | 沃尔德里普 | waldrep
德马西奥 | 德马肖 | demascio
穆科夫斯基 | 穆科斯基 | mukowski
泽谢拉 | 泽克拉 | zechella
卡莉 | 凯莉 | kallie
斯凯特 | 斯卡特 | skate
麦吉尔伍 | 麦吉尔伍尔 | macgillvoor
鲍古尔德 | 布古尔 | bougourd
塞文 | 西文 | sevin
内姆切克 | 内姆泽克 | nemzek
尤曼斯基 | 乌曼斯基 | umansky
斯特克科 | 斯特科 | stecko
欣 | 希恩 | shinn
庞纳佩拉马 | 庞南佩鲁马 | ponnamperuma
米曾 | 迈曾 | mizen
洛梅尔 | 隆梅尔 | lommel
马赫 | 马奇 | much
金尼弗 | 珍妮弗 | gennifer
查萨尼斯 | 沙萨涅 | chassagnes
厄尔利 | 厄利 | earley
奥图托 | 阿尤托 | aiuto
布格鲁德 | 鲍赫鲁德 | boughrood
吉隆 | 吉伦 | gillon
道沃德 | 道尔德 | doward
瓦克 | 瓦克尔 | wacker
路易佐 | 路易祖 | louizou
弗兰兹 | 弗朗兹 | franz
特里福迪迪斯 | 特里福尼迪斯 | trifonidis
米泽尔 | 米泽勒 | mizelle
托雷斯 | 托里斯 | torres
沃利本 | 沃莱本 | wohlleben
普尔特格拉夫 | 法尔茨格拉夫 | pfaltzgraff
沃申科 | 瓦申科 | washenko
博尼特 | 博内特 | bonett
伊利特 | 艾利特 | ilett
多伊希尔 | 多伊施尔 | deuschl
马库斯 | 马库塞 | marcuse
艾尔明杰 | 艾尔明格 | irminger
弗特尔 | 费特尔 | fertel
阿伦 | 艾伦 | allen
乔瑟姆 | 乔撒姆 | jotham
古卡斯 | 古奥卡斯 | guokas
迪特 | 迪泰特 | dittert
费滕 | 法滕 | phaten
菲查尔温 | 菲茨艾尔温 | fitzailwyn
埃迪生 | 埃迪森 | eddison
希金博瑟姆 | 希金博特姆 | higinbotham
登宁 | 丹宁 | denning
马杰 | 马季 | marj
布加斯 | 巴加斯 | bugas
埃奇达尔 | 埃奇代尔 | edgedal
基伊 | 基 | key
林德斯滕 | 林斯滕 | lindsten
本内特 | 贝内特 | bennete
贝罗尔 | 伯罗尔 | berall
凯特伦 | 卡特伦 | catron
斯威特凯 | 斯威凯 | switkay
多本施克 | 多本斯佩克 | daubenspeck
兹扎尔斯基 | 兹巴尔斯基 | zbarskiy
迪克森 | 德克森 | dirksen
贝格尔 | 贝尔 | beighle
肖弗勒 | 肖夫勒 | schauffler
瑟利尔 | 特威利尔 | thuillier
德加拉迪安 | 德加拉贝迪安 | dergarabedian
戈特格雷 | 戈特格特鲁 | gottgetereu
诺撒普顿 | 诺桑普顿 | northampton
布罗厄斯 | 布罗斯 | broas
赫伦布兰德 | 海伦布兰德 | hellenbrand
埃布 | 厄尔布 | erb
格瓦特金 | 格沃特金 | gwatkin
鲍尔丹齐 | 巴尔丹齐 | baldanzi
锡茜 | 锡西 | cissie
莱兰 | 利兰 | lelland
希瓦特罗 | 奇瓦特罗 | chivatero
温泽尔 | 温策尔 | wenzel
杜格 | 杜奇 | dooge
巴蒙特 | 贝蒙特 | bamont
奥德黑泽 | 奥尔迪泽 | aldhizer
纳吉恩 | 纳金 | nagean
姆利纳米克 | 姆利纳奇克 | mlinarchik
道兹韦尔 | 多德斯韦尔 | dowdeswell
德尔 | 杜尔 | durr
米齐 | 梅齐 | meazey
尤特 | 尤思 | uthe
斯廷纳 | 斯蒂纳 | stiner
戴伦富思 | 迪伦弗思 | dhyrenfurth
拉费蒂 | 拉菲蒂 | laffeaty
扬克威奇 | 扬克维奇 | yankwich
赛格尔 | 西格尔 | sigel
萨格曼 | 塞奇曼 | sageman
克奇维尔 | 克切维尔 | kercheville
施韦特德 | 施韦蒂德 | schwetid
德西雷 | 德西蕾 | desiree
凯利 | 丘利 | kewley
乔瑟琳 | 乔斯林 | josselyn
卡德拉 | 夸德拉 | cuadra
休什 | 休伊什 | huish
德波迈耶 | 德波米耶 | depommier
比昂 | 拜昂 | bion
加哈根 | 加黑根 | gahagen
麦金特夫夫 | 麦金塔夫 | mcinturff
莫福德 | 莫维兹 | morfudd
桑克利 | 尚克利 | sankley
罗马因 | 罗曼 | romaine
西马拉 | 赛马拉 | saemala
怀斯坦 | 威斯坦 | wystan
博德瓦恩 | 鲍德温 | bodwine
勒斯 | 卢斯 | luss
鲍科姆 | 鲍库姆 | bawcombe
莱瑟夫 | 勒瑟夫 | lesurf
查林格 | 查林杰 | challenger
塞特 | 撒特 | thaete
西希 | 西赫 | sih
弗兰西娅 | 弗朗西亚 | francia
亨特雷斯 | 亨特里斯 | huntress
图乌丝南 | 蒂乌萨宁 | tiusanen
特里布 | 特赖布 | tribe
金卡尼 | 金凯尼 | kincairney
阿尼尼 | 阿内尼 | aneny
马斯曼 | 穆斯曼 | mussman
沃尔伦德 | 沃尔龙德 | walrond
蒙塔文 | 蒙塔冯 | montavon
萨特奇 | 萨特杰 | satge
贾尼斯 | 贾尼西 | janisse
比基特 | 比克特 | bicket
耶妮 | 耶尼 | yeni
达蒂 | 达西 | duthie
加亨 | 加恩 | gahan
德雷波 | 德拉珀 | drapeau
贾斯卡克斯 | 贾斯帕克斯 | jasparks
梅尔谢默 | 梅尔斯海默 | melsheimer
迪利 | 杜利 | duley
霍奇特 | 霍贾特 | hodgart
特比特 | 特贝特 | tebet
德斯博伊斯 | 德布瓦 | desbois
斯韦布 | 斯韦比 | swaebe
格拉巴尔 | 格拉巴 | grabar
弗鲁伊特 | 弗鲁特 | fruit
伊利恩 | 伊尔伦 | illearn
阿布洛姆 | 阿布隆 | ablom
博尔加塔 | 博加塔 | borgatta
基伦 | 基兰 | kiran
埃斯梅尔 | 伊斯梅尔 | esmail
沃滕伯格 | 瓦滕伯格 | wattenberg
阿迪内 | 阿迪尼特 | adinet
邓科姆 | 邓库姆 | duncombe
吉尔克雷斯特 | 吉尔克里斯特 | gilchrest
迪克 | 迪克尔 | dicker
格鲍尔 | 格巴尔 | geballe
霍耶尔贝克 | 胡尔贝克 | houiellebecq
布希 | 布舍 | busche
卡梅尔福德 | 卡姆尔福德 | camelford
卢金贝尔 | 卢金比尔 | lukingbeal
布吕恩 | 布鲁恩 | bruene
比伊 | 布伊 | buie
埃斯特哈 | 埃斯特海 | esterhai
马尔欣 | 马尔夏恩 | mulshine
米哈拉克 | 迈克拉克 | michalak
伊莱特克拉 | 伊莱克特拉 | electra
查费茨 | 查菲茨 | chafetz
塞米厄斯 | 瑟缪斯 | sermeus
艾克瑟 | 伊克瑟 | ixer
安杰尔斯 | 安杰利斯 | angeles
艾卡恩 | 伊坎 | icahn
罗伊尔 | 鲁埃尔 | reuel
森 | 图恩 | thun
泰瑟 | 特瑟 | tether
海森 | 希森 | hyson
布龙森 | 布朗森 | bronson
沃姆索尔 | 沃姆泽 | wormsor
热诺尔 | 格瑙尔 | genauer
克莱夫 | 克拉夫 | clave
蒙东纳 | 蒙顿纳 | montonna
卡莎 | 卡沙 | kasha
利多姆 | 利德姆 | leedom
马拉布尔 | 梅拉伯 | malabre
埃丝拉 | 埃斯拉 | esra
利希特韦特 | 利希特瓦尔特 | lichtwardt
奥弗罗尔 | 奥费拉尔 | o'ferrall
马琴 | 梅琴 | machen
塔谢罗 | 塔什罗 | taschereau
埃廷杰 | 埃廷格 | ettinger
查蓬 | 沙蓬 | chapone
林迪 | 琳迪 | lynndie
多诺霍尔 | 多诺莫尔 | donoughmore
奇德尔 | 切德尔 | chedell
卡林 | 卡莱恩 | carline
法尔 | 费尔 | fayer
康伯 | 库默 | comber
赫施 | 胡希 | husch
阿克利 | 埃克利 | akeley
尤泽 | 尤伊泽 | ueyser
奥拉 | 奥尔拉 | orla
布朗丁 | 布隆丁 | blondin
卡丹 | 卡登 | kadane
金格莱克 | 金莱克 | kinglake
维拉博洛斯 | 比利亚洛沃斯 | villalobos
迪达姆 | 迪德姆 | deedham
斯特朗伯格 | 斯特龙伯格 | stromberg
格维茨 | 格威茨 | gurwitz
德梅特 | 德梅特尔 | demaitre
斯韦特林 | 斯韦思林 | swaythling
海恩菲尔德 | 汉费尔德 | hainfeld
沃拉 | 瓦拉 | walla
埃尔德赫姆 | 埃尔德姆 | ealdhelm
斯塔内克 | 斯托尔内克 | stalnecker
马格里 | 马格丽 | margery
贝沃尔德 | 贝瓦尔德 | baerwald
盖伊 | 贾伊 | ghey
赖姆斯 | 里姆斯 | rheims
蒙卡姆 | 蒙特卡姆 | montcalm
费罗萨德 | 费罗祖德 | ferozud
普拉格 | 普拉奇 | plugge
基乔 | 凯乔 | kejoa
博斯顿 | 波士顿 | boston
费克特基蒂 | 费克特库蒂 | feketekuty
赫芬 | 赫法恩 | huffine
梅勒韦瑟 | 梅里韦瑟 | mereweather
瑟谢 | 塞希 | sershey
拉克斯里思 | 拉克斯弗里思 | laxfrith
埃诺 | 伊诺 | eno
塞利格曼 | 塞利希曼 | seligmann
加韦德 | 加维德 | gaved
科奇尼希 | 科奇尼格 | kotschnig
斯特雷姆劳 | 斯特里姆劳 | stremlau
德罗姆戈尔 | 德罗姆古尔 | dromgoole
拜尔 | 贝耶尔 | beier
马查利尼斯 | 马查洛尼斯 | marchalonis
塞瓦克 | 瑟瓦奇 | serwach
阿塞林 | 阿斯林 | acelin
阿菲 | 埃菲 | afee
西德博特姆 | 赛德博特姆 | sidebotham
格德 | 格尔德 | gerd
埃克洛夫 | 埃克勒夫 | eklof
博格泰尔 | 博格蒂尔 | boghatyr
芬格勒 | 芬勒 | fengler
埃德弗丽德 | 埃德弗里德 | eadfrid
奥因 | 约恩 | eoin
索 | 托 | thau
图里曼 | 图尔曼 | tureman
法克托 | 法克特 | factor
德西德拉塔 | 德西德蕾塔 | desiderata
朱埃特 | 朱厄特 | jouett
塞格尔 | 西格尔 | seigel
约克威廉斯 | 约克威廉 | yorkwilliams
弗拉利克 | 弗雷利克 | fralick
韦克滕 | 维克滕 | vechten
伦宁 | 伦南 | lennen
罗吉特 | 罗热 | roget
道布 | 多布 | daub
阿伯恩 | 阿本 | abern
伊登 | 艾登 | idden
希格内特 | 希格尼特 | hignett
沙夫斯伯里 | 沙夫茨伯里 | shaftesbury
杜庞 | 杜邦 | dupont
赫尔布尔 | 赫布尔 | helble
比尔布勒 | 比尔伯勒 | bilbrough
斯温托 | 斯温特 | swintor
伦德罗 | 伦德弗罗 | rendfrow
昂布赖特 | 昂布里特 | umbreit
布劳恩 | 布朗 | browne
凯加 | 凯加鲁 | caegarw
胡沃斯 | 休沃斯 | huvos
萨姆斯塔格 | 扎姆斯塔格 | samstag
麦克诺格尔 | 麦克诺尔 | mcnaugher
贾格斯 | 贾格尔斯 | jaggers
格伦巴克 | 格伦巴赫 | grumbach
萨基纳 | 萨金娜 | sakinah
拉夫尚 | 拉夫肖恩 | rafshoon
贝曼 | 比曼 | beman
索弗特 | 索伊弗特 | seufert
斯特里文斯 | 斯特雷文斯 | strevens
斯坦纳姆 | 斯塔纳姆 | stanham
阿克申 | 埃克申 | action
梅因沙因 | 梅恩沙因 | maienschein
加斯丘 | 加斯克 | gasque
齐梅尔曼 | 齐梅曼 | zimmeman
桑兹 | 桑德斯 | sondes
穆普森 | 马普森 | mupson
勒克赫斯特 | 卢克赫斯特 | luckhurst
纳伯斯 | 内伯斯 | nabors
卡罗尔 | 卡萝尔 | carole
埃丁杰 | 埃丁格 | edinger
德维尔 | 德韦尔 | deveulle
麦高兰 | 麦戈兰 | mcgauran
鲍尔达扎 | 巴尔丹扎 | baldanza
马格奈 | 马格内 | magnay
福尔康布里奇 | 福尔肯布里奇 | falconbridge
穆恩 | 穆安 | muan
格林斯特德 | 格林斯蒂德 | grinstead
内奇曼 | 纳奇曼 | nacheman
阿尔文 | 奥尔文 | allvine
林德内斯 | 莱因德尼斯 | rhindness
米多斯 | 梅多斯 | meadows
帕德西 | 帕齐 | pudsey
罗尔夫斯 | 罗卢夫斯 | rolufs
汉德沃 | 汉德沃格 | handwerger
塞尔诺维奇 | 切尔诺维奇 | cernovitch
莱加特 | 莱格特 | legatt
尼科拉迪斯 | 尼古拉迪斯 | nikolaidis
贝特拉 | 伯特拉 | bertera
戈利特利 | 戈莱特利 | golightly
芒尼克森 | 芒尼克海森 | munnikhuysen
奇尔德 | 蔡尔德 | child
贾尔科维茨 | 尤尔科维茨 | jurkowitz
谢 | 舍韦 | schewe
西莫尼什 | 西莫尼奇 | simonitsch
麦坎金 | 麦克琼金 | mcjunkin
高蒂耶 | 高蒂尔 | gauthier
拉贝特 | 拉贝 | rabet
麦克法迪安 | 麦克法迪恩 | mcfadyean
卢内德 | 莉内德 | luned
科克兰 | 科克伦 | cochrane
布扎娜 | 布尔扎纳 | brzana
莫尔霍特 | 莫霍尔特 | molholt
梅佩尔 | 马佩尔 | mapel
塞蒙 | 瑟蒙 | sermon
布兰特里 | 布伦特里 | braintree
钱伯尔辛 | 钱伯辛 | chamberlsin
格青格 | 格青杰 | getsinger
欧维特 | 艾尔薇特 | irvette
德尼奥 | 迪奈欧 | denio
基尔 | 基利 | kille
奥思内尔 | 奥塞内尔 | othenel
马尼奥利亚 | 马格诺利娅 | magnolia
戴西 | 黛西 | daisy
戈迪夫 | 戈德夫 | godefe
克里斯托 | 克里斯戈 | christgau
奥科因 | 奥库安 | aucoin
帕尼思 | 帕内思 | paneth
休尔塔 | 许尔塔 | huerta
彼特罗 | 佩特罗 | petro
诺克伊 | 诺基 | norquoy
马克厄姆 | 梅卡姆 | makeham
斯特拉布里奇 | 斯特劳布里奇 | strawbridge
伯尔纳夫 | 伯纳夫 | bernulf
希肯洛瑟 | 希肯卢珀 | hickenlooper
巴尔塔萨 | 巴尔塔泽 | baltassar
迪克 | 杜凯 | duque
安弗丽德 | 安弗里德 | amfrid
弗利金格 | 弗利金杰 | flickinger
泽比纳 | 泽拜纳 | zebina
布拉夫 | 布劳 | blough
格拉斯戈 | 格拉斯哥 | glasgow
赫钦格 | 赫金杰 | hechinger
哈尼迪 | 哈内迪 | harnedy
斯梅杰 | 斯梅奇 | smaje
奥利文特 | 奥利万特 | ollivant
戈洛夫坎克 | 戈洛夫琴科 | golovchenko
布利肯施塔夫 | 布利肯斯塔夫 | blickenstaff
麦克莱莫尔 | 麦克勒莫尔 | mclemore
麦克费德兰 | 麦克费德伦 | macphedran
奥迪吉尔 | 奥迪吉耶 | audigier
赫蒙 | 哈蒙 | hummon
伯图德 | 伯绍德 | berthoud
阿尔卡尔德 | 阿尔卡德 | alcalde
帕克特 | 帕赫特 | pachter
古比托什 | 古比托西 | gubitoshi
比塔 | 比塔尔 | bitar
麦克斯帕兰 | 麦克斯帕伦 | mcsparran
达尔维奇 | 达利奇 | dulwich
迪卢基奥 | 迪卢乔 | diluchio
格罗塞斯特 | 格罗斯泰特 | grosseteste
施蒂贝林 | 斯蒂贝林 | stiebeling
洛克希尔 | 洛希尔 | lochiel
弗赖尔 | 弗雷耶 | freyere
斯康菲尔德 | 舍恩菲尔德 | schonfield
斯托普尔曼 | 施托尔普曼 | stolpman
弗兰普明 | 弗兰普申 | framption
博雷特 | 博里特 | borrett
米克尔约恩 | 米克尔约翰 | meiklejohn
菲切姆 | 费克姆 | feachem
拉卡钱涅 | 拉康帕涅 | lacampagne
索维奇 | 索瓦热 | sauvage
普劳富特 | 普劳德富特 | proudfoot
赫曼 | 赫尔曼 | herman
科帕德 | 科珀德 | coppard
埃尔齐 | 埃尔扎伊 | elzay
韦格索 | 维格索 | vegso
巴思 | 巴特 | barthe
埃斯科菲 | 伊斯科菲 | escoffey
吉利亚姆 | 吉列姆 | gilliam
皮勒 | 皮埃尔 | pierre
博施威茨 | 博希威茨 | boschwitz
哈德格里 | 哈迪格里 | hardegree
皮尔 | 珀尔 | pearl
维拉雷尔 | 维拉里尔 | villarreal
伊格莱维奇 | 伊格尔维奇 | iglewicz
洛西安 | 洛西恩 | lowthian
多姆安 | 多米扬 | domjan
阿利斯 | 阿莱斯 | allies
海泽 | 哈伊泽 | huyser
科米杰 | 康马杰 | commager
卡拉佩蒂安 | 卡拉佩琴 | carapetyan
布里宁 | 布赖宁 | bryning
格利多尔 | 格利德尔 | gleadall
麦克琴 | 麦克钦 | mccheane
克拉布里 | 克拉布特里 | crabtree
特洛 | 特略 | tello
托尔梅奇 | 塔尔梅奇 | tallmadge
威克斯蒂德 | 威克斯第德 | wicksteed
维斯洛斯基 | 维斯克洛斯基 | visclosky
斯科格伦 | 斯科格隆 | skoglund
温塔尔 | 温特尔 | weintal
贾夫 | 贾菲 | jaffe
斯塔姆 | 施塔姆 | stamm
普朗 | 弗朗 | pfrang
法扎 | 法扎尔 | fazar
萨西妮 | 萨西尼 | sassienie
马塞尔 | 玛塞勒 | marcelle
尤因斯 | 尤温斯 | uwins
切切尔斯基 | 切赫尔斯基 | cehelsky
尤列维奇 | 乌莱维奇 | ulevich
达尔斯特龙 | 达尔斯特伦 | dahlstrom
康尼利 | 康奈利 | conneally
马顿 | 梅顿 | maton
夏拉 | 夏伊拉 | shyla
比恩 | 比汉 | beehan
法尔肯海姆 | 福尔肯海姆 | falkenheim
利西摩尔 | 利西莫尔 | lissimore
德拉夫施泰特 | 德拉格施泰特 | dragstedt
洛恩 | 洛温 | lowen
德弗勒 | 德夫勒 | doerfler
彻尔尼 | 彻尼 | tscherny
伊利希 | 伊利格 | illig
贝默赛德 | 比默赛德 | bemersyde
米姆诺 | 明诺 | mimno
布平达 | 布平达尔 | bhupindar
罗明 | 罗梅因 | romeyn
扬斯巴德 | 扬哈斯本 | younghusband
沙皮 | 沙比 | sharpey
莱西奇 | 勒萨热 | lesage
杰普萨 | 杰普撒 | jeptha
巴布利斯 | 布勃利斯 | bublys
伯特霍尔夫 | 伯索夫 | bertholf
塞迪亚 | 切迪亚 | ceddia
舒特勒夫 | 舒特莱夫 | shurtleff
斯波特德 | 斯波蒂德 | spotted
乔齐 | 乔茜 | jozy
利伯恩 | 莱伯恩 | laybourne
迪安 | 戴安 | dian
马奥恩 | 马洪 | mahone
劳克夫 | 劳卡夫 | laukhuff
米尔希 | 米尔海 | milhy
卡德根 | 卡杜根 | cadwgan
博希尔 | 博舍尔 | boshier
斯克里伯 | 斯克赖伯 | scriber
博维 | 博韦 | bovee
赫克顿 | 赫克通 | hektoen
莱维 | 利瓦伊 | levi
查斯 | 蔡斯 | chayes
克里 | 克雷 | crea
乔尔万 | 朱尔万 | joulwan
卡佐克里亚 | 库佐克雷亚 | cuzzocrea
克拉茨 | 克卢茨 | clutz
阿德基森 | 阿基森 | adkisson
施莱 | 施利 | schlie
伊菲根 | 伊菲吉妮 | iphigene
塞金格 | 塞金杰 | seckinger
泽费雷利 | 泽菲雷利 | zeffirelli
泰菲恩 | 泰维恩 | teifion
亚历克西斯 | 亚历克西丝 | alexys
本贾明 | 本杰明 | benjamin
拉罗姆 | 拉勒姆 | larom
坎帕因 | 坎佩恩 | campaigne
格策韦勒 | 古茨维勒 | gutzwiller
斯特芬斯 | 斯蒂芬斯 | steffens
勒金 | 勒德金 | ludgin
雷伊 | 雷 | rhae
阿尔皮娜 | 阿尔皮纳 | alpina
韦雷尔 | 沃雷尔 | werrell
福尔兹 | 福尔茨 | folz
德福德 | 德福特 | deford
博比萨德 | 博比苏德 | bobisud
图尔 | 特尔 | tourle
图利特 | 塔利特 | tulett
斯塔克 | 斯图克 | stucke
肖伯格 | 舍恩伯格 | schonberger
兰贝利特 | 兰伯利特 | lambelet
孔施尼克 | 康施尼克 | konschnik
盖伊 | 贾伊 | gye
利希滕斯坦 | 利克滕斯坦 | liechtenstein
安德鲁塞维奇 | 安德鲁斯克维奇 | andruskevich
托德里亚斯 | 托德雷亚斯 | todreas
泰林厄姆 | 蒂林厄姆 | tyringham
比尤 | 布埃 | bue
阿维斯 | 阿维丝 | aveis
黑吉斯 | 海吉斯 | haigis
阿伦 | 阿龙 | aaron
马尔克斯 | 马尔库斯 | malkus
宰昂 | 蔡恩 | zion
格尔巴赫 | 盖尔博 | gelbach
布雷克兰 | 布里克兰 | brekland
布卡拉 | 布阿哈拉 | buachalla
沃尔克 | 沃克 | walke
考特尼 | 考特妮 | kourtney
库尔 | 屈尔 | kuehl
麦克雷迪 | 麦克拉迪 | mccrady
比利尔 | 比埃 | billiere
埃尔杰 | 埃尔格 | elger
曼恩 | 曼 | mann
厄尔里克 | 乌尔里克 | ullrich
埃尔坎 | 埃尔肯 | elkan
普钦斯基 | 普辛斯基 | pucinski
尼古利 | 尼古拉 | nicolay
弗雷塔格 | 弗赖塔格 | freytag
撒尔肯 | 萨尔肯 | thalken
基米特 | 金米特 | kimmitt
克罗斯芒 | 克罗斯蒙 | croasmun
乔登斯 | 乔丹斯 | jordans
赖津 | 里津 | ryzin
库德韦尔 | 库尔德韦尔 | couldwell
索莱兹 | 索莱 | saulez
斯坦西克 | 斯坦奇克 | stanczyk
保林 | 波林 | paulin
巴塞尔缪 | 巴托洛缪 | bartholemeu
柯克 | 瑟克 | cirker
恩德科特 | 恩迪科特 | endecott
阿尔文 | 阿尔温 | alwin
拉索姆 | 莱瑟姆 | lathom
霍伊塞尔 | 休塞尔 | heusel
莱弗勒 | 莱弗拉尔 | leflar
罗萨佩普 | 罗萨皮普 | rosapepe
赫宁伯格 | 赫宁堡 | heningburg
巴萨德 | 巴萨德雷 | basadre
福伊耶谢格 | 福伊尔齐格 | feuerzeig
梅卢普斯 | 梅拉普斯 | mellups
马拉赫 | 马拉克 | malach
巴尔西格 | 巴尔西杰 | balsiger
希拉伯 | 希莱伯 | shillaber
布兰达斯 | 布兰德法斯 | brandfas
休马森 | 赫马森 | humason
斯特夫斯 | 斯特弗斯 | steffes
吉尔鲍德 | 吉尔博 | guillebaud
贝切特 | 贝谢 | bechet
梅利奥 | 梅莉奥尔 | melior
鲁马塞特 | 罗马塞特 | roumasset
克尔奇弗 | 克切弗 | kerchever
比阿特里夏 | 比阿特丽西娅 | beatricia
梅努因 | 梅纽因 | menuhin
赫米斯 | 赫姆斯 | hemmes
伊萨科 | 伊萨科夫 | isakow
兹沃 | 兹瓦尔 | zwar
克伦西克 | 赫伦奇克 | chrencik
尼莎 | 尼萨 | neysa
彭沃尔特 | 佩恩沃尔特 | pennwalt
库塞维茨基 | 科乌谢维茨基 | koussevitzky
伊尔图德 | 伊尔蒂德 | illtud
弗罗伊斯 | 弗勒泽 | froese
阿什利 | 阿什莉 | ashleigh
弗拉赫蒂 | 弗莱厄蒂 | flaherty
戈特瓦尔斯 | 戈特沃尔斯 | gotwals
诺克斯 | 努克斯 | nokes
恰鲁奇 | 基亚鲁奇 | chiarucci
图默 | 瑟默 | thuermer
汉奇 | 汉格 | hange
贝特鲁普 | 贝格特鲁普 | begtrup
乌利克 | 尤利克 | ulick
安贝达卡 | 安贝德卡 | ambedkar
达克瑙伊 | 迪克努瓦 | duquenoy
托里乔斯 | 托里霍斯 | torrijos
柯彻 | 基尔舍 | kircher
斯托尔本巴赫 | 斯托曾巴赫 | stolzenbach
柯蒂斯 | 柯蒂兹 | curtiz
马德丽德 | 马德里 | madrid
唐恩 | 唐 | donn
凯特尔比 | 基特尔比 | ketelbey
怀甘特 | 威甘特 | wygant
博弗里 | 博韦里 | boverie
阿姆休茨 | 阿姆谢维茨 | amshewitz
奥法雷尔 | 奥法雷 | o'farrell
特金 | 图尔金 | turkin
西里 | 蒂里 | thierry
阿斯芬 | 阿斯普登 | aspden
乔西 | 约瑟 | josee
施赖伯 | 施里伯 | shriber
迈斯兰 | 迈斯拉恩 | meislahn
森塞尼克 | 森塞尼奇 | sensenich
塞克肖尔 | 塞克索尔 | sexauer
高因 | 高英 | gowing
本尼 | 贝恩 | benne
科斯 | 库斯 | coes
舍内曼 | 舍尼曼 | schoeneman
韦尼斯 | 维内斯 | veness
穆斯 | 缪斯 | muse
霍里克斯罗克 | 哈维克斯布罗克 | hawixbrock
冈齐利 | 贡希利 | goonhilly
亚伯格 | 亚伯勒 | yarburgh
霍尔蒂格纳 | 霍尔蒂万格 | haltiwanger
萨克斯 | 萨克斯比 | saxbe
哈里尔 | 哈丽尔 | harriel
塞塞尔 | 塞斯尔 | sessel
尼纳基斯 | 尼奥纳基斯 | nionakis
西厄尔 | 休厄尔 | sewall
霍金森 | 霍奇金森 | hodgkinson
克利兰 | 克莱兰 | cleland
阿尔西芬 | 阿尔西弗龙 | alciphron
达纳根 | 杜纳根 | dunagan
肖克 | 吉奥克 | giauque
埃尼德 | 伊妮德 | enid
萨金特 | 瑟金特 | searjeant
拉金 | 莱金 | laging
莫尼尔 | 莫内尔 | monell
尚伯格 | 舍恩伯格 | schonberg
米茨费夫 | 米采夫 | mitseff
范格 | 范杰 | fanger
布兰钱 | 布兰昌 | blanchan
霍尔戴曼德 | 哈尔迪曼德 | haldimand
吉廉斯 | 吉利亚姆 | guilliams
多奇 | 道奇 | dodge
梅利亚 | 米利亚 | melia
斯威恩 | 斯温 | sween
弗赖赖克 | 弗赖雷克 | freireich
戈梅斯帕拉特 | 戈梅斯普拉塔 | gomezplata
布尔乔伊斯 | 布儒瓦 | bourgeois
安东尼奥 | 安东尼乌 | antoniou
罗伊巴尔 | 罗伊鲍尔 | roybal
布休夫 | 布舒夫 | bushueff
萨吉里厄斯 | 萨吉泰里厄斯 | sagittarius
比克 | 贝克 | beek
福斯 | 富斯 | fuoss
特怀德尔 | 特威德尔 | twidell
雷诺埃 | 伦瓦尔 | renouard
希拉斯 | 希勒斯 | heelas
考尔克拉夫 | 考尔德克拉夫 | caldcleugh
克拉格 | 克莱格 | clague
杰西娜 | 杰西纳 | jacyna
切希尔 | 切斯希尔 | chesshyre
布雷钦 | 布里金 | brechin
古德勒姆 | 古德哈姆 | gooderham
耶格 | 耶格尔 | yager
鲍尔恩 | 鲍恩 | balne
赫普 | 霍伊普 | heup
希曼娜 | 希曼纳 | sheemanna
阿德钱尼奇 | 阿德查尼克 | ardcharnich
贝迪利恩 | 贝迪利翁 | bedillion
里道特 | 赖德奥特 | rideout
麦考斯兰 | 麦考斯伦 | mcauslan
尼思代尔 | 尼斯代尔 | nithsdale
皮得罗斯 | 皮特罗斯 | peatross
布卢顿 | 布勒顿 | blurton
马托奥 | 马泰奥 | matteo
多罗西 | 多萝西 | dorothy
斯塔宾 | 斯图宾 | stubbing
索洛梅斯 | 索尔特斯 | solotesz
布姆斯特德 | 巴姆斯特德 | bumstead
坦普拉 | 坦普勒 | templar
伦 | 莱恩 | len
德马斯托 | 德马尔托 | desmarteau
迪伯斯坦 | 杜伯斯坦 | duberstein
戴维斯 | 戴维兹 | davids
谢尔普 | 谢普 | shairp
伯泽尔 | 伯塞尔 | birdsell
克洛德纳 | 科洛德纳 | kolodner
普雷彻 | 普里彻 | preacher
索恩代克 | 桑代克 | thorndike
马沙姆 | 马香 | marsham
奥伯尔曼 | 奥伯黑尔曼 | oberhelman
帕特里亚克 | 佩特里亚克 | patriach
莱斯 | 莱什 | leisz
里查兹 | 理查兹 | richards
艾奇森 | 艾奇逊 | eytchison
布里安特 | 布赖恩特 | briant
科尔菲亚托 | 科菲亚托 | corfiato
丹罗瑟 | 丹罗伊特 | dannreuther
法斯尔 | 法塞尔 | fascell
巴恩比 | 巴恩贝 | barnebey
梅林达 | 梅琳达 | melinda
弗伦泽 | 弗伦策 | frenzer
孔西尔 | 康斯尔 | council
沙因鲍姆 | 欣鲍姆 | sheinbaum
尚顿 | 桑顿 | szanton
沃拉尼厄斯 | 瓦拉尼厄斯 | waranius
赫马尼克 | 赫马纽克 | hermaniuk
维思 | 韦思 | vaeth
拉齐 | 拉津 | razeen
埃尔万 | 埃尔温 | elwane
古夫 | 高夫 | gough
巴塔格尔 | 巴塔杰尔 | battagel
厄尔克 | 埃厄克 | earwaker
格林达尔 | 格林德尔 | grindal
塞弗林豪斯 | 塞夫林豪斯 | sevringhaus
雅科蒂特 | 贾科泰 | jacottet
富西洛 | 富奇洛 | fuccillo
布里利 | 布里厄利 | brealey
麦科康奈格 | 麦科尚奈格 | maco'shannaig
麦克廷格 | 马赫廷格 | machtinger
内内曼 | 南尼曼 | nenneman
赫巴尔德 | 赫博尔德 | hebald
康杰 | 康格 | conger
克尼格 | 凯尼格 | koernig
卡塞尔 | 卡瑟尔 | cuthell
迪威斯 | 德威斯 | dewees
基茨哈伯 | 基察伯 | kitzhaber
布雷齐尔 | 布雷热 | brazier
芬尼 | 菲尼 | phinney
奥尔迪 | 阿尔迪 | alday
阿曼德斯 | 阿曼达斯 | amandus
西纳 | 西纳尔 | synar
康奇拉尔 | 康科勒 | concholar
杜纳利 | 达纳利 | dunalley
舒勒 | 朔伊勒 | scheuler
特鲁曼 | 杜鲁门 | truman
惠伦 | 惠兰 | whelan
达奇 | 达基 | dachi
迪奥 | 德奥 | deo
拉思 | 雷思 | rathe
鲁特 | 鲁尔特 | rurt
赫利 | 赫尔利 | hurleigh
斯通纳 | 斯托纳 | stoner
克罗嫩贝格 | 克罗嫩伯格 | kronenberg
克里奇顿 | 克赖顿 | crichton
格威内德 | 格威内思 | gwynedd
伍梅尔多夫 | 沃梅尔多夫 | womeldorph
奎勒 | 凯勒 | cuyler
布奇 | 布谢 | bouchey
罗雷姆 | 罗勒姆 | rorem
沃蒂埃 | 沃捷 | vautier
安德里奥 | 安德里厄 | andrieux
阿莱恩 | 阿林 | alleine
贝克 | 贝克尔 | becker
怀索基 | 维索茨基 | wysocki
比弗 | 贝弗 | bever
斯莫尔佩斯 | 斯莫尔皮斯 | smallpeice
诺伦 | 诺伦德 | norlund
唐西娅 | 唐西亚 | donsia
达克罗 | 迪克罗 | ducrow
沃尔克 | 沃克 | walk
沃尔克 | 沃克 | walker
斯坦达洛夫特 | 斯坦德洛夫特 | standaloft
埃克伦茨 | 厄克伦茨 | ercklentz
德沃查克 | 德沃夏克 | dvorchak
埃尔库斯 | 埃尔克斯 | elkus
科赫兰 | 库格伦 | coughran
多克特 | 多克托 | docktor
弗朗斯 | 弗朗西斯 | fraunces
卢尔 | 勒尔 | lull
希尔茨 | 希尔兹 | shields
菲内尔 | 芬内尔 | feennell
皮克普 | 皮卡普 | pickup
塞门扎 | 西门扎 | semenza
沃尔拉特 | 沃尔拉思 | walrath
阿夫雷特 | 阿夫里特 | avrett
彼得龙 | 佩特龙 | petrone
科克斯 | 考克斯 | coxe
格里桑蒂 | 格里桑迪 | grisanti
梅尔斯 | 马雷斯 | mares
阿奈林 | 阿内林 | aneirin
施温德曼 | 施文德曼 | schwendeman
冈利 | 高恩利 | gownley
阿图鲁斯 | 阿图罗斯 | arturous
拉丽比 | 拉勒比 | larabee
埃斯卡达尼安 | 伊斯坎达里安 | eskandarian
霍金 | 霍奇金 | hodgkin
贾洛雷齐 | 贾洛伦齐 | giallorenzi
盖格 | 盖杰 | gager
特穆多 | 塞穆多 | themudo
科尔奎特 | 科尔基特 | colquitt
贝松 | 贝森 | bessone
塞科夫斯基 | 赛科夫斯基 | saikowski
塞格雷夫 | 西格雷夫 | segrave
休伊代尔 | 舍代尔 | suirdale
哈莫尔 | 哈默 | hamor
博索思沃思 | 博索姆沃思 | bosomworth
普普 | 普珀 | puppe
施米德 | 施密德 | schmid
哈尔 | 海尔 | haire
哈克威尔 | 黑克威尔 | hakewill
冈萨莱斯 | 冈萨雷斯 | gonzalez
格兰 | 格兰妮 | grainne
兹韦德林 | 兹沃德林 | zwerdling
库米什 | 卡米什 | cumish
麦克斯托芬 | 麦克斯蒂奥芬 | macstiofain
亚里莫维奇 | 雅里莫维奇 | yarymovych
登尼斯顿 | 丹尼斯顿 | denniston
塞尼奥尔 | 西尼尔 | senior
哈特赛德 | 哈齐德 | hartsid
博伊斯拉根 | 博勒根 | boisragon
雷伯特 | 雷巴特 | rebut
梅特罗普尔斯 | 梅特罗波利斯 | metropolis
索热 | 索热尔 | saussure
费里比 | 费尔比 | ferebee
兰塔克 | 兰加托克 | llangattock
科克森 | 考克森 | coxon
斯克拉塔托 | 斯克鲁泰特 | scrutator
格里泽 | 格赖泽 | griser
贝拉尼娅 | 贝拉尼亚 | berania
戈德森 | 戈德西蒙 | goldsymon
利宁 | 莱宁 | leining
许尔霍尔兹 | 许霍尔茨 | schuerholz
威克泽 | 威克瑟 | wichser
科尔希普 | 科尔黑普 | kohlhepp
赫纳亨 | 赫纳汉 | henahan
杰里什 | 格里什 | gerrish
鲁奥科 | 罗科 | ruocco
加诺尔 | 加诺 | ganor
鲍尔迪施韦勒 | 巴尔德施维勒 | baldeschwieler
斯洛尼姆 | 斯洛宁 | slonim
马莎 | 玛莎 | martha
卡斯特莱恩 | 卡斯特兰 | castellain
珀塞克 | 佩塞克 | perseck
维伦 | 瓦伊伦 | viron
索尔茨 | 肖尔茨 | soults
乔西亚斯 | 乔赛亚斯 | josias
埃夫达德 | 埃瓦德 | evvard
格罗尔德 | 杰罗尔德 | gerould
杰尔 | 耶格 | jaegher
赫雷肖夫 | 赫雷斯霍夫 | herreshoff
加弗 | 盖弗 | gaver
瑟金 | 西尔金 | sirkin
麦克马廷 | 麦克马丁 | macmartin
柯兰 | 柯伦 | curran
瓦伦比拉 | 巴伦苏埃拉 | valenzuela
肖尔斯 | 肖沃斯 | showers
阿格杜 | 阿古 | agwu
弗卢克斯 | 弗勒克斯 | flux
考斯利 | 库斯利 | cousley
亚达南 | 阿达姆南 | adamnan
林恩 | 林 | linn
里查德 | 理查德 | richard
罗伯森 | 罗伯逊 | robertson
吉查姆 | 吉彻姆 | gitsham
普波 | 波波 | poepoe
利沃亚克 | 莱夫奥克 | liveoak
普鲁斯曼 | 普拉斯曼 | prusman
基弗 | 凯弗 | keifer
吉安 | 吉亨 | gehan
施努克尼 | 施努克内 | schnukne
温纳斯特伦 | 温纳斯特鲁姆 | wennerstrum
利德克 | 利迪克 | luedecke
乔德 | 乔德尔 | jordre
普卢内克 | 普伦尼克 | pluenneke
赫希特里特 | 赫什特里特 | hirschtritt
贝拉德 | 贝拉尔 | berard
马尔文农 | 马尔韦农 | mulvenon
皮珀 | 派珀 | piper
豪瑟姆 | 豪萨姆 | howsam
科菲恩 | 科芬 | coffeen
德沃尔金 | 德沃金 | dworkin
阿特尔西 | 阿特莱西 | attlesey
加格尼宾 | 加涅班 | gagnebin
阿克雷斯 | 阿克斯 | acres
布莱克施米特 | 布莱希施米特 | blechschmidt
赫维茨 | 赫威茨 | herwitz
克兰德 | 克兰 | kland
德雷斯克 | 德赖斯克 | dreiske
普赖尔 | 普里尔 | preil
比勒姆 | 比鲁姆 | biroum
贝思 | 贝丝 | beth
比霍尔特 | 伯霍尔特 | byrholdt
约赫 | 约埃 | yohe
恩杰 | 恩弗 | engfer
亚特龙 | 亚特隆 | yatron
斯凯姆 | 斯基姆 | skym
格瓦尔托斯基 | 格瓦尔托夫斯基 | gewartowski
布思利 | 布思莱 | buthlay
安杰莉娜 | 安杰利娜 | angelina
盖切特 | 加切特 | gatschet
鲁阿塔 | 里乌塔 | riutta
普伦蒂 | 普朗蒂 | prunty
吉林 | 格林 | girling
奥洛克林 | 奥劳克林 | o'laughlin
梅约拉斯 | 马约拉斯 | mayoras
伊弗利 | 伊夫利 | evelegh
韦西 | 维齐 | veysey
施塔尔 | 斯塔尔 | stahl
沃尔斯特纳夫特 | 沃斯通克拉夫特 | wollstonecraft
法夫罗特 | 法夫罗 | favrot
阿曼 | 阿尔曼 | arman
阿米欧 | 阿米奥特 | amiot
阿德尼 | 埃德尼 | adney
莫莱诺尔 | 莫勒瑙尔 | mollenauer
斯凯尔斯 | 斯基尔斯 | skiles
芬维西 | 芬韦西 | fenvessy
帕奇 | 帕克 | pach
吉尔德 | 格尔德 | gelder
贝尔基 | 贝尔克 | behlke
于里安 | 尤里安 | urien
萨森 | 萨瑟恩 | southern
巴查尔 | 巴卡尔 | bachar
奥尔博 | 阿尔博 | allbaugh
盖梅特 | 加梅特 | gamet
雷蒂 | 雷图 | rettew
德利吉戈斯 | 德利乔治斯 | deligiorgis
加雷尔 | 加勒尔 | garel
奥尔 | 奥利 | ole
巴德温 | 布德温 | budwine
迪奥 | 戴奥 | dio
哈巴赫 | 哈巴克 | harbach
莱维 | 利维 | levie
格龙基 | 格朗茨基 | groncki
加康 | 加肯 | garcon
米德拉尔斯基 | 米德拉斯基 | midlarsky
戴姆里希 | 德姆里克 | daemmrich
肖尔德勒 | 斯科德勒 | scholderer
迪比 | 达比 | duby
贝尔比 | 比尔比 | beilby
博斯金德 | 博斯坎德 | boskind
瑟弗 | 瑟维耶 | surveyer
阿尼斯 | 安妮斯 | anis
阿布林 | 埃布林 | ablin
班德 | 班德尔 | bander
罗萨尔 | 罗塞尔 | rossall
谢德 | 沙德 | shad
埃奇逊 | 艾奇逊 | etcheson
福塞特 | 福西特 | fawssett
奥莱夫 | 奥拉夫 | olave
莫菲 | 莫夫 | maufe
阿蒂亚 | 阿提耶 | atiyeh
伦芬特 | 朗方 | lenfant
厄夫罗辛 | 尤弗罗西尼 | euphrosyne
里奥赫 | 里奥克 | reoch
艾亚拉 | 阿亚拉 | ayala
皮特里兹 | 佩特里迪斯 | petrides
科德尔 | 科德 | corder
戴文 | 达文 | davern
罗赞妮 | 罗珊 | rozanne
格莱穆尔 | 格利穆尔 | glymour
戈歇尔 | 戈查尔 | gotshal
埃利纳 | 埃琳娜 | elena
杜 | 杜韦 | duwe
布雷德 | 布里德 | breder
麦加恩 | 麦加亨 | mcgahern
利班 | 莱班 | leban
穆拉尔特 | 缪拉尔持 | muralt
萨洛梅 | 萨洛米 | salome
利克曼 | 莱克曼 | likeman
玛丽萨 | 马里萨 | marisa
沙帕 | 沙帕尔 | shapar
尤金尼亚 | 尤金妮亚 | eugenia
梅德沃夫斯基 | 梅德瓦多夫斯基 | medwadowski
希厄特 | 海厄特 | hieatt
科德尔 | 科格德尔 | cogdell
特里布瓦瑟 | 特里布沃瑟 | triebwasser
惠奇利夫 | 惠特克利夫 | whitchliffe
卡利斯尔 | 卡莱尔 | carlisle
怀森 | 威森 | wison
德彻特 | 德克特 | dechert
德弗尼 | 迪夫尼 | deveney
海姆索特 | 海姆塞特 | heimsoth
盖斯特菲尔德 | 盖斯特费尔德 | geistfeld
塔利亚里罗 | 托利弗 | taliaferro
莱塞特 | 莱西特 | lycett
莱贡 | 利根 | lygon
奥利克西 | 奥莱克休 | oleksiw
阿莱兹 | 阿莱 | allez
萨尔温 | 西尔温 | sulwen
威德尔 | 韦德尔 | weddle
法迪安 | 法迪恩 | fadyean
伯克隆 | 伯克伦 | berklund
拜萨特 | 比萨特 | bisat
德雷南 | 德雷宁 | drennen
德彻 | 德谢尔 | decher
皮尔特尼 | 普尔特尼 | pulteney
特鲁齐 | 特拉齐 | truzzi
阿布迪安 | 阿布迪恩 | abdian
蒙特梅罗诺 | 蒙特莫雷诺 | montemoreno
托里 | 托丽 | tori
卡里洛 | 卡里略 | carrillo
比比 | 毕比 | beeby
马塞娜 | 马塞纳 | marthena
盖内森 | 吉尼森 | genesen
凯利 | 卡利 | cali
波兰 | 波伦 | pollan
