布雷金里奇 | 布雷肯里奇 | breckinridge
锡德 | 切德 | cedd
黑根森 | 哈根森 | haagensen
玛莉 | 马利 | maly
阿尔西尼加 | 阿西涅加 | arciniega
法莱恩 | 法兰 | farlane
西恩 | 西根 | seaghan
斯特拉瑟恩 | 斯特拉森 | strathearn
派珀特 | 佩珀特 | peipert
皮内 | 皮奈 | pinay
梅雷斯曼 | 米尔斯曼 | meresman
弗兰宗 | 弗兰曾 | franzon
伊兹比基 | 伊兹比茨基 | izbicky
埃凯奎斯特 | 埃沙韦斯特 | echaveste
费尔班恩 | 费尔贝恩 | fairbairn
舒普 | 肖普 | shoupp
普恩 | 普汉 | puhan
芒斯巴克 | 蒙斯巴克 | maunsbach
沃塞尔 | 瓦塞尔 | wassell
麦卡加 | 麦卡格 | mccargar
瑟金特 | 萨金特 | seargent
亨巴克 | 亨巴赫 | heimbach
基布勒 | 库布勒 | kuebler
纳尔迪 | 纳迪 | nardi
杰米马 | 杰迈玛 | jemima
莫杜伊特 | 莫德维 | mauduit
惠塔克 | 惠特克 | whitacre
耶特 | 艾厄特 | eyet
耶尔德利 | 亚德利 | yeardley
博比 | 鲍比 | bobbie
麦基尔文纳 | 麦基尔温纳 | macilvenna
赖因斯 | 赖恩斯 | rines
埃德尔霍赫 | 埃德尔霍克 | edelhoch
博萨尔 | 博索尔 | botsal
科勒恩 | 科尔雷因 | coleraine
科克拉姆 | 科克勒姆 | cockrum
瓦格尼 | 韦恩 | wagne
登特曼 | 多伊特曼 | deutermann
厄德曼 | 厄尔德曼 | erdman
戈伦比夫斯基 | 戈伦别夫斯基 | golembiewski
卡尔迪 | 恰尔迪 | ciardi
格雷戈埃尔 | 格雷瓜尔 | gregoire
米卡哈 | 迈凯亚 | micajah
佐格 | 索格 | sorg
科梅索罗夫 | 科梅萨罗夫 | komesaroff
罗因 | 雷温 | raewyn
雷马克斯 | 拉马克斯 | raemakers
皮凯弗 | 皮卡弗 | piccaver
苏布林 | 萨布林 | subrin
斯克拉顿 | 斯克鲁顿 | scrutton
塔德勒 | 坦德勒 | tandler
津嫩 | 津宁 | zinnen
布杰兹 | 布尔盖兹 | bourgaize
佩莱蒂埃 | 佩尔蒂埃 | pelletier
帕塞尔 | 帕斯尔 | parcel
霍诺里 | 霍诺丽 | honori
艾梅施 | 伊梅施 | imesch
埃尔顿蒂德 | 埃尔顿黑德 | eltonhead
西明顿 | 赛明顿 | symington
利戈 | 莱戈 | lygo
布龙海姆 | 布朗海姆 | bronheim
马霍 | 玛奥 | mahault
法克 | 菲克 | fike
奥德斯 | 奥杜斯 | audus
沃伊奇克 | 沃伊蒂奇 | woytych
韦赫特尔 | 瓦赫特尔 | wachtel
塔利亚雷罗 | 塔利亚费罗 | tagliaferro
马基南 | 马基嫩 | makinen
拉切斯 | 拉雪兹 | lachaise
格肯斯 | 格尔肯斯 | gehrkens
达维格多 | 达维多尔 | d'avigdor
福尔尼 | 福尼 | fournie
玛吉 | 马吉 | magi
哈巴德 | 哈伯德 | hubbard
曼纳韦 | 马纳韦 | mannaway
伊伊德 | 伊佐德 | izod
图伊马 | 托伊马 | teuma
乌夫 | 奥 | ough
吉杰 | 吉格 | gieger
阿福蒂 | 阿富尔蒂特 | affourtit
米塞尔 | 米赛尔 | misael
赫默里希 | 亨默里克 | hemmerich
詹宁斯 | 杰宁斯 | jenyns
巴克霍尔兹 | 巴克霍尔茨 | buckholts
斯塔姆斯 | 斯泰姆斯 | stames
萨万纳 | 萨万娜 | savannah
塔伦斯 | 塔兰斯 | tarrance
谢诺韦思 | 切诺韦思 | chenoweth
安瓦里尔 | 安瓦里普尔 | anvaripour
亚达斯金 | 阿达斯金 | adaskin
比布 | 毕比 | beebe
凯斯勒 | 基斯勒 | keisler
巴尔默 | 布尔默 | bulmer
博查特 | 博哈特 | borchardt
卡明 | 卡迈恩 | carmine
巴特伦 | 巴特拉姆 | bartram
派尔 | 皮尔 | peile
麦康 | 麦肯 | mccon
麦卡里 | 麦凯里 | mccarey
英芬特 | 因方特 | infant
卡赫 | 卡尔 | karrh
亨内肯斯 | 亨尼肯斯 | hennekens
吉弗 | 贾埃弗 | giaever
贾米 | 杰米 | jamie
鲍尔霍恩 | 巴尔霍恩 | ballhorn
斯特吉斯 | 斯特奇斯 | sturges
莫克萨姆 | 莫克塞姆 | moxam
帕斯 | 佩斯 | pace
阿什多恩 | 阿什当 | ashdown
卡尔梅 | 卡尔姆 | culme
比克姆 | 比卡姆 | bickham
希尔曼 | 沙伊尔曼 | shireman
梅索利 | 梅索伊 | meszoly
福伊希特纳 | 福伊希特万格 | feuchtwanger
埃森斯 | 埃森丝 | essence
格沃思米 | 格瓦思米 | gwathmey
巴比罗利 | 巴尔比罗利 | barbirolli
利布 | 利比 | luebbe
哈泽尔 | 黑兹尔 | hazell
施蒂宁 | 斯蒂宁 | stiening
克莱农 | 克勒农 | clernon
金德雷德 | 金德里德 | kindred
德鲁夫 | 德鲁伊夫 | druiff
努索尔 | 纳托尔 | nuthall
戴 | 戴伊 | daigh
埃坦 | 埃泰恩 | etain
德尔里戈 | 德尔列戈 | delriego
巴策 | 巴策尔 | batzer
廷肯 | 廷康 | tinkon
德弗雷茨 | 迪弗雷特斯 | defrates
尤拉姆 | 乌拉姆 | ulam
昂德歇尔 | 昂德达尔 | underdahl
达劳 | 达罗 | darraugh
米恩斯 | 默恩斯 | mearns
蒂利 | 泰利 | tiley
格罗布 | 格罗比 | grobe
塔塔利诺 | 塔尔塔利诺 | tartaglino
兰姆 | 拉姆 | lambe
卡德韦尔 | 考德威尔 | caldwell
泽米娜 | 泽米纳 | zemina
坎特伯里 | 坎特伯雷 | canterbury
塔肯 | 泰肯 | tacon
基尔施 | 基尔希 | kirsch
古特穆特 | 古特穆思 | gutermuth
弗森 | 费尔森 | ferson
托皮 | 托毕 | torpey
洛多维克 | 洛多威克 | lodowicke
泰奇曼 | 泰克曼 | teichmann
普鲁杜姆 | 普鲁多姆 | prudhomme
基斯特纳齐西 | 基斯特纳萨米 | kistnasamy
坎比 | 坎贝 | cumbey
赫姆尔 | 赫姆利 | hermle
蒙根 | 蒙贡 | mongon
马歇尔 | 马塞尔 | mussehl
亨佩尔 | 亨普尔 | hempel
艾罗 | 艾罗尔特 | ayrault
赖蒂娜 | 赖蒂纳 | rytina
里亚 | 雷 | rea
布赖登索尔 | 布赖登塔尔 | breidenthal
罗林格 | 罗林杰 | rollinger
德卢吉 | 德路易吉 | deluigi
科什雷斯 | 科克里斯 | cocheres
巴姆菲尔德 | 班菲尔德 | bamfield
霍斯伯格 | 霍斯伯勒 | horsburgh
贝尔茨 | 贝尔思 | belth
鲁达赫 | 鲁阿兹 | ruadh
格雷思黑德 | 格雷特黑德 | greathead
巴斯基特 | 巴斯克特 | baskette
马尔特比 | 莫尔特比 | maltby
埃塞蕾达 | 埃塞丽达 | ethelreda
默奎斯顿 | 默奇斯顿 | merchiston
迪娜 | 迪恩纳 | dienna
博里尔 | 博雷尔 | boreel
布雷恩 | 布里恩 | brehon
盖尔 | 圭尔 | guire
约赫克 | 尤尔丘克 | yurchuck
坦尼肯 | 滕尼肯 | tennican
利文 | 莱文 | levene
克拉莱斯 | 克拉雷斯 | clares
杜林科 | 祖林科 | dzurinko
林利斯戈 | 林利思戈 | linlithgow
塞普林斯基 | 西普林斯基 | cieplinski
索茹纳 | 索杰纳 | sojourner
布鲁休森 | 布鲁克豪森 | bruchhausen
纳布尔 | 努贝尔 | knubel
卡诺肯 | 卡诺坎 | carnochan
吉纽诺 | 吉赫诺 | giheno
乔伊齐 | 乔伊西 | joicey
罗克辛 | 罗克西娜 | roxinne
伦斯勒 | 伦塞勒 | rensselaer
伊登斯 | 埃登斯 | edens
杰姆森 | 詹姆森 | jameson
比哈里尔 | 贝哈里尔 | beharriell
朗查姆 | 朗香 | longchamp
贝德纳斯基 | 贝德纳尔斯基 | bednarski
舒尔金德 | 舒尔坎德 | schulkind
穆拉马米 | 穆拉卡米 | murakami
皮什 | 佩什 | peche
洛伦兹 | 洛伦茨 | lorenz
特波尔 | 蒂普尔 | tepoel
吉莫 | 贾伊莫 | giaimo
库尔吉安 | 库尔金 | kuljian
哈米利恩 | 哈米里恩 | hamilyon
利恩 | 利安娜 | leanne
基尔库西 | 基尔科西 | kilcoursie
纽布拉奇 | 纽布兰奇 | newbranch
里森诺弗 | 里曾诺弗 | reasonover
雷布萨蒙 | 里布萨门 | rebsamen
托菲申 | 托菲肯 | torphichen
布利克斯弗弗 | 布利肯斯德弗 | blickensderfer
戈索尔斯 | 戈瑟尔斯 | goethals
古尔蒂里 | 瓜尔蒂耶里 | gualtieri
科伊 | 考伊 | cowie
泽兰 | 齐伦 | zeran
比贝尔 | 比布尔 | biebel
奥尔德史斯尔 | 奥尔德斯泰尔 | oldstyle
西门斯 | 西门子 | siemens
普利本 | 普利邦 | plybon
佩伊夫 | 帕耶夫 | payeff
斯温斯鲁德 | 斯温斯拉德 | swensrud
贝克纳 | 比克纳 | beichner
恩格霍尔姆 | 恩格霍姆 | engholm
惠特洛 | 怀特洛 | whytlaw
迪瓦斯 | 德瓦斯 | dewas
兰内伯格 | 兰恩伯格 | ranneberger
桑德威克 | 桑威克 | sandwick
威思 | 韦思 | wyeth
施魏希尔德 | 施韦柴尔德 | schweichild
斯坦霍普 | 斯坦诺普 | stanhope
英沃尔兹塔德 | 英沃斯塔德 | ingvoldstad
森厄 | 桑戈尔 | senghor
布里豪斯 | 布里格豪斯 | brighouse
克伦布尔 | 克伦巴尔 | krumbhaar
莫拉尔 | 莫勒 | morar
格莱纳纳 | 格莱纳瑟 | glenarthur
路易 | 路易西 | louisy
弗里利 | 弗赖利 | friley
赖兰斯 | 赖伦斯 | rylance
吉尔德里夫 | 吉尔德斯利夫 | gildersleeve
鲍托尔 | 鲍塔尔 | boutall
斯帕因 | 斯佩因 | spayin
哈勒尔 | 哈拉尔 | harral
哈扎德 | 哈泽德 | hazard
穆切特 | 马希特 | mushet
布鲁姆利 | 布伦利 | brumley
比尔特 | 伯特 | birt
菲金杰 | 菲金格 | fickinger
明 | 米恩 | min
菲格雷斯 | 菲格斯 | figures
伊万杰莱塔 | 埃万杰利斯塔 | evangelista
韦布利 | 韦伯利 | webley
帕门蒂尔 | 帕尔芒捷 | parmentier
迪杰莉斯 | 迪安杰利斯 | deangelis
格里沃尔特 | 格里纳沃尔特 | greenawalt
麦格拉施里奇 | 麦格拉斯里克 | macglasrich
索恩顿 | 桑顿 | thornton
巴洛克 | 巴洛赫 | balloch
彻内斯基 | 切尔涅斯基 | chernesky
克龙 | 克朗 | kron
贝勒瓦 | 贝尔维 | bellevue
里斯伯格 | 赖斯伯格 | riseberg
布劳恩 | 布朗 | braun
拉德姆姆 | 拉德勒姆 | rudderham
特里利文 | 特里莱文 | treleaven
切科格维奇 | 切特科维奇 | chetkovich
比内尔 | 比尤内尔 | buesnel
阿迪 | 埃迪 | adye
哈格迈耶 | 哈格迈尔 | hagemeyer
凯希亚 | 凯蒂娅 | katia
阿拉蒙 | 阿拉芒 | allamong
西米恩 | 西明 | siemien
罗文德 | 罗安德 | rowand
普里亚尔 | 普赖尔 | prial
布利萨克 | 布利萨茨 | blisac
布罗伊特 | 布劳伊特 | browett
马尼斯 | 马内斯 | maness
阿博德 | 阿布德 | abboud
拜兹 | 比德兹 | bidez
埃威尔 | 厄维尔 | irwil
威尔米特 | 薇尔梅特 | wilmett
尼迪 | 内迪 | neddy
纳兰乔 | 纳兰霍 | naranjo
布雷兰 | 布里兰 | breland
阿马纳西 | 阿马纳齐 | armanazi
奥金迪 | 奥金达基 | auchindachie
卡尼特 | 卡内特 | kanet
卡尔 | 卡利 | karle
阿德莉娜 | 阿德利娜 | adelina
斯特尔特 | 斯泰尔特 | stelter
舒克伯勒 | 沙克伯勒 | shuckburgh
特雷菲西斯 | 特里富西斯 | trefusis
亚历克森森 | 亚历山德森 | alexanderson
科克伦 | 科克兰 | cockran
格尔 | 瓜尔 | guare
朱皮特 | 丘辟特 | jupiter
德特里希 | 多伊特里希 | deutrich
托厄里 | 托尔里 | towery
马德林 | 马德琳 | madlin
威舍 | 维舍 | wischer
卡莱尔 | 卡利尔 | kalil
戴加 | 迪格 | dygard
库比特 | 丘比特 | cubitt
西克雷斯特 | 西克里斯特 | secrest
塔特 | 图特 | tuteur
拉扎 | 拉扎尔 | lazar
麦高恩 | 麦古恩 | macgoun
佩茨 | 皮特斯 | petes
费尔哈文 | 费尔黑文 | fairhaven
扎什洛夫 | 扎斯洛夫 | zaslove
索恩伯格 | 索恩伯勒 | thornburgh
特雷德加 | 特里迪加 | tredegar
埃瑟 | 阿瑟 | acer
阿丽 | 阿利 | alli
阿蒂盖尔 | 阿蒂格尔 | attygalle
马西娅 | 玛西娅 | mathea
费布勒 | 法布勒 | fabler
格莱德 | 格利德 | gleed
彼得鲁斯拉 | 彼特鲁斯卡 | petruska
弗恩 | 维恩 | verne
韦姆 | 瓦伊姆 | waim
鲁兰 | 鲁伦 | ruellan
拉赫特 | 拉克特 | lachter
拉哈布 | 雷哈布 | rahab
麦金纳尼 | 麦基纳尼 | macinerney
斯蒂格勒 | 施蒂格勒 | stigler
特威宁 | 特文宁 | twining
西达罗斯 | 西达劳斯 | sidarouss
弗洛威 | 弗劳尔迪 | flowerdew
盖兰 | 格兰 | gellan
吉梅内斯 | 希门尼斯 | jimenez
普勒 | 普拉 | pullar
斯威特曼 | 斯韦特曼 | sweatman
布拉德劳 | 布拉德洛 | bradlaugh
布鲁因 | 布勒因 | bruyn
库劳 | 库罗 | courau
迪米奥 | 迪梅奥 | dimeo
贝尼迪卡斯 | 贝内迪克斯 | benedicus
麦格罗瑟 | 麦格鲁瑟 | macgreuther
柯蒂尼厄斯 | 柯特纽斯 | curtenius
赫利娜 | 赫莉娜 | helina
奥博斯塔 | 阿尔博斯塔 | albosta
斯特朗奇 | 斯特朗 | stronge
埃沃伊 | 伊沃伊 | evoy
迪伦福思 | 迪伦弗思 | dyhrenfurth
坦盖 | 坦圭 | tanguay
拉斯布里奇 | 拉斯布里杰 | rusbridger
米利森 | 米莱森 | muehleisen
杜布拉斯 | 杜布拉 | dubras
劳德代尔 | 劳德戴尔 | lauderdale
伯贝奇 | 伯比奇 | burbage
哈斯卢普 | 哈斯勒普 | haslup
科尔尼特 | 科尔内特 | collnette
波洛斯 | 普洛斯 | poulos
勒万多 | 柳安多 | lewando
休林斯 | 赫林斯 | hulings
施尼特 | 施奈特 | schneiter
弗里岑 | 弗里曾 | fritzen
比纳吉奥 | 比纳乔 | binaggio
贝利 | 贝尔赫 | bailhe
斯科克罗夫特 | 斯考克罗夫特 | scowcroft
奥尔曼 | 阿利芒 | allemang
赛奇 | 赛什 | saich
皮奥特罗夫斯基 | 彼得罗夫斯基 | piotrowski
贾翰 | 扬 | jahn
康戈尔顿 | 康高尔顿 | congalton
乌尔默 | 厄尔默 | ulmer
沙滕克 | 沙滕柯克 | schattenkerk
加特纳 | 盖特纳 | gaertner
法隆 | 法伦 | falloon
克莱本 | 克莱伯恩 | clyburn
奥斯尤 | 奥斯威尤 | oswiu
兰德威西 | 兰德沃西 | landwirthy
索蒂 | 索西 | southee
米隆 | 米伦 | millon
特特尔 | 瑟特尔 | thurtle
艾利 | 艾莉 | eily
埃肯 | 伊肯 | ekern
菲利恩 | 菲利翁 | filion
苏尚 | 舒尚 | shooshan
莫普斯 | 莫皮斯 | moppes
格林斯彭 | 格林斯庞 | greenspun
帕塞尔 | 帕斯尔 | parcell
泰博尔特 | 蒂博尔特 | tybalt
索尔 | 苏尔 | soul
吕尔 | 卢尔 | lure
德多奥 | 戴德奥 | dedeo
巴特歇尔 | 巴特谢尔 | battershell
麦克里思 | 麦克勒思 | mackereth
帕珀马斯特 | 佩珀马斯特 | papermaster
贝伦德斯 | 贝伦兹 | berendes
埃拉齐姆 | 伊拉齐姆 | erazim
施雷德 | 施拉德 | schrade
安热尔 | 安杰尔 | angel
伯克 | 比尔克 | birck
斯潘金 | 斯庞金 | spungin
巴托尔森 | 巴托尔松 | bartholdson
麦克斯波兰 | 麦克斯波伦 | macsporran
英格林 | 英林 | yingling
波特厄斯 | 波蒂厄斯 | porteus
查努廷 | 查纽廷 | chanutin
埃塞克 | 伊塞克 | esek
马耶霍弗 | 迈尔霍费尔 | maierhofer
德普勒格 | 德普卢格 | derploog
弗雷希特 | 弗赖海特 | freiheit
马伦普尔 | 马伦普雷 | malempre
斯拉克 | 斯莱克 | slack
多奇 | 德奇 | doetsch
阿雷顿 | 阿里顿 | arreton
法尔布伦斯 | 法尔布兰斯 | firebrance
安嫩贝格 | 安嫩伯格 | annenberg
富洛姆 | 富勒姆 | fullom
博尔多 | 波尔多 | bordeaux
德西德里厄斯 | 德西迪里厄斯 | desiderius
塔尔戈特 | 索尔戈特 | thalgott
卡特 | 柯特 | curt
切尔基齐安 | 彻克齐安 | cherkezian
马格尼尔 | 马尼耶 | magnier
奥特林尼克 | 奥特林厄姆 | altrincham
埃纳姆 | 埃努姆 | aernum
麦基尔维维 | 麦基雷维 | macilrevie
艾兴格林 | 艾肯格林 | eichengreen
莱夫勒 | 莱弗勒 | leffler
科卡姆 | 科克姆 | corkum
拉文 | 雷文 | raven
黑文纳 | 哈文纳 | havenner
格威沙德斯 | 格威查德斯 | gwychardus
莫布斯比 | 莫布兹比 | mobsby
赛雷斯 | 西尔斯 | cyres
西加尔 | 西格尔 | seegal
西波兰 | 西波隆 | cipollone
阿穆奥 | 阿夸约 | aquayo
赛泽 | 赛斯 | sise
弗雷林豪森 | 弗里林海森 | frelinghuysen
帕杰利斯 | 帕盖利斯 | pargellis
莱普尔 | 勒普尔 | lepoer
阿尔施塔特 | 阿尔斯塔特 | alstadt
博尼法修斯 | 博尼费修斯 | bonifacius
达夫恩 | 达夫妮 | daphne
恩德烈尼 | 恩德雷尼 | endrenyi
麦肯基 | 麦康希 | macconchy
桑德姆 | 桑达姆 | sandham
里穆斯基 | 里莫斯基 | rimouski
马宁 | 曼宁 | maning
布莱赫特 | 布拉胡特 | blachut
赫明 | 亨明 | hemming
特文加姆 | 蒂文加杜姆 | tirvengadum
卡尔斯密斯 | 卡尔史密斯 | carlsmith
马米 | 玛米 | mami
杰内罗 | 吉尼罗 | genero
比斯特 | 比伊斯特 | buist
拉拉莫尔 | 拉腊莫尔 | laramore
福韦尔 | 福尔韦尔 | faulwell
哈克 | 黑克 | hake
哈沙根 | 哈舍根 | hashagen
赖尔斯 | 赖亚尔斯 | ryalls
梅伦 | 默龙 | merron
范德克德 | 范德克利德 | vanderkleed
格鲁科特 | 格劳科特 | groucott
鲁兹 | 吕埃 | ruez
拉德布罗克 | 拉德布鲁克 | ladbroke
卢伊斯蒂格 | 卢斯蒂格 | luistig
昂斯莱格 | 奥恩斯莱格 | oenslager
哈加丁 | 哈格丁 | hargadine
莱基姆 | 利克希姆 | leikhim
沃奇福特 | 沃特沙夫特 | wirtschafter
伊默斯 | 伊穆斯 | imus
托奇 | 托克 | toch
迪文特 | 德温特 | dewenter
加瓦尔特 | 加沃尔特 | gawalt
哈雷尔 | 哈勒尔 | harrel
斯普勒 | 施普勒 | spuhler
西丽卡 | 西里卡 | sirica
阿马尼 | 阿尔马尼 | armani
弗莱布 | 弗莱比 | flebbe
汤姆斯 | 图姆斯 | tombs
达夫伦 | 杜弗隆 | duflon
西伊 | 赛伊 | thye
贝恩 | 本 | benn
马诺莫利 | 马诺波利 | manopoli
麦基利肯 | 麦基利坎 | mackillican
多里 | 多丽 | dorrie
法尼夫 | 法纳夫 | faneuf
劳尔 | 罗尔 | rawle
罗伯顿 | 罗伯茨顿 | robertston
索隆 | 索伦 | solon
科尔克拉瑟 | 科尔克拉泽 | colclaser
罗赫 | 罗奇 | roch
多勒 | 多拉夫 | dorough
巴尔尼尔 | 巴尼尔 | balniel
金克丽德 | 金克里德 | kincrid
菲林 | 法尔林 | firing
克莱姆 | 克莱米 | klemme
费尔 | 费雷 | ferre
菲凯蒂 | 菲谢蒂 | fischetti
安娜贝尔 | 安娜贝勒 | annabelle
贝伊文 | 博伊文 | boivin
福伊西 | 福西 | feusi
朱伯格 | 宗伯格 | zumberg
萨加 | 塞格尔 | sagar
恩格兰 | 英格兰 | england
诺特 | 纽特 | newt
艾德斯莫 | 艾兹莫 | eidsmoe
阿布 | 阿贝 | abbe
布瓦文斯坦 | 博伊斯方丹 | boisfontaine
麦卡耶蒂 | 麦克哈蒂 | mccahearty
麦克门 | 麦克蒙 | mcmunn
塞弗里 | 萨弗里 | savery
布赖滕菲尔德 | 布赖滕费尔德 | breitenfeld
托伦斯 | 托兰斯 | torrance
韦斯特莫兰 | 威斯特摩兰 | westmoreland
伯格哈德 | 伯格哈特 | burghard
厄尔普 | 厄普 | earp
蒙多尔 | 蒙多 | mondor
格尔泽 | 盖尔泽 | gelzer
维尔皮卢 | 韦皮勒 | verpilleux
迪厄门特 | 迪亚门特 | diament
汤南德 | 汤恩德 | townend
杰普恩 | 杰波恩 | jepoen
伯肯霍尔茨 | 伯肯霍尔兹 | birkenholtz
默茨 | 默特斯 | mertes
勒克特 | 勒基特 | luckett
斯珀 | 斯珀尔 | spurr
埃德 | 伊德尔 | eader
福比斯 | 福布斯 | forbes
维诺格拉德 | 维诺格勒 | vinograd
安纳纽尔 | 安纳克莫尔 | annaghmore
斯图德曼 | 斯蒂德曼 | studeman
勒利恩 | 勒林 | lelean
布里森 | 布赖森 | bridson
马达维克 | 马达维赫 | mhadavikh
戈勒布 | 戈卢布 | golub
伊尔杰弗里茨 | 伊尔根弗里茨 | ilgenfritz
达拉赫 | 杜拉奇 | dullach
肖尔德 | 索尔德 | szold
杜普卡克 | 杜普恰克 | dupcak
布雷登 | 布拉顿 | bradon
奥基 | 奥齐 | orczy
贝姆 | 巴姆 | bame
莱西 | 利西 | leisy
普利马尔 | 普莱梅尔 | plymale
布罗梅特 | 布罗米特 | bromet
皮科维亚克 | 皮乔维亚克 | piechowiak
沃尔纳 | 沃纳 | woerner
奥雷斯肯 | 奥雷斯坎 | orescan
惠特伯格 | 惠特伯勒 | whitburgh
西比尔 | 塞比尔 | sebire
霍莫尔卡 | 霍穆尔卡 | homolka
海斯伯格 | 海斯堡 | heisborg
费尔德布里尔 | 费德布里尔 | feldbrill
杰农 | 热农 | gernon
斯滕特 | 斯坦特 | stunt
埃莉斯 | 埃莉丝 | elyse
伦格利 | 伦利 | lungley
米斯基金斯 | 米斯基明斯 | miskimins
克勒勒 | 克雷勒 | kroehler
谢米宁 | 切米宁特 | cheminint
迪本 | 德本 | deben
法斯纳赫 | 法斯纳克特 | fasnacht
布根 | 巴根 | bugan
施万 | 施万布 | schwamb
奥里 | 奥赖 | ory
艾尔弗里克 | 阿尔弗里克 | aelfric
埃尔加 | 艾尔格 | eylgar
索内曼 | 索恩曼 | sonnemann
奥赞娜 | 奥赞 | ozanne
沙普尔斯 | 沙普利斯 | sharpless
德黑 | 德哈恩 | dehaan
雷诺 | 雷纳 | raynor
弗西瓦尔 | 费西瓦尔 | fercival
贝克哈特 | 贝克哈德 | beckhard
松塔格 | 桑塔格 | sontag
麦克尔霍农 | 麦克尔哈农 | mcelhanon
沃尔格格雷夫 | 沃尔德格雷夫 | waldegrave
塔利奥 | 图利奥 | tullio
莱威尔 | 勒威尔 | lerwill
麦康 | 梅肯 | macon
德拉芬斯 | 德拉方斯 | delafons
戴维 | 达维 | davee
戈希 | 戈伊 | gohey
克莱弗 | 克拉弗 | claver
桑瑟姆 | 桑森 | sansum
吉吉 | 吉盖 | giggey
达科姆 | 戴科姆 | dacombe
邦廷 | 邦坦 | bontein
多本 | 多宾 | doben
杰穆斯 | 格穆思 | germuth
麦克内尼 | 麦克尼尼 | mceneaney
泰因什 | 坦什 | tainsh
克雷斯皮尼 | 克雷皮尼 | crespigny
赫梅尔森 | 休梅尔辛 | humelsine
马夸里 | 麦夸里 | maquarie
比尔基 | 伯基 | buerki
斯沃迪 | 斯沃德什 | swadesh
巴贝尔 | 贝布尔 | babell
克拉丽达 | 克拉里达 | clarida
博德温恩 | 博德瓦恩 | bordwine
布伦塔斯 | 布龙塔斯 | brountas
德雷戈雷拉 | 德沃尔吉拉 | drevorguilla
科特兰 | 柯特兰 | kirtland
奥弗拉法蒂 | 奥弗莱厄蒂 | o'flahertie
塞维 | 西维 | sevey
鲍弗 | 鲍尔 | bouwer
克拉恩 | 克拉汉 | crahan
博克尔 | 博克 | boker
斯森特 | 森特 | scent
埃肖 | 埃舒 | eshoo
佩雷兹 | 佩雷斯 | perez
蒂利 | 蒂莉 | tillie
阿利森 | 艾莉森 | alyson
德雷塞尔 | 德雷斯尔 | dressel
朱利 | 朱莉 | julie
丹尼昂 | 达尼恩 | danyon
马休伦 | 马胡兰 | mahuran
瓦恩 | 韦恩 | vayne
波兰 | 普兰 | poulain
切 | 切赫 | czeh
西尔瓦纳斯 | 西尔维纳斯 | silvanus
埃克斯坦斯 | 埃克斯滕斯 | exstance
艾恩斯 | 安斯 | aines
尼恩 | 奈恩 | nyhen
霍拉舍斯 | 霍雷修斯 | horatius
佩基 | 帕基 | packy
克利瑟 | 克莱瑟 | cleather
瓦基特 | 瓦克特 | wackett
罗巴蒂斯 | 罗巴茨 | robartes
阿格内洛 | 阿涅洛 | agnello
伊莱 | 艾莱 | ilay
纳西 | 纳休 | nathiew
赫德克 | 赫达克 | hudak
塞西利厄斯 | 塞西莉厄斯 | cecilius
沃纳科特 | 旺纳科特 | wonnacott
纳登 | 内登 | naden
哈姆斯 | 黑姆斯 | hammes
雷贝尔 | 里贝尔 | rebel
查格尔斯 | 查格利斯 | chagles
格里博诺 | 格里布诺 | griebenow
朔伊尔 | 肖尔 | schauer
加南吉安 | 加南吉扬 | ganangiyan
彭特 | 廷特 | tynte
古拉德 | 戈拉德 | goulard
考沃特 | 科沃特 | cowart
布里斯 | 布赖斯 | brise
沙特勒 | 舒特勒 | shutler
怀特利瑟 | 怀特莱瑟 | whiteleather
埃夫勒 | 埃弗勒 | effler
惠特塞特 | 惠特西特 | whitsett
哈奇森 | 哈钦森 | hutchinson
库兰蒂克 | 库兰齐克 | kurlantzick
明顿 | 明特恩 | minturn
勒克龙 | 莱克龙 | leckrone
布雷斯纳安 | 布雷斯纳汉 | bresnahan
波 | 鲍 | pow
拉克索尔 | 拉克斯尔 | wraxhall
曼柳斯 | 曼利厄斯 | manlius
谢拉 | 希拉 | shelagh
内格尔 | 尼格尔 | negel
巴吉特 | 巴杰特 | bardgett
乔弗里翁 | 乔夫里翁 | joffrion
伯恩 | 贝尼 | boehne
德沃拉克 | 德沃夏克 | dvorak
贝纳维德斯 | 贝纳维兹 | benavides
马乔斯 | 梅杰斯 | majors
福伊尔克 | 福伊尔沃克 | feuerwerker
塔吉 | 塔姬 | taggy
麦科克 | 麦科奇 | mccoch
巴克纳 | 巴赫纳 | bachner
图德霍 | 塔杜 | tudhoe
蒂格雷特 | 泰格雷特 | tigrett
卡迪尤 | 卡迪厄 | cadieux
纳蒂 | 克努蒂 | knutti
凯嫩 | 凯南 | kainen
德普托克 | 德普塔克 | deptuck
格尔 | 吉尔 | gehl
迪斯特伯格 | 杜斯特伯格 | duesterberg
莱德福 | 利德福德 | lydford
科南 | 科奈恩 | conein
巴尔诺 | 巴诺 | barno
朗莱因 | 朗莱恩 | longhlein
埃勒斯 | 埃利斯 | elles
德斯巴拉茨 | 德巴拉茨 | desbarats
沃拉克 | 沃勒克 | wallack
克兰多尔 | 克兰德尔 | crandall
克里斯顿森 | 克里斯坦森 | christanson
卡尼尼 | 卡奈尔尼 | carnearney
坦嫩鲍姆 | 特南鲍姆 | tennenbaum
霍奇 | 霍根 | hodgan
卡基亚 | 卡夏 | cachia
莫森 | 莫桑 | morsan
阿杰里斯 | 阿吉里斯 | argeris
明尼特 | 明妮特 | minnette
福尔加 | 福加 | forga
里哈尔 | 雷哈尔 | rehal
安斯波 | 安斯帕赫尔 | anspacher
贾西诺夫斯基 | 贾西诺斯基 | jasinowski
克雷弗 | 克里弗 | crever
沃尔西夫 | 瓦尔塞奥夫 | waltheof
拉普亚诺 | 拉普阿诺 | rapuano
托比特 | 托贝特 | torbett
泰雷尔 | 蒂雷尔 | tyrell
安德雷斯 | 安德烈斯 | andress
卡尔戈 | 卡戈 | cargo
埃尔斯皮 | 伊丽莎白 | elspie
哈根 | 黑根 | hagan
维特拉泰尔 | 维特拉西尔 | vytlacil
凯特林萨克 | 卡特林萨克 | katrinsak
托普尔 | 托佩尔 | topple
撒姆斯 | 泰晤士 | thames
斯维克 | 斯韦克 | svec
肯奈尔德 | 肯奈德 | kennaird
莱克拉斯 | 勒克拉 | lecras
安德琳 | 安德林 | andelin
艾克纳 | 艾希纳 | eichner
费拉 | 费劳 | ferrao
奥弗莱雷蒂 | 奥弗莱厄蒂 | o'flaherty
博内斯蒂尔 | 博恩斯蒂尔 | bonesteel
克里恩 | 克林 | crean
萨马罗 | 萨马鲁 | samaroo
卡赫特 | 卡彻特 | kachert
休 | 霍格 | hoegh
珀克 | 珀基 | pyrke
恩布林 | 恩布琳 | emblin
谢伍德 | 舍伍德 | sherwood
瓦莱蒂斯 | 瓦莱奥蒂斯 | valeotis
西森 | 特森 | thesen
吉尔德豪姆 | 吉尔多姆 | guildhaume
埃夫尤 | 埃维尤 | evjue
威尔科夫斯基 | 维尔科夫斯基 | wilkowski
法尼奥尔 | 法纳尔 | faneuil
雷塔 | 里塔 | rheta
伯尼特 | 伯内特 | burnett
里查特 | 理查特 | richart
朗尼加 | 朗内加 | runnegar
安恩霍尔兹 | 安索尔兹 | ahntholz
卡萨 | 卡撒 | cartha
麦克莱恩 | 麦克林 | mcclean
扬杰 | 扬格 | younger
多尔格 | 德尔格 | dolger
希尔米密斯 | 希尔史密斯 | shearsmith
赫贝斯特里特 | 赫布斯特雷特 | herbestreit
赫尔斯滕 | 赫尔斯特恩 | hellstern
法兹卡斯 | 法泽卡斯 | fazekas
普莱斯顿 | 普利斯顿 | puleston
迪林 | 迪尔林 | deerlin
埃尔韦斯 | 埃尔威斯 | elwes
塔弗 | 塔沃尔 | tavor
韦赫 | 韦伊尔 | weiher
维特 | 维特尔 | vetter
赫米恩 | 赫米奥娜 | hermione
约翰森 | 约翰逊 | johnson
杭德里奇 | 杭德里克 | honderich
利伯坦 | 利伯蒂娜 | libertine
达莱皮兹 | 达莱佩泽 | dallepezze
迈尔斯特拉普 | 迈尔斯特勒普 | meilstrup
朗斯莱特斯 | 朗斯利特斯 | launceletus
埃德利 | 埃德尔 | ederle
阿代奥 | 阿德奥 | addeo
米杰利 | 米奇利 | midgley
科莫尼亚克 | 科莫尼亚雷克 | komoniarek
格恩斯巴克 | 根斯巴克 | gernsback
维图凯蒂斯 | 韦图凯蒂斯 | vaitukaitis
比尔 | 伯尔 | birr
邓坎森 | 邓肯森 | duncanson
格拉迪厄斯 | 格拉迪厄 | gladieux
高迪安 | 高迪恩 | gaudian
迪尔 | 代尔 | diel
肯奇 | 金奇 | kynge
菲茨瓦伦 | 菲茨沃伦 | fitzwarren
迪思里希 | 迪特里希 | diethrich
德黑 | 德海 | dehay
迈斯利克 | 迈斯利奇 | meislich
沃索 | 瓦索 | wasow
霍沃思 | 豪沃思 | howarth
贾尔迪 | 吉亚尔迪 | ghiardi
阿勒姆 | 奥勒姆 | allam
博迪科姆 | 博迪库姆 | bodycombe
施韦尔布 | 施韦布 | schwelb
艾泽纳 | 艾泽努尔 | izenour
雷纳尔夫 | 雷纳夫 | ranulph
特里利斯 | 特里赖斯 | trerise
帕尼特 | 帕内特 | panet
平肖特 | 平肖 | pinchot
范热 | 范格特 | fanget
伊尔格 | 伊尔克 | ilg
查森 | 蔡森 | chasen
科佩拉 | 科皮拉 | coppela
乔拉布基安 | 朱拉布奇安 | joorabchian
斯顿博 | 斯通博 | stombaugh
斯拉特里 | 斯莱特里 | slattery
弗雷克莱顿 | 弗雷克尔顿 | freckleton
托罗 | 陶罗 | tauro
埃尔马思 | 厄马思 | earmarth
希勒克 | 希莱克 | shillaker
霍根 | 豪根 | haugan
贝格尔曼 | 比格尔曼 | begelman
赫格金斯 | 哈金斯 | hugghins
梅约 | 梅奥 | mayo
安蒂维尔 | 安特维尔 | antevil
杜纳文特 | 杜纳万特 | dunavant
奎珀斯 | 凯珀斯 | kuipers
梅恩达德 | 梅因唐纳德 | maindonald
麦卡勒里 | 麦卡利里 | mcalery
哈兹尔廷 | 黑兹尔坦 | hazeltine
米希尔 | 迈伊尔 | mighill
赫曼 | 希曼 | heman
布罗瑟 | 布拉泽 | brother
赛恩 | 锡恩 | thynne
弗里斯 | 弗里亚斯 | freas
皮尼 | 派尼 | piney
布里安 | 布赖恩 | brian
拉尼斯 | 鲁尼斯 | runice
莱顿德尔 | 勒滕德 | letendre
杰斯 | 杰西 | jesse
海因 | 海因特 | heinte
格温沃 | 格温弗 | gwynfor
莱夫斯克 | 莱韦斯克 | levesque
奥德里 | 奥德丽 | audrey
皮伊斯 | 皮尤什 | piyush
托尔明 | 图尔明 | toulmin
丹尼罗 | 达尼罗 | daniero
斯马比 | 斯梅比 | smaby
德赖伯格 | 德赖伯勒 | dryburgh
莱彭内克 | 勒佩内克 | lepennec
津巴尔多 | 津巴多 | zimbardo
多南菲尔德 | 多宁费尔德 | donenfeld
内诺斯 | 纳诺斯 | nanos
沃尔德雷普 | 沃尔德里普 | waldrep
德马西奥 | 德马肖 | demascio
马科夫斯基 | 穆科斯基 | mukowski
泽切拉 | 泽克拉 | zechella
卡莉 | 凯莉 | kallie
斯凯特 | 斯卡特 | skate
麦吉尔福 | 麦吉尔伍尔 | macgillvoor
布戈德 | 布古尔 | bougourd
塞文 | 西文 | sevin
欣恩 | 希恩 | shinn
庞南彭厄拉 | 庞南佩鲁马 | ponnamperuma
米曾 | 迈曾 | mizen
洛梅尔 | 隆梅尔 | lommel
马赫 | 马奇 | much
盖尼弗 | 珍妮弗 | gennifer
查萨尼斯 | 沙萨涅 | chassagnes
厄尔利 | 厄利 | earley
艾尤托 | 阿尤托 | aiuto
博赫罗德 | 鲍赫鲁德 | boughrood
吉隆 | 吉伦 | gillon
道沃德 | 道尔德 | doward
瓦克 | 瓦克尔 | wacker
卢易佐 | 路易祖 | louizou
弗兰兹 | 弗朗兹 | franz
特里福尼斯 | 特里福尼迪斯 | trifonidis
米泽尔 | 米泽勒 | mizelle
托雷斯 | 托里斯 | torres
沃尔本 | 沃莱本 | wohlleben
法法尔格拉夫 | 法尔茨格拉夫 | pfaltzgraff
玛丽恩 | 马里恩 | maryon
沃申科 | 瓦申科 | washenko
克罗普坎 | 克罗帕特金 | kropatkin
博尼特 | 博内特 | bonett
伊利特 | 艾利特 | ilett
多伊谢尔 | 多伊施尔 | deuschl
厄明格 | 艾尔明格 | irminger
阿伦 | 艾伦 | allen
布耶克 | 布亚克 | bujake
伊莎巴德 | 伊桑巴德 | isambard
斯森特 | 斯滕特 | stent
乔瑟姆 | 乔撒姆 | jotham
温彻廉 | 温切尔西 | winchelsea
古卡斯 | 古奥卡斯 | guokas
迪特尔 | 迪泰特 | dittert
菲策尔温 | 菲茨艾尔温 | fitzailwyn
埃迪生 | 埃迪森 | eddison
加雷特 | 加勒特 | garret
希金博瑟姆 | 希金博特姆 | higinbotham
登宁 | 丹宁 | denning
塞雷斯 | 塞尔斯 | sayres
比柳 | 比利厄 | bilyeu
马杰 | 马季 | marj
布加斯 | 巴加斯 | bugas
埃奇达尔 | 埃奇代尔 | edgedal
勒基 | 莱基 | lecky
凯 | 基 | key
林德斯滕 | 林斯滕 | lindsten
本内特 | 贝内特 | bennete
贝拉尔 | 伯罗尔 | berall
施威默 | 施维默 | schwimmer
斯威特基 | 斯威凯 | switkay
索布洛夫 | 索贝洛夫 | sobeloff
贝勒 | 贝尔 | beighle
梅奥 | 梅约 | maio
休维尔 | 特威利尔 | thuillier
戴亚特 | 迪亚曼特 | diamant
法拉古特 | 法拉格特 | farragut
科德 | 科尔德 | coard
德加拉迪丁 | 德加拉贝迪安 | dergarabedian
戈特盖卢 | 戈特格特鲁 | gottgetereu
尼迪 | 内迪 | neddie
赫伦布兰德 | 海伦布兰德 | hellenbrand
厄布 | 厄尔布 | erb
鲍尔达齐 | 巴尔丹齐 | baldanzi
西西 | 锡西 | cissie
莱兰 | 利兰 | lelland
温泽尔 | 温策尔 | wenzel
道奇 | 杜奇 | dooge
巴蒙特 | 贝蒙特 | bamont
奥尔德海泽 | 奥尔迪泽 | aldhizer
纳丁 | 纳金 | nagean
姆利纳基克 | 姆利纳奇克 | mlinarchik
贝格尔 | 比格尔 | begel
道兹韦尔 | 多德斯韦尔 | dowdeswell
德尔 | 杜尔 | durr
米齐 | 梅齐 | meazey
格鲁乔 | 格劳乔 | groucho
普拉因 | 普拉欣 | prahin
迪伦福思 | 迪伦弗思 | dhyrenfurth
扎尔米 | 扎尔梅 | zalmay
扬克威奇 | 扬克维奇 | yankwich
萨奇曼 | 塞奇曼 | sageman
克基维尔 | 克切维尔 | kercheville
德西雷 | 德西蕾 | desiree
基利 | 丘利 | kewley
德波迈耶 | 德波米耶 | depommier
拜恩 | 拜昂 | bion
加哈根 | 加黑根 | gahagen
麦金图夫 | 麦金塔夫 | mcinturff
莫福兹 | 莫维兹 | morfudd
桑克利 | 尚克利 | sankley
罗梅因 | 罗曼 | romaine
凯米 | 卡米 | camy
萨马拉 | 赛马拉 | saemala
维斯坦 | 威斯坦 | wystan
吉尔哈利 | 吉尔胡利 | gilhuly
博德威恩 | 鲍德温 | bodwine
勒斯 | 卢斯 | luss
霍里 | 豪里 | haury
莱瑟夫 | 勒瑟夫 | lesurf
查伦格 | 查林杰 | challenger
泰特 | 撒特 | thaete
约基尔森 | 约克尔森 | yochelson
赛赫 | 西赫 | sih
弗兰西亚 | 弗朗西亚 | francia
亨特雷斯 | 亨特里斯 | huntress
图森 | 蒂乌萨宁 | tiusanen
迈尔德温 | 米尔德文 | mildvan
安尼尼 | 阿内尼 | aneny
卡多里 | 卡杜里 | kadoorie
马斯曼 | 穆斯曼 | mussman
恩德斯 | 恩德雷斯 | endres
沃朗德 | 沃尔龙德 | walrond
蒙塔文 | 蒙塔冯 | montavon
阿尔韦尔 | 奥尔韦尔 | alwell
萨奇 | 萨特杰 | satge
贾尼斯 | 贾尼西 | janisse
巴德拉 | 班德拉 | bandera
迪蒂 | 达西 | duthie
加亨 | 加恩 | gahan
德拉波 | 德拉珀 | drapeau
霍格加特 | 霍贾特 | hodgart
德斯博瓦 | 德布瓦 | desbois
考斯兰 | 库斯兰 | cousland
斯韦布 | 斯韦比 | swaebe
格拉巴尔 | 格拉巴 | grabar
弗鲁伊特 | 弗鲁特 | fruit
伊勒恩 | 伊尔伦 | illearn
阿布洛姆 | 阿布隆 | ablom
博尔加塔 | 博加塔 | borgatta
埃斯梅尔 | 伊斯梅尔 | esmail
沃滕伯格 | 瓦滕伯格 | wattenberg
安努斯 | 安图尼斯 | antunes
阿迪内特 | 阿迪尼特 | adinet
吉尔克雷斯特 | 吉尔克里斯特 | gilchrest
迪克 | 迪克尔 | dicker
德塞 | 德瑟 | desser
霍耶莱贝克 | 胡尔贝克 | houiellebecq
布希 | 布舍 | busche
卡梅尔福德 | 卡姆尔福德 | camelford
露金鲍尔 | 卢金比尔 | lukingbeal
比伊 | 布伊 | buie
马尔欣恩 | 马尔夏恩 | mulshine
埃利特拉 | 伊莱克特拉 | electra
法伦特霍尔德 | 法伦索尔德 | farenthold
多佩尔 | 德佩尔 | doepel
查费茨 | 查菲茨 | chafetz
瑟米厄斯 | 瑟缪斯 | sermeus
德文特 | 德甘特 | degandt
艾克瑟 | 伊克瑟 | ixer
伊卡恩 | 伊坎 | icahn
罗伊尔 | 鲁埃尔 | reuel
桑恩 | 图恩 | thun
海森 | 希森 | hyson
布龙森 | 布朗森 | bronson
吉诺尔 | 格瑙尔 | genauer
查维 | 查维格 | chaveg
默里 | 缪里 | murie
克莱夫 | 克拉夫 | clave
卡莎 | 卡沙 | kasha
利多姆 | 利德姆 | leedom
马拉布尔 | 梅拉伯 | malabre
利希特沃特 | 利希特瓦尔特 | lichtwardt
加诺斯 | 加农斯 | garnons
奥弗罗尔 | 奥费拉尔 | o'ferrall
麦琴 | 梅琴 | machen
塔谢罗 | 塔什罗 | taschereau
夏蓬 | 沙蓬 | chapone
利格 | 洛格 | logue
克里斯皮安 | 克里斯皮尼安 | crispinian
林迪 | 琳迪 | lynndie
多努莫尔 | 多诺莫尔 | donoughmore
奇德尔 | 切德尔 | chedell
艾丽 | 艾尔利 | airlie
甘博 | 甘博亚 | gamboa
巴蒂萨尔 | 巴蒂扎尔 | bartizal
康伯 | 库默 | comber
赫施 | 胡希 | husch
阿克利 | 埃克利 | akeley
尤泽 | 尤伊泽 | ueyser
奥拉 | 奥尔拉 | orla
西拉 | 赛拉 | thyra
卡丹 | 卡登 | kadane
斯特罗索尔 | 斯特罗萨尔 | strohsahl
阿韦伯里 | 埃夫伯里 | avebury
卢什 | 勒什 | lush
迪达姆 | 迪德姆 | deedham
古特沃思 | 格特沃思 | gutwirth
斯特朗伯格 | 斯特龙伯格 | stromberg
格维茨 | 格威茨 | gurwitz
德梅特 | 德梅特尔 | demaitre
哈特内特 | 哈特尼特 | hartnett
贝里 | 比尔里 | beary
塞吉恩 | 塞金 | seguin
达姆勒 | 杜姆勒 | dumler
利奥妮达斯 | 利奥尼达斯 | leonidas
海因菲尔德 | 汉费尔德 | hainfeld
沃拉 | 瓦拉 | walla
埃尔德勒 | 埃尔德姆 | ealdhelm
斯塔尔尼克 | 斯托尔内克 | stalnecker
马杰里 | 马格丽 | margery
贝沃尔德 | 贝瓦尔德 | baerwald
盖伊 | 贾伊 | ghey
赖姆斯 | 里姆斯 | rheims
费罗伊德 | 费罗祖德 | ferozud
凯乔亚 | 凯乔 | kejoa
博斯顿 | 波士顿 | boston
费克克蒂蒂 | 费克特库蒂 | feketekuty
杜布纳 | 达布纳 | dubner
赫芬 | 赫法恩 | huffine
瑟希 | 塞希 | sershey
拉克斯里思 | 拉克斯弗里思 | laxfrith
塞利格曼 | 塞利希曼 | seligmann
阿格里皮 | 阿格里帕 | agrippa
加韦德 | 加维德 | gaved
科奇尼希 | 科奇尼格 | kotschnig
斯特雷姆劳 | 斯特里姆劳 | stremlau
佩洛贝特 | 佩卢贝特 | peloubet
德罗姆戈尔 | 德罗姆古尔 | dromgoole
拜尔 | 贝耶尔 | beier
斯普赖耶 | 斯普赖尔 | spryer
马卡洛尼斯 | 马查洛尼斯 | marchalonis
瑟沃克 | 瑟瓦奇 | serwach
阿菲 | 埃菲 | afee
西德博特姆 | 赛德博特姆 | sidebotham
格德 | 格尔德 | gerd
埃克洛夫 | 埃克勒夫 | eklof
博格盖尔 | 博格蒂尔 | boghatyr
芬格勒 | 芬勒 | fengler
豪因谢尔 | 霍恩谢尔 | hounshell
伊因 | 约恩 | eoin
索 | 托 | thau
悉尼 | 西妮 | sydni
图里曼 | 图尔曼 | tureman
德西德拉塔 | 德西德蕾塔 | desiderata
茹埃特 | 朱厄特 | jouett
班顿 | 贝恩顿 | baynton
约克威尔姆斯 | 约克威廉 | yorkwilliams
伍尔斯泰特 | 沃尔斯泰特 | wohlstetter
弗拉利克 | 弗雷利克 | fralick
瑟娜 | 塞尔纳 | serna
伦宁 | 伦南 | lennen
弗雷伊 | 弗雷 | frej
杰瑟里奇 | 杰塞里克 | jeserich
希格内特 | 希格尼特 | hignett
杜庞特 | 杜邦 | dupont
克利姆克 | 克利姆基 | klimcke
赫尔布尔 | 赫布尔 | helble
比尔布勒 | 比尔伯勒 | bilbrough
斯温托 | 斯温特 | swintor
昂布赖特 | 昂布里特 | umbreit
布劳恩 | 布朗 | browne
凯加 | 凯加鲁 | caegarw
萨姆斯塔格 | 扎姆斯塔格 | samstag
贾格斯 | 贾格尔斯 | jaggers
格伦巴克 | 格伦巴赫 | grumbach
凯斯 | 基斯 | keys
萨基纳 | 萨金娜 | sakinah
勒福 | 勒方 | lefaune
拉夫向 | 拉夫肖恩 | rafshoon
哈格特 | 哈吉特 | haggitt
贝曼 | 比曼 | beman
西弗特 | 索伊弗特 | seufert
麦克沃登 | 麦克瓦登 | mcvadon
帕特诺 | 佩特诺 | paterno
阿克申 | 埃克申 | action
马因沙因 | 梅恩沙因 | maienschein
桑兹 | 桑德斯 | sondes
穆普森 | 马普森 | mupson
埃尔利 | 埃尔勒 | ehrle
勒克赫斯特 | 卢克赫斯特 | luckhurst
卡罗尔 | 卡萝尔 | carole
爱丁杰 | 埃丁格 | edinger
德维尔 | 德韦尔 | deveulle
麦高兰 | 麦戈兰 | mcgauran
登帕赛 | 登帕西 | dempasay
金蒙斯 | 基蒙斯 | kimmons
鲍尔达扎 | 巴尔丹扎 | baldanza
马格尼 | 马格内 | magnay
法尔康布里奇 | 福尔肯布里奇 | falconbridge
马库斯 | 马克斯 | marcuss
米安 | 穆安 | muan
格林斯特德 | 格林斯蒂德 | grinstead
纳希曼 | 纳奇曼 | nacheman
林德尼斯 | 莱因德尼斯 | rhindness
贝里厄斯 | 贝里奥斯 | berrios
米多斯 | 梅多斯 | meadows
帕德西 | 帕齐 | pudsey
罗勒夫斯 | 罗卢夫斯 | rolufs
塞尔诺维奇 | 切尔诺维奇 | cernovitch
勒加特 | 莱格特 | legatt
尼科拉迪斯 | 尼古拉迪斯 | nikolaidis
戈利特利 | 戈莱特利 | golightly
芒尼克豪森 | 芒尼克海森 | munnikhuysen
休伊 | 舍韦 | schewe
麦奎金 | 麦克琼金 | mcjunkin
高蒂耶 | 高蒂尔 | gauthier
拉贝特 | 拉贝 | rabet
吉盖尔 | 吉格尔 | giguere
麦克法迪安 | 麦克法迪恩 | mcfadyean
马吉塔 | 玛吉塔 | margita
卢尼德 | 莉内德 | luned
科勒斯 | 科雷斯 | corace
科克兰 | 科克伦 | cochrane
布扎娜 | 布尔扎纳 | brzana
莫尔霍尔特 | 莫霍尔特 | molholt
埃尔尼 | 厄尼 | ernie
阿加西亚 | 阿加西娅 | agacia
塞蒙 | 瑟蒙 | sermon
布罗多斯基 | 布罗多夫斯基 | brodowski
克里茨 | 克赖茨 | crites
布兰特里 | 布伦特里 | braintree
钱伯尔森 | 钱伯辛 | chamberlsin
格青格 | 格青杰 | getsinger
欧韦特 | 艾尔薇特 | irvette
怀恩 | 温 | wyn
德尼奥 | 迪奈欧 | denio
基尔 | 基利 | kille
奥思内尔 | 奥塞内尔 | othenel
坦迪恩 | 坦丁 | tandien
马尼奥利亚 | 马格诺利娅 | magnolia
埃莱斯迈 | 埃尔斯米尔 | ellesmere
戴西 | 黛西 | daisy
戈迪夫 | 戈德夫 | godefe
布拉纳姆 | 布拉诺姆 | branom
沃塞海姆 | 沃特海姆 | wertheim
克里斯特戈 | 克里斯戈 | christgau
奥库因 | 奥库安 | aucoin
帕尼思 | 帕内思 | paneth
赫尔塔 | 许尔塔 | huerta
诺克伊 | 诺基 | norquoy
马克厄姆 | 梅卡姆 | makeham
希肯洛珀 | 希肯卢珀 | hickenlooper
巴尔塔萨 | 巴尔塔泽 | baltassar
杜克 | 杜凯 | duque
海尔卡 | 海尔基 | heilkay
泽比娜 | 泽拜纳 | zebina
麦卡纳尼 | 麦卡内尼 | mcaneney
布卢 | 布劳 | blough
格拉斯戈 | 格拉斯哥 | glasgow
赫钦格 | 赫金杰 | hechinger
哈恩迪 | 哈内迪 | harnedy
布拉斯内特 | 布拉斯尼特 | brasnett
奥利文特 | 奥利万特 | ollivant
戈洛芬科 | 戈洛夫琴科 | golovchenko
布利肯施塔夫 | 布利肯斯塔夫 | blickenstaff
麦克莱莫尔 | 麦克勒莫尔 | mclemore
德布勒勒 | 德布鲁勒 | debruler
麦克费德兰 | 麦克费德伦 | macphedran
奥迪盖尔 | 奥迪吉耶 | audigier
赫蒙 | 哈蒙 | hummon
伯特胡德 | 伯绍德 | berthoud
阿尔卡尔德 | 阿尔卡德 | alcalde
帕克特 | 帕赫特 | pachter
比奥利 | 比利 | beoley
戴恩 | 丁 | din
比塔 | 比塔尔 | bitar
麦克斯帕兰 | 麦克斯帕伦 | mcsparran
达尔威奇 | 达利奇 | dulwich
霍斯 | 豪斯 | howes
格罗塞斯特 | 格罗斯泰特 | grosseteste
施蒂布林 | 斯蒂贝林 | stiebeling
洛克希尔 | 洛希尔 | lochiel
弗雷埃尔 | 弗雷耶 | freyere
亨斯莱 | 亨斯利 | hensly
斯科菲尔德 | 舍恩菲尔德 | schonfield
斯托尔普曼 | 施托尔普曼 | stolpman
弗兰普欣 | 弗兰普申 | framption
博雷特 | 博里特 | borrett
米克尔霍翰 | 米克尔约翰 | meiklejohn
拉肯迈耶 | 拉肯米尔 | lackenmier
费切姆 | 费克姆 | feachem
拉卡帕涅 | 拉康帕涅 | lacampagne
索维奇 | 索瓦热 | sauvage
赫曼 | 赫尔曼 | herman
科帕德 | 科珀德 | coppard
斯塔尔斯 | 斯泰尔斯 | stares
韦格索 | 维格索 | vegso
巴思 | 巴特 | barthe
埃斯科菲 | 伊斯科菲 | escoffey
吉利亚姆 | 吉列姆 | gilliam
皮埃 | 皮埃尔 | pierre
博施威茨 | 博希威茨 | boschwitz
哈德格雷 | 哈迪格里 | hardegree
弗利特拉夫特 | 弗利特克拉夫特 | flitcraft
皮尔 | 珀尔 | pearl
阿丰索 | 阿方索 | alfonso
维拉雷尔 | 维拉里尔 | villarreal
伊格尔威奇 | 伊格尔维奇 | iglewicz
洛西安 | 洛西恩 | lowthian
多姆安 | 多米扬 | domjan
阿巴斯泰尼娅 | 阿巴斯蒂尼亚 | abastenia
阿利斯 | 阿莱斯 | allies
海伊泽 | 哈伊泽 | huyser
卡拉佩安 | 卡拉佩琴 | carapetyan
布里宁 | 布赖宁 | bryning
格利多尔 | 格利德尔 | gleadall
麦基恩 | 麦克钦 | mccheane
埃德尔 | 伊德尔 | eedle
布罗德伯特 | 布罗德本特 | broadbent
克拉布里 | 克拉布特里 | crabtree
埃里特 | 埃雷特 | ehret
特洛 | 特略 | tello
纽伯勒 | 纽伯格 | newburgh
威克斯蒂德 | 威克斯第德 | wicksteed
维克斯利基 | 维斯克洛斯基 | visclosky
斯科格拉德 | 斯科格隆 | skoglund
拉萨尔 | 拉萨 | lassar
贾夫 | 贾菲 | jaffe
斯塔姆 | 施塔姆 | stamm
法扎 | 法扎尔 | fazar
萨西妮 | 萨西尼 | sassienie
马塞尔 | 玛塞勒 | marcelle
苏斯特 | 图斯特 | touster
尤因斯 | 尤温斯 | uwins
塞赫尔斯基 | 切赫尔斯基 | cehelsky
达尔斯特龙 | 达尔斯特伦 | dahlstrom
康尼利 | 康奈利 | conneally
勒肯 | 卢肯 | lukken
德黑斯 | 德海斯 | dehayes
莫利纳利 | 莫利纳里 | molinari
希拉 | 夏伊拉 | shyla
比恩 | 比汉 | beehan
法尔肯海姆 | 福尔肯海姆 | falkenheim
哈努舍克 | 哈努谢克 | hanushek
德拉格塞特 | 德拉格施泰特 | dragstedt
洛恩 | 洛温 | lowen
德弗勒 | 德夫勒 | doerfler
伊利希 | 伊利格 | illig
贝默赛德 | 比默赛德 | bemersyde
米姆诺 | 明诺 | mimno
布平达 | 布平达尔 | bhupindar
罗明 | 罗梅因 | romeyn
布雷克斯佩尔 | 布雷克斯皮尔 | breakspear
扬赫斯本德 | 扬哈斯本 | younghusband
夏皮 | 沙比 | sharpey
莱西奇 | 勒萨热 | lesage
杰普瑟 | 杰普撒 | jeptha
巴布利斯 | 布勃利斯 | bublys
辛皮克 | 辛皮奇 | simpich
特德福德 | 塞德福德 | thedford
伯特霍尔夫 | 伯索夫 | bertholf
塞迪亚 | 切迪亚 | ceddia
沙特勒夫 | 舒特莱夫 | shurtleff
乔齐 | 乔茜 | jozy
利伯恩 | 莱伯恩 | laybourne
黛安 | 戴安 | dian
赞布鲁姆 | 赞布勒姆 | zambrum
劳克休夫 | 劳卡夫 | laukhuff
米尔希 | 米尔海 | milhy
卡德温 | 卡杜根 | cadwgan
博希尔 | 博舍尔 | boshier
斯克里伯 | 斯克赖伯 | scriber
博维 | 博韦 | bovee
赫克托 | 赫克通 | hektoen
莱维 | 利瓦伊 | levi
纳撒奈尔 | 纳撒内尔 | nathanael
克里 | 克雷 | crea
乔尔万 | 朱尔万 | joulwan
卡佐克里 | 库佐克雷亚 | cuzzocrea
阿德基森 | 阿基森 | adkisson
伊菲芬 | 伊菲吉妮 | iphigene
德比基 | 德比茨基 | debicki
泽费雷利 | 泽菲雷利 | zeffirelli
泰菲恩 | 泰维恩 | teifion
本杰曼 | 本杰明 | benjamin
菲施利斯 | 菲谢利斯 | fischelis
拉罗姆 | 拉勒姆 | larom
坎帕涅 | 坎佩恩 | campaigne
古茨怀勒 | 古茨维勒 | gutzwiller
马奎斯 | 马克斯 | marques
勒金 | 勒德金 | ludgin
阿尔皮娜 | 阿尔皮纳 | alpina
韦勒尔 | 沃雷尔 | werrell
福尔兹 | 福尔茨 | folz
德福德 | 德福特 | deford
齐耶尼基 | 齐尔尼基 | ziernicki
博比伯德 | 博比苏德 | bobisud
图尔 | 特尔 | tourle
图利特 | 塔利特 | tulett
斯塔克 | 斯图克 | stucke
尚伯格 | 舍恩伯格 | schonberger
兰贝利特 | 兰伯利特 | lambelet
盖 | 贾伊 | gye
利希滕斯坦 | 利克滕斯坦 | liechtenstein
安林 | 安格林 | anglin
安德鲁奎维奇 | 安德鲁斯克维奇 | andruskevich
托德里亚斯 | 托德雷亚斯 | todreas
布金 | 布尔金 | bourgin
泰林厄姆 | 蒂林厄姆 | tyringham
吉吉斯 | 吉格斯 | giggs
比 | 布埃 | bue
斯拉克斯 | 斯莱克斯 | slacks
阿维斯 | 阿维丝 | aveis
奎珀 | 凯珀 | kuiper
阿伦 | 阿龙 | aaron
马尔克斯 | 马尔库斯 | malkus
齐恩 | 蔡恩 | zion
格尔巴克 | 盖尔博 | gelbach
卢夫特 | 勒夫特 | luft
布雷克兰 | 布里克兰 | brekland
布亚哈拉 | 布阿哈拉 | buachalla
沃尔克 | 沃克 | walke
考特尼 | 考特妮 | kourtney
布洛格伦 | 布洛姆格伦 | blomgren
库尔 | 屈尔 | kuehl
比利尔 | 比埃 | billiere
埃尔杰 | 埃尔格 | elger
曼恩 | 曼 | mann
库利希 | 库利格 | kulig
麦戈纳尔 | 麦戈纳格尔 | mcgonagall
尼科利 | 尼古拉 | nicolay
塔图利斯 | 塔图尔斯 | tatooles
撒尔肯 | 萨尔肯 | thalken
基米特 | 金米特 | kimmitt
克罗斯门 | 克罗斯蒙 | croasmun
乔登斯 | 乔丹斯 | jordans
利萨特 | 利撒特 | leathart
赖津 | 里津 | ryzin
库德韦尔 | 库尔德韦尔 | couldwell
内马思 | 纳马思 | namath
索莱兹 | 索莱 | saulez
斯坦齐克 | 斯坦奇克 | stanczyk
布莱金登 | 布莱钦登 | blechynden
巴托尔缪约 | 巴托洛缪 | bartholemeu
塔尼娅 | 塔妮娅 | tania
柯克 | 瑟克 | cirker
德文特 | 德温特 | derwent
妮科尔 | 尼科尔 | nicolle
恩德科特 | 恩迪科特 | endecott
阿尔文 | 阿尔温 | alwin
豪塞尔 | 休塞尔 | heusel
莱弗勒 | 莱弗拉尔 | leflar
罗萨佩普 | 罗萨皮普 | rosapepe
赫宁伯格 | 赫宁堡 | heningburg
舍申斯坦 | 舍恩斯坦 | schoenstein
巴萨德 | 巴萨德雷 | basadre
塞勒斯 | 塞拉斯 | sellars
斯威策 | 斯韦策 | sweitzer
梅卢普斯 | 梅拉普斯 | mellups
巴尔西格 | 巴尔西杰 | balsiger
希拉伯 | 希莱伯 | shillaber
斯卡里斯特 | 斯卡尔普西特 | sculpsit
休马森 | 赫马森 | humason
斯特夫斯 | 斯特弗斯 | steffes
卡斯特伯里 | 卡斯尔伯里 | castelberry
贝克特 | 贝谢 | bechet
梅利奥尔 | 梅莉奥尔 | melior
赖恩 | 赖因 | rein
鲁马塞特 | 罗马塞特 | roumasset
布尔特 | 博尔特 | boult
克尔凯弗 | 克切弗 | kerchever
比阿特里亚 | 比阿特丽西娅 | beatricia
休尔 | 舒尔 | shure
凯格 | 基格 | keig
兹沃 | 兹瓦尔 | zwar
克伦西克 | 赫伦奇克 | chrencik
内莎 | 尼萨 | neysa
彭沃尔特 | 佩恩沃尔特 | pennwalt
米柳斯 | 米利厄斯 | milius
库塞维茨基 | 科乌谢维茨基 | koussevitzky
米尼奥 | 米内奥 | mineo
伊尔图德 | 伊尔蒂德 | illtud
弗罗泽 | 弗勒泽 | froese
赖伊尔 | 赖尔 | ryle
阿什利 | 阿什莉 | ashleigh
斯图扎 | 斯图尔扎 | stoorza
弗拉赫蒂 | 弗莱厄蒂 | flaherty
诺克斯 | 努克斯 | nokes
恰亚鲁奇 | 基亚鲁奇 | chiarucci
图尔默 | 瑟默 | thuermer
汉奇 | 汉格 | hange
舍戈尔斯 | 舍加尔斯 | shergals
贝特鲁普 | 贝格特鲁普 | begtrup
安巴德克 | 安贝德卡 | ambedkar
杜克努伊 | 迪克努瓦 | duquenoy
托里戈斯 | 托里霍斯 | torrijos
柯彻 | 基尔舍 | kircher
耶格 | 杰格 | jeger
马德里德 | 马德里 | madrid
多恩 | 唐 | donn
凯特尔比 | 基特尔比 | ketelbey
怀安特 | 威甘特 | wygant
博弗里 | 博韦里 | boverie
阿莱格拉 | 阿利格拉 | allegra
赖克沃特 | 里克沃特 | rykwert
奥法雷尔 | 奥法雷 | o'farrell
卢宁 | 吕宁 | luening
特金 | 图尔金 | turkin
蒂尔里 | 蒂里 | thierry
伊比 | 埃比 | ebby
阿斯富登 | 阿斯普登 | aspden
乔西 | 约瑟 | josee
施赖伯 | 施里伯 | shriber
迈斯兰 | 迈斯拉恩 | meislahn
格尔纳 | 盖尔纳 | gellner
森森尼奇 | 森塞尼奇 | sensenich
高因 | 高英 | gowing
本尼 | 贝恩 | benne
凯斯 | 库斯 | coes
斯库斯 | 斯丘斯 | skuce
舍内曼 | 舍尼曼 | schoeneman
穆斯 | 缪斯 | muse
哈伊克斯布鲁克 | 哈维克斯布罗克 | hawixbrock
冈亨利 | 贡希利 | goonhilly
霍尔蒂廷格 | 霍尔蒂万格 | haltiwanger
哈里尔 | 哈丽尔 | harriel
奎恩 | 奎因 | queen
塞塞尔 | 塞斯尔 | sessel
尼诺亚基斯 | 尼奥纳基斯 | nionakis
费尔马纳 | 费尔曼纳 | fairmaner
法伊斯 | 法伊尔斯 | fyles
阿尔西霍龙 | 阿尔西弗龙 | alciphron
达纳根 | 杜纳根 | dunagan
特雷西 | 特蕾西 | tracey
茹克 | 吉奥克 | giauque
库蒂斯 | 柯蒂斯 | kurtis
埃尼德 | 伊妮德 | enid
西金特 | 瑟金特 | searjeant
拉金 | 莱金 | laging
尚恩伯格 | 舍恩伯格 | schonberg
米切夫 | 米采夫 | mitseff
杰舒阿 | 杰舒亚 | jeshua
布兰钦 | 布兰昌 | blanchan
霍尔迪曼德 | 哈尔迪曼德 | haldimand
吉利亚斯 | 吉利亚姆 | guilliams
多奇 | 道奇 | dodge
斯威恩 | 斯温 | sween
弗赖赖希 | 弗赖雷克 | freireich
罗明格 | 罗明杰 | rominger
戈梅兹拉塔 | 戈梅斯普拉塔 | gomezplata
布吉瓦 | 布儒瓦 | bourgeois
安东尼欧 | 安东尼乌 | antoniou
奥利瓦里兹 | 奥利瓦雷斯 | olivarez
罗伊巴尔 | 罗伊鲍尔 | roybal
布什夫 | 布舒夫 | bushueff
萨吉蒂里厄斯 | 萨吉泰里厄斯 | sagittarius
比克 | 贝克 | beek
雷努亚德 | 伦瓦尔 | renouard
希拉斯 | 希勒斯 | heelas
卡尔克利 | 考尔德克拉夫 | caldcleugh
克拉格 | 克莱格 | clague
贾西娜 | 杰西纳 | jacyna
切希尔 | 切斯希尔 | chesshyre
布雷钦 | 布里金 | brechin
古德姆姆 | 古德哈姆 | gooderham
耶格 | 耶格尔 | yager
巴尔尼 | 鲍恩 | balne
霍普 | 霍伊普 | heup
格鲁丁德 | 格鲁辛德 | grusinde
博索克 | 博苏克 | borsook
施雷尔 | 施赖尔 | schreyer
阿达尼奇 | 阿德查尼克 | ardcharnich
贝迪利恩 | 贝迪利翁 | bedillion
斯迈思 | 史密斯 | smyth
里道特 | 赖德奥特 | rideout
麦考斯兰 | 麦考斯伦 | mcauslan
尼思代尔 | 尼斯代尔 | nithsdale
马托奥 | 马泰奥 | matteo
多罗西 | 多萝西 | dorothy
斯塔宾 | 斯图宾 | stubbing
索洛茨茨 | 索尔特斯 | solotesz
坎普什罗 | 坎普施罗尔 | kampschror
伦 | 莱恩 | len
德马托托 | 德马尔托 | desmarteau
马吉雷尔 | 马圭雷尔 | maguirel
希尔普 | 谢普 | shairp
格赖德 | 格雷德 | greider
伯兹尔 | 伯塞尔 | birdsell
克洛德纳 | 科洛德纳 | kolodner
索恩代克 | 桑代克 | thorndike
马沙姆 | 马香 | marsham
奥伯伯曼 | 奥伯黑尔曼 | oberhelman
帕特里亚克 | 佩特里亚克 | patriach
莱兹 | 莱什 | leisz
里卡兹 | 理查兹 | richards
艾奇森 | 艾奇逊 | eytchison
布里恩特 | 布赖恩特 | briant
科尔菲亚托 | 科菲亚托 | corfiato
科亚克 | 科哈克 | kohak
丹罗瑟 | 丹罗伊特 | dannreuther
巴恩比 | 巴恩贝 | barnebey
梅林达 | 梅琳达 | melinda
弗伦泽 | 弗伦策 | frenzer
康西尔 | 康斯尔 | council
谢因鲍姆 | 欣鲍姆 | sheinbaum
尚顿 | 桑顿 | szanton
戈德博勒 | 戈德伯勒 | goldborough
赫马尼克 | 赫马纽克 | hermaniuk
维思 | 韦思 | vaeth
拉泽 | 拉津 | razeen
埃尔万 | 埃尔温 | elwane
巴塔格尔 | 巴塔杰尔 | battagel
埃勒克 | 埃厄克 | earwaker
格林达尔 | 格林德尔 | grindal
贝克斯泰特 | 贝克施泰特 | beckstedt
贾科克特 | 贾科泰 | jacottet
布雷利 | 布里厄利 | brealey
麦科尚纳格 | 麦科尚奈格 | maco'shannaig
马克廷格 | 马赫廷格 | machtinger
康杰 | 康格 | conger
马米特 | 马梅特 | mamet
卡塞尔 | 卡瑟尔 | cuthell
迪尤斯 | 德威斯 | dewees
奥琳达 | 奥林达 | orinda
基茨哈伯 | 基察伯 | kitzhaber
布雷齐尔 | 布雷热 | brazier
斯米亚莱克 | 斯米亚利克 | smialek
里维特 | 里韦特 | rivet
奥尔迪 | 阿尔迪 | alday
阿曼德斯 | 阿曼达斯 | amandus
麦克塔纳根 | 麦克塔纳汉 | mctarnahan
赛纳 | 西纳尔 | synar
康科拉 | 康科勒 | concholar
杜纳利 | 达纳利 | dunalley
斯丘勒 | 朔伊勒 | scheuler
特鲁曼 | 杜鲁门 | truman
里卡西 | 里斯卡西 | riscassi
迪奥 | 德奥 | deo
拉思 | 雷思 | rathe
哈尔巴克 | 哈尔巴赫 | halbach
戈德温 | 戈尔德温 | goldwyn
劳特 | 鲁尔特 | rurt
赫利 | 赫尔利 | hurleigh
克罗嫩贝格 | 克罗嫩伯格 | kronenberg
尤斯顿 | 奥斯顿 | ouston
克里克顿 | 克赖顿 | crichton
格威尼德 | 格威内思 | gwynedd
科特 | 考特 | cawte
鲍奇 | 布谢 | bouchey
鲍尔斯 | 鲍威尔斯 | powels
艾萨克 | 艾萨克斯 | isaacs
安德里欧 | 安德里厄 | andrieux
阿莱恩 | 阿林 | alleine
纳夫诺夫 | 纳赫马诺夫 | nachmanoff
怀索基 | 维索茨基 | wysocki
艾尔布拉克特 | 艾尔布拉赫特 | eilbracht
亨尼 | 赫尼 | henie
诺伦 | 诺伦德 | norlund
萨里奇 | 瑟里奇 | surridge
杜尤 | 迪尤 | dew
唐西娅 | 唐西亚 | donsia
杜克罗 | 迪克罗 | ducrow
格雷根蒂 | 格雷甘蒂 | greganti
沃尔克 | 沃克 | walk
沃尔克 | 沃克 | walker
巴里厄斯 | 巴里奥斯 | barrios
麦科拉姆 | 麦科勒姆 | mccollam
斯坦达罗夫特 | 斯坦德洛夫特 | standaloft
西弗赖特 | 西夫赖特 | sievwright
莱恩斯 | 莱昂斯 | lyons
德沃查克 | 德沃夏克 | dvorchak
科赫伦 | 库格伦 | coughran
多克特 | 多克托 | docktor
弗朗塞斯 | 弗朗西斯 | fraunces
菲林 | 法林 | filene
巴戈 | 巴戈特 | bagot
拉尔 | 勒尔 | lull
希尔茨 | 希尔兹 | shields
希德尔 | 欣德尔 | schindell
埃弗舍德 | 埃弗谢德 | evershed
皮库普 | 皮卡普 | pickup
塞门扎 | 西门扎 | semenza
蒂克西 | 蒂克西尔 | tixier
沃尔拉特 | 沃尔拉思 | walrath
彼得龙 | 佩特龙 | petrone
格里桑蒂 | 格里桑迪 | grisanti
梅尔斯 | 马雷斯 | mares
庞蒂尼 | 庞特尼 | pounteney
安奈林 | 阿内林 | aneirin
冈利 | 高恩利 | gownley
劳本盖尔 | 劳本盖耶 | laubengayer
阿图鲁斯 | 阿图罗斯 | arturous
拉拉比 | 拉勒比 | larabee
埃斯坎达里安 | 伊斯坎达里安 | eskandarian
盖格 | 盖杰 | gager
科尔奎特 | 科尔基特 | colquitt
厄德博尔德 | 埃德博尔德 | eadbald
查宁 | 查嫩 | chanen
贝松 | 贝森 | bessone
塞科夫斯基 | 赛科夫斯基 | saikowski
塞格雷夫 | 西格雷夫 | segrave
苏伊代尔 | 舍代尔 | suirdale
哈莫尔 | 哈默 | hamor
博森沃思 | 博索姆沃思 | bosomworth
普佩 | 普珀 | puppe
施米德 | 施密德 | schmid
塔缪格尔 | 塔穆格尔 | tarmugl
黑尔 | 海尔 | haire
哈克威尔 | 黑克威尔 | hakewill
冈萨莱兹 | 冈萨雷斯 | gonzalez
莫纳 | 莫娜 | mona
格雷恩 | 格兰妮 | grainne
布里霍尔特 | 布赖霍尔特 | bryholdt
特鲁怀特 | 特鲁哈特 | trueheart
布拉斯特里特 | 布拉德斯特里特 | bradstreet
麦克斯蒂菲温 | 麦克斯蒂奥芬 | macstiofain
亚里莫维奇 | 雅里莫维奇 | yarymovych
塞尼奥尔 | 西尼尔 | senior
哈特赛德 | 哈齐德 | hartsid
博伊斯拉根 | 博勒根 | boisragon
雷伯特 | 雷巴特 | rebut
梅特罗莫利斯 | 梅特罗波利斯 | metropolis
索热 | 索热尔 | saussure
费里比 | 费尔比 | ferebee
斯克拉托托 | 斯克鲁泰特 | scrutator
格丽泽 | 格赖泽 | griser
黑泽利普 | 黑兹利普 | hazelip
布兰塞特 | 布兰西特 | blanscet
贝拉妮娅 | 贝拉尼亚 | berania
戈尔西蒙 | 戈德西蒙 | goldsymon
许尔霍尔兹 | 许霍尔茨 | schuerholz
威克泽 | 威克瑟 | wichser
科尔希普 | 科尔黑普 | kohlhepp
杰里什 | 格里什 | gerrish
博廷 | 博滕 | boateng
鲁伊科 | 罗科 | ruocco
加诺尔 | 加诺 | ganor
鲍德迪韦勒勒 | 巴尔德施维勒 | baldeschwieler
斯洛尼姆 | 斯洛宁 | slonim
马莎 | 玛莎 | martha
福内斯 | 福尼斯 | forness
鲍迪安 | 鲍德温 | bauduin
珀塞克 | 佩塞克 | perseck
维伦 | 瓦伊伦 | viron
皮尔森 | 皮尔逊 | pirsson
索尔茨 | 肖尔茨 | soults
埃弗沃德 | 埃瓦德 | evvard
格劳尔德 | 杰罗尔德 | gerould
杰尔 | 耶格 | jaegher
加弗 | 盖弗 | gaver
瑟金 | 西尔金 | sirkin
瓦伦苏埃拉 | 巴伦苏埃拉 | valenzuela
弗拉克斯 | 弗勒克斯 | flux
考斯利 | 库斯利 | cousley
特劳布里奇 | 特鲁布里奇 | troubridge
卡汉 | 卡亨 | kahane
阿达曼 | 阿达姆南 | adamnan
林恩 | 林 | linn
里查德 | 理查德 | richard
罗伯森 | 罗伯逊 | robertson
达肯 | 达坎 | dakan
吉查姆 | 吉彻姆 | gitsham
波佩 | 波波 | poepoe
利夫瓦克 | 莱夫奥克 | liveoak
范德霍夫 | 范德胡夫 | vanderhoof
普鲁斯曼 | 普拉斯曼 | prusman
基弗 | 凯弗 | keifer
吉根 | 吉亨 | gehan
施努肯 | 施努克内 | schnukne
梅杰 | 马杰 | mager
温纳斯特伦 | 温纳斯特鲁姆 | wennerstrum
伦德尔 | 伦达尔 | lundahl
利德克 | 利迪克 | luedecke
乔德雷 | 乔德尔 | jordre
普伦内克 | 普伦尼克 | pluenneke
赫莱特里特 | 赫什特里特 | hirschtritt
贝拉德 | 贝拉尔 | berard
威厄姆 | 威格姆 | wigham
马尔文农 | 马尔韦农 | mulvenon
巴特伦 | 巴特拉姆 | battram
麦吉因蒂 | 麦金蒂 | mcguinty
皮珀 | 派珀 | piper
卡莉什 | 卡利什 | kalish
埃冯代尔 | 埃文代尔 | avondale
德保 | 德波 | depauw
安尼斯 | 安妮斯 | annise
豪瑟姆 | 豪萨姆 | howsam
德沃尔金 | 德沃金 | dworkin
阿特尔西 | 阿特莱西 | attlesey
加格宾宾 | 加涅班 | gagnebin
霍 | 豪 | howe
布莱克施米特 | 布莱希施米特 | blechschmidt
赫维茨 | 赫威茨 | herwitz
梅恩斯 | 梅因斯 | mains
布卢克 | 布劳克 | blouke
梅明格 | 梅明杰 | memminger
马塔拉索 | 马塔拉佐 | matarazzo
德莱斯克 | 德赖斯克 | dreiske
费布里斯 | 法布里斯 | fabris
普赖尔 | 普里尔 | preil
贝伊克 | 贝尤克 | bayuk
科奈罗 | 科内罗 | corneiro
奎伦 | 奎林 | quillen
图尔斯 | 托尔斯 | towers
贝思 | 贝丝 | beth
比尔霍特 | 伯霍尔特 | byrholdt
约赫 | 约埃 | yohe
亚特伦 | 亚特隆 | yatron
斯凯姆 | 斯基姆 | skym
格瓦尔托斯基 | 格瓦尔托夫斯基 | gewartowski
布思利 | 布思莱 | buthlay
里伊塔 | 里乌塔 | riutta
普伦蒂 | 普朗蒂 | prunty
奥洛克林 | 奥劳克林 | o'laughlin
马奥拉斯 | 马约拉斯 | mayoras
维西 | 维齐 | veysey
施塔尔 | 斯塔尔 | stahl
沃尔斯塔克罗夫特 | 沃斯通克拉夫特 | wollstonecraft
阿曼 | 阿尔曼 | arman
阿德尼 | 埃德尼 | adney
芬维西 | 芬韦西 | fenvessy
帕奇 | 帕克 | pach
内瑟塞尔 | 内瑟索尔 | nethersole
盖尔德 | 格尔德 | gelder
萨森 | 萨瑟恩 | southern
佩皮厄特 | 佩皮奥特 | pepiot
巴哈尔 | 巴卡尔 | bachar
奥尔博 | 阿尔博 | allbaugh
盖米特 | 加梅特 | gamet
德利贾戈斯 | 德利乔治斯 | deligiorgis
加雷尔 | 加勒尔 | garel
奥尔 | 奥利 | ole
巴德威恩 | 布德温 | budwine
迪奥 | 戴奥 | dio
布罗尔施 | 布勒尔施 | broelsch
塞维尔 | 萨维尔 | savele
莱维 | 利维 | levie
格龙基 | 格朗茨基 | groncki
加孔 | 加肯 | garcon
丹姆里希 | 德姆里克 | daemmrich
肖尔德勒 | 斯科德勒 | scholderer
迪比 | 达比 | duby
贝尔比 | 比尔比 | beilby
博斯金德 | 博斯坎德 | boskind
阿尼斯 | 安妮斯 | anis
阿布林 | 埃布林 | ablin
班德 | 班德尔 | bander
罗萨尔 | 罗塞尔 | rossall
谢德 | 沙德 | shad
埃奇逊 | 艾奇逊 | etcheson
福塞特 | 福西特 | fawssett
奥拉芙 | 奥拉夫 | olave
莫菲 | 莫夫 | maufe
阿加斯 | 阿加丝 | agase
阿蒂耶 | 阿提耶 | atiyeh
伦芬特 | 朗方 | lenfant
尤弗罗森 | 尤弗罗西尼 | euphrosyne
杰里米亚 | 杰里迈亚 | jeremiah
梅恩林 | 梅因沃林 | mainwaring
彼得里兹 | 佩特里迪斯 | petrides
科德尔 | 科德 | corder
戴文 | 达文 | davern
罗赞妮 | 罗珊 | rozanne
霍利 | 豪利 | howley
格林霍 | 格里诺 | greenhow
格利摩 | 格利穆尔 | glymour
霍施卡 | 豪施卡 | hauschka
戈歇尔 | 戈查尔 | gotshal
蔡斯 | 谢斯 | shays
埃莉娜 | 埃琳娜 | elena
布雷德 | 布里德 | breder
埃克斯特拉特 | 埃克斯特拉克特 | ekstract
麦加恩 | 麦加亨 | mcgahern
勒班 | 莱班 | leban
穆拉尔特 | 缪拉尔持 | muralt
萨洛姆 | 萨洛米 | salome
玛丽萨 | 马里萨 | marisa
肖纳 | 肖娜 | shauna
克鲁什什 | 克鲁伊什 | kerruish
沙帕 | 沙帕尔 | shapar
劳杰杰 | 劳因格 | lauinger
尤金尼娅 | 尤金妮亚 | eugenia
梅德沃夫斯基 | 梅德瓦多夫斯基 | medwadowski
希厄特 | 海厄特 | hieatt
科德尔 | 科格德尔 | cogdell
特里巴瑟 | 特里布沃瑟 | triebwasser
惠奇利夫 | 惠特克利夫 | whitchliffe
卡利尔 | 卡莱尔 | carlisle
约弗里达 | 朱弗里达 | giuffrida
怀森 | 威森 | wison
德谢特 | 德克特 | dechert
德夫尼 | 迪夫尼 | deveney
戈斯基 | 戈尔斯基 | gorski
海姆索特 | 海姆塞特 | heimsoth
希伯德 | 希巴德 | hibbard
盖斯特菲尔德 | 盖斯特费尔德 | geistfeld
塔利亚罗罗 | 托利弗 | taliaferro
蒂特勒 | 泰特勒 | tytler
埃博罗尔 | 埃博拉尔 | eborall
莱塞特 | 莱西特 | lycett
莱贡 | 利根 | lygon
奥利克西 | 奥莱克休 | oleksiw
阿莱兹 | 阿莱 | allez
卡德瓦雷沃 | 卡德瓦拉德 | cadwaladyr
萨尔文 | 西尔温 | sulwen
谢德尔 | 沙德尔 | shadel
坦克蕾托 | 坦克雷托 | tancreto
法迪安 | 法迪恩 | fadyean
伯克隆 | 伯克伦 | berklund
德雷南 | 德雷宁 | drennen
德彻尔 | 德谢尔 | decher
巴特伦 | 巴特拉姆 | buttram
特鲁齐 | 特拉齐 | truzzi
阿布迪安 | 阿布迪恩 | abdian
蒙特莫罗诺 | 蒙特莫雷诺 | montemoreno
托里 | 托丽 | tori
卡里洛 | 卡里略 | carrillo
马西纳 | 马塞纳 | marthena
凯利 | 卡利 | cali
波兰 | 波伦 | pollan
