布雷金里奇 | 布雷肯里奇 | breckinridge
锡德 | 切德 | cedd
拉比里 | 拉巴里 | labaree
梅莉 | 马利 | maly
阿尔西尼加 | 阿西涅加 | arciniega
斯特拉思撒 | 斯特拉森 | strathearn
皮内 | 皮奈 | pinay
梅雷斯曼 | 米尔斯曼 | meresman
弗兰宗 | 弗兰曾 | franzon
伊兹比基 | 伊兹比茨基 | izbicky
埃哈维斯特 | 埃沙韦斯特 | echaveste
费尔伯恩 | 费尔贝恩 | fairbairn
穆尔黑德 | 缪尔黑德 | muirhead
沃塞尔 | 瓦塞尔 | wassell
麦卡加 | 麦卡格 | mccargar
西金特 | 萨金特 | seargent
亨巴克 | 亨巴赫 | heimbach
基布勒 | 库布勒 | kuebler
纳尔迪 | 纳迪 | nardi
杰米马 | 杰迈玛 | jemima
莫杜 | 莫德维 | mauduit
艾耶特 | 艾厄特 | eyet
耶尔德利 | 亚德利 | yeardley
博比 | 鲍比 | bobbie
凯勒 | 塞勒 | celler
麦基尔文娜 | 麦基尔温纳 | macilvenna
麦克费伦 | 麦克弗伦 | mcpherren
博查尔 | 博索尔 | botsal
科勒雷恩 | 科尔雷因 | coleraine
瓦格尼 | 韦恩 | wagne
多特曼 | 多伊特曼 | deutermann
厄德曼 | 厄尔德曼 | erdman
戈伦拜夫斯基 | 戈伦别夫斯基 | golembiewski
格雷戈伊尔 | 格雷瓜尔 | gregoire
米卡亚 | 迈凯亚 | micajah
莱德洛 | 莱德劳 | laidlaw
雷马克斯 | 拉马克斯 | raemakers
皮凯弗 | 皮卡弗 | piccaver
苏布林 | 萨布林 | subrin
范德勒 | 坦德勒 | tandler
津嫩 | 津宁 | zinnen
费登 | 法登 | faden
布盖兹 | 布尔盖兹 | bourgaize
佩莱蒂尔 | 佩尔蒂埃 | pelletier
帕塞尔 | 帕斯尔 | parcel
霍诺里 | 霍诺丽 | honori
伊梅希 | 伊梅施 | imesch
埃尔托黑德 | 埃尔顿黑德 | eltonhead
西明顿 | 赛明顿 | symington
马豪 | 玛奥 | mahault
奥达斯 | 奥杜斯 | audus
沃伊蒂克 | 沃伊蒂奇 | woytych
韦克特尔 | 瓦赫特尔 | wachtel
夏弗尔 | 希维尔 | shivell
马基南 | 马基嫩 | makinen
拉凯斯 | 拉雪兹 | lachaise
达伦 | 达龙 | daron
格肯斯 | 格尔肯斯 | gehrkens
达维格多 | 达维多尔 | d'avigdor
加莱夫 | 加利夫 | galef
玛吉 | 马吉 | magi
达文 | 达温 | darwen
曼纳韦 | 马纳韦 | mannaway
梅恩 | 米恩 | meighen
基利 | 基利亚 | killea
伊泽德 | 伊佐德 | izod
图伊马 | 托伊马 | teuma
奥赫 | 奥 | ough
阿福特 | 阿富尔蒂特 | affourtit
米泽尔 | 米赛尔 | misael
赫默里希 | 亨默里克 | hemmerich
海伍德 | 希伍德 | heawood
詹宁斯 | 杰宁斯 | jenyns
斯塔姆斯 | 斯泰姆斯 | stames
塔伦斯 | 塔兰斯 | tarrance
比贝 | 毕比 | beebe
考尔德尔 | 考德尔 | caldell
博查特 | 博哈特 | borchardt
卡明 | 卡迈恩 | carmine
巴特伦 | 巴特拉姆 | bartram
派尔 | 皮尔 | peile
麦康 | 麦肯 | mccon
沙克伯勒 | 舒克伯勒 | schuckburgh
麦卡里 | 麦凯里 | mccarey
布罗克 | 布勒克 | broecker
英芬特 | 因方特 | infant
卡赫 | 卡尔 | karrh
盖弗 | 贾埃弗 | giaever
珍米 | 杰米 | jamie
鲍尔霍恩 | 巴尔霍恩 | ballhorn
斯特吉斯 | 斯特奇斯 | sturges
莫克萨姆 | 莫克塞姆 | moxam
米德尔巴什 | 米德尔布什 | middlebush
阿什敦 | 阿什当 | ashdown
卡姆 | 卡尔姆 | culme
希尔曼 | 沙伊尔曼 | shireman
梅索利 | 梅索伊 | meszoly
福伊希特万 | 福伊希特万格 | feuchtwanger
埃森斯 | 埃森丝 | essence
格瓦思梅 | 格瓦思米 | gwathmey
卢布 | 利比 | luebbe
黑泽尔 | 黑兹尔 | hazell
克莱农 | 克勒农 | clernon
金德雷德 | 金德里德 | kindred
德鲁夫 | 德鲁伊夫 | druiff
纽索尔 | 纳托尔 | nuthall
戴 | 戴伊 | daigh
埃泰因 | 埃泰恩 | etain
德尔罗戈 | 德尔列戈 | delriego
巴策 | 巴策尔 | batzer
艾什纳 | 艾斯纳 | eiszner
莱思科特 | 利思科特 | lythcott
廷肯 | 廷康 | tinkon
德弗雷特斯 | 迪弗雷特斯 | defrates
奥尔文厄姆 | 阿尔文厄姆 | alvingham
尤拉姆 | 乌拉姆 | ulam
德罗利 | 德劳利 | drowley
迪多 | 德多 | dedow
梅恩斯 | 默恩斯 | mearns
拜勒勒姆 | 拜勒姆 | byerrum
蒂利 | 泰利 | tiley
格罗布 | 格罗比 | grobe
塔塔利诺 | 塔尔塔利诺 | tartaglino
亚历山大 | 达历山大 | d'alexander
兰布 | 拉姆 | lambe
卡德韦尔 | 考德威尔 | caldwell
泽米娜 | 泽米纳 | zemina
赫莉 | 赫利 | helie
坎特伯里 | 坎特伯雷 | canterbury
塔肯 | 泰肯 | tacon
基尔施 | 基尔希 | kirsch
古特穆特 | 古特穆思 | gutermuth
托皮 | 托毕 | torpey
梅拉尼 | 梅拉妮 | melanie
泰奇曼 | 泰克曼 | teichmann
普拉德霍姆 | 普鲁多姆 | prudhomme
基斯特纳西 | 基斯特纳萨米 | kistnasamy
坎比 | 坎贝 | cumbey
赫姆尔 | 赫姆利 | hermle
弗罗门泰尔 | 弗罗曼蒂尔 | fromanteel
蒙冈 | 蒙贡 | mongon
图特尔 | 泰特尔 | tytell
亨佩尔 | 亨普尔 | hempel
埃罗 | 艾罗尔特 | ayrault
赖蒂娜 | 赖蒂纳 | rytina
里亚 | 雷 | rea
伊基 | 埃基 | ecky
德洛吉 | 德路易吉 | deluigi
科切雷斯 | 科克里斯 | cocheres
霍斯伯格 | 霍斯伯勒 | horsburgh
拉德 | 鲁阿兹 | ruadh
克拉伯 | 克莱伯 | klaber
格里思黑德 | 格雷特黑德 | greathead
马尔特比 | 莫尔特比 | maltby
埃塞蕾达 | 埃塞丽达 | ethelreda
巴特韦尔 | 贝特韦尔 | batewell
巴伦斯 | 巴兰斯 | barans
迪恩娜 | 迪恩纳 | dienna
博里尔 | 博雷尔 | boreel
布雷恩 | 布里恩 | brehon
久尔 | 圭尔 | guire
约丘克 | 尤尔丘克 | yurchuck
坦尼肯 | 滕尼肯 | tennican
勒文 | 莱文 | levene
克拉特 | 克鲁特 | krutter
克拉里斯 | 克拉雷斯 | clares
朱林科 | 祖林科 | dzurinko
奇普林斯基 | 西普林斯基 | cieplinski
索茹纳 | 索杰纳 | sojourner
布鲁豪森 | 布鲁克豪森 | bruchhausen
克努贝尔 | 努贝尔 | knubel
卡诺琴 | 卡诺坎 | carnochan
吉内诺 | 吉赫诺 | giheno
罗克珊 | 罗克西娜 | roxinne
伦塞莱尔 | 伦塞勒 | rensselaer
比哈里尔 | 贝哈里尔 | beharriell
朗彻姆 | 朗香 | longchamp
贝德纳斯基 | 贝德纳尔斯基 | bednarski
伯勒德 | 伯拉德 | burrard
赫洛韦尔 | 赫拉韦尔 | hellawell
佩奇 | 佩什 | peche
洛伦兹 | 洛伦茨 | lorenz
劳夫特 | 卢夫特 | looft
雷蒙 | 里蒙 | reamon
特波尔 | 蒂普尔 | tepoel
盖莫 | 贾伊莫 | giaimo
库尔杰安 | 库尔金 | kuljian
吉勒特 | 吉利特 | guillet
哈米利恩 | 哈米里恩 | hamilyon
利恩娜 | 利安娜 | leanne
格雷克 | 古雷克 | gureck
马特 | 马蒂尔 | mateer
里森诺沃 | 里曾诺弗 | reasonover
查根 | 查康 | chacon
里布塞门 | 里布萨门 | rebsamen
托尔菲琴 | 托菲肯 | torphichen
布利克多弗 | 布利肯斯德弗 | blickensderfer
戈索尔斯 | 戈瑟尔斯 | goethals
海特姆 | 哈特姆 | hatem
霍勒克斯 | 霍拉克斯 | horrax
古尔蒂里 | 瓜尔蒂耶里 | gualtieri
泽兰 | 齐伦 | zeran
比贝尔 | 比布尔 | biebel
西门斯 | 西门子 | siemens
普利本 | 普利邦 | plybon
佩伊夫 | 帕耶夫 | payeff
斯温斯鲁德 | 斯温斯拉德 | swensrud
贝克纳 | 比克纳 | beichner
恩格霍尔姆 | 恩格霍姆 | engholm
杜尤斯 | 德瓦斯 | dewas
兰内伯格 | 兰恩伯格 | ranneberger
桑德威克 | 桑威克 | sandwick
威思 | 韦思 | wyeth
施魏菲尔德 | 施韦柴尔德 | schweichild
斯坦霍普 | 斯坦诺普 | stanhope
英沃兹塔德 | 英沃斯塔德 | ingvoldstad
森戈尔 | 桑戈尔 | senghor
克伦布尔 | 克伦巴尔 | krumbhaar
莫拉尔 | 莫勒 | morar
安格尔迈耶 | 安格尔迈尔 | anglemire
路易齐 | 路易西 | louisy
弗里利 | 弗赖利 | friley
赖兰斯 | 赖伦斯 | rylance
赫斯莱普 | 赫斯利普 | heslep
比尔茨 | 比尔兹 | beards
哈扎德 | 哈泽德 | hazard
达梅舍克 | 达梅谢克 | dameshek
穆谢特 | 马希特 | mushet
布鲁姆利 | 布伦利 | brumley
比尔特 | 伯特 | birt
明 | 米恩 | min
菲格雷斯 | 菲格斯 | figures
特克姆西 | 特库姆塞 | tecumseh
谢巴兹 | 沙巴兹 | shabazz
伊万杰丝塔 | 埃万杰利斯塔 | evangelista
韦布利 | 韦伯利 | webley
帕门蒂尔 | 帕尔芒捷 | parmentier
迪因利斯 | 迪安杰利斯 | deangelis
汉伦 | 汉兰 | hanlan
格里诺沃特 | 格里纳沃尔特 | greenawalt
麦格拉里里奇 | 麦格拉斯里克 | macglasrich
索恩顿 | 桑顿 | thornton
巴洛克 | 巴洛赫 | balloch
切尔尼斯基 | 切尔涅斯基 | chernesky
贝勒韦 | 贝尔维 | bellevue
布劳恩 | 布朗 | braun
赫雷黑尼克 | 赫雷查尼克 | hrechanyk
霍夫 | 豪夫 | hauf
特里利文 | 特里莱文 | treleaven
阿文特 | 埃文特 | avent
比斯内尔 | 比尤内尔 | buesnel
阿迪 | 埃迪 | adye
哈格迈耶 | 哈格迈尔 | hagemeyer
凯希娅 | 凯蒂娅 | katia
阿拉蒙 | 阿拉芒 | allamong
西米恩 | 西明 | siemien
罗万德 | 罗安德 | rowand
普里亚尔 | 普赖尔 | prial
布利萨克 | 布利萨茨 | blisac
比兹 | 比德兹 | bidez
厄威尔 | 厄维尔 | irwil
威尔米特 | 薇尔梅特 | wilmett
贝尔 | 比尔 | beale
波伊特 | 波因特 | poynter
纳兰乔 | 纳兰霍 | naranjo
布雷兰 | 布里兰 | breland
阿曼纳齐 | 阿马纳齐 | armanazi
卡尼特 | 卡内特 | kanet
卡尔 | 卡利 | karle
阿德莉娜 | 阿德利娜 | adelina
斯特尔特 | 斯泰尔特 | stelter
门恩韦尔 | 米恩韦尔 | meanwell
沙克伯格 | 沙克伯勒 | shuckburgh
特雷芬西斯 | 特里富西斯 | trefusis
亚历山森 | 亚历山德森 | alexanderson
科克伦 | 科克兰 | cockran
格尔 | 瓜尔 | guare
朱皮特 | 丘辟特 | jupiter
德特里奇 | 多伊特里希 | deutrich
托厄里 | 托尔里 | towery
威舍 | 维舍 | wischer
肖茨 | 肖恩茨 | shontz
戴加 | 迪格 | dygard
巴利克 | 巴利奇 | balich
库比特 | 丘比特 | cubitt
福尔迪西 | 福尔德西 | foldessy
西克雷斯特 | 西克里斯特 | secrest
柯尔斯 | 库尔斯 | coors
拉扎 | 拉扎尔 | lazar
麦高恩 | 麦古恩 | macgoun
佩茨 | 皮特斯 | petes
皮克斯 | 皮尔克斯 | pearkes
费尔哈文 | 费尔黑文 | fairhaven
孔特林曼 | 康特里曼 | countryman
祖斯洛夫 | 扎斯洛夫 | zaslove
索恩伯格 | 索恩伯勒 | thornburgh
特里德加尔 | 特里迪加 | tredegar
埃瑟 | 阿瑟 | acer
阿蒂高尔 | 阿蒂格尔 | attygalle
蒙戈马利 | 蒙哥马利 | montgomerie
马西娅 | 玛西娅 | mathea
费布勒 | 法布勒 | fabler
彼得鲁斯卡卡 | 彼特鲁斯卡 | petruska
弗恩 | 维恩 | verne
约迪切洛 | 尤迪塞洛 | iudicello
韦姆 | 瓦伊姆 | waim
鲁兰 | 鲁伦 | ruellan
拉赫特 | 拉克特 | lachter
拉哈布 | 雷哈布 | rahab
麦金纳尼 | 麦基纳尼 | macinerney
埃根 | 伊根 | egan
斯蒂格勒 | 施蒂格勒 | stigler
特威宁 | 特文宁 | twining
乌尔夫 | 厄尔夫 | ulph
西达勒斯 | 西达劳斯 | sidarouss
弗洛韦尤 | 弗劳尔迪 | flowerdew
盖兰 | 格兰 | gellan
吉梅内斯 | 希门尼斯 | jimenez
伍尔纳 | 沃尔纳 | woellner
德翁特 | 德温特 | dewint
科尔帕齐 | 科帕齐 | corpazzi
斯威特曼 | 斯韦特曼 | sweatman
加米齐 | 加梅齐 | garmezy
布鲁因 | 布勒因 | bruyn
塔米赫尔 | 塔米希尔 | tamihere
库劳 | 库罗 | courau
迪莫奥 | 迪梅奥 | dimeo
贝尼迪克斯 | 贝内迪克斯 | benedicus
柯蒂尼厄斯 | 柯特纽斯 | curtenius
阿斯丘思 | 阿斯奎思 | asquith
赫利娜 | 赫莉娜 | helina
伊特拉格 | 伊泰拉格 | itteilag
斯特朗奇 | 斯特朗 | stronge
埃沃伊 | 伊沃伊 | evoy
迪伦福思 | 迪伦弗思 | dyhrenfurth
特鲁塞尔 | 特拉塞尔 | trussel
坦韦 | 坦圭 | tanguay
贝克特 | 本克特 | benkert
波克 | 普克 | pook
杜布拉斯 | 杜布拉 | dubras
亚兹明 | 亚斯明 | yazmin
劳德代尔 | 劳德戴尔 | lauderdale
伯贝奇 | 伯比奇 | burbage
哈斯卢普 | 哈斯勒普 | haslup
泽纳 | 策纳 | zaehner
波洛斯 | 普洛斯 | poulos
卢万多 | 柳安多 | lewando
麦克沃尼什 | 麦克瓦尼什 | macvarnish
休林斯 | 赫林斯 | hulings
施尼特 | 施奈特 | schneiter
弗里岑 | 弗里曾 | fritzen
麦克米切尔 | 麦克迈克尔 | mcmichael
贝尔希 | 贝尔赫 | bailhe
斯库克罗夫特 | 斯考克罗夫特 | scowcroft
麦卡尔 | 麦考尔 | mackal
奥尔曼 | 阿利芒 | allemang
塞奇 | 赛什 | saich
旺克 | 沃恩克 | warnke
皮奥特罗夫斯基 | 彼得罗夫斯基 | piotrowski
贾恩 | 扬 | jahn
康纳尔顿 | 康高尔顿 | congalton
乌尔默 | 厄尔默 | ulmer
杜瓦克斯 | 杜阿克斯 | duax
沙特克 | 沙滕柯克 | schattenkerk
盖尔特纳 | 盖特纳 | gaertner
库尔尔 | 库尔德尔 | kuldell
法隆 | 法伦 | falloon
克莱本 | 克莱伯恩 | clyburn
奥斯维 | 奥斯威尤 | oswiu
兰德维西 | 兰德沃西 | landwirthy
索锡 | 索西 | southee
米隆 | 米伦 | millon
特特尔 | 瑟特尔 | thurtle
艾丽 | 艾莉 | eily
埃克恩 | 伊肯 | ekern
菲利恩 | 菲利翁 | filion
斯派克 | 斯平克 | spink
赞皮耶 | 赞皮耶洛 | zampiello
肖申 | 舒尚 | shooshan
莫普斯 | 莫皮斯 | moppes
帕塞尔 | 帕斯尔 | parcell
蒂巴尔特 | 蒂博尔特 | tybalt
索尔 | 苏尔 | soul
德雷维斯 | 德雷夫斯 | dreves
吕尔 | 卢尔 | lure
德迪奥 | 戴德奥 | dedeo
蒂达 | 西达 | theda
麦克雷思 | 麦克勒思 | mackereth
奥瑟 | 奥泽 | orser
帕珀马斯特 | 佩珀马斯特 | papermaster
贝伦德斯 | 贝伦兹 | berendes
施雷德 | 施拉德 | schrade
切斯特 | 奇斯特 | chiste
伯克 | 比尔克 | birck
斯潘金 | 斯庞金 | spungin
科尔金斯 | 考尔金斯 | caulkins
巴索尔森 | 巴托尔松 | bartholdson
麦克斯波兰 | 麦克斯波伦 | macsporran
英格林 | 英林 | yingling
库普里尔 | 卡普里尔 | cuprill
沙努廷 | 查纽廷 | chanutin
埃塞克 | 伊塞克 | esek
梅尔霍弗 | 迈尔霍费尔 | maierhofer
德普勒格 | 德普卢格 | derploog
唐利维 | 唐拉维 | donlavey
弗赖希特 | 弗赖海特 | freiheit
马伦普尔 | 马伦普雷 | malempre
德施 | 德奇 | doetsch
阿雷顿 | 阿里顿 | arreton
贝哈 | 贝亚 | beha
埃斯特斯 | 埃斯蒂斯 | estes
肯尼 | 森尼 | cenni
博多 | 波尔多 | bordeaux
德西德里厄斯 | 德西迪里厄斯 | desiderius
塔尔戈特 | 索尔戈特 | thalgott
考特 | 柯特 | curt
切克奇安 | 彻克齐安 | cherkezian
马尼尔 | 马尼耶 | magnier
阿特林厄姆 | 奥特林厄姆 | altrincham
艾尔纳姆 | 埃努姆 | aernum
戈卢布 | 戈勒布 | gollub
麦基尔雷维 | 麦基雷维 | macilrevie
艾肯雷琳 | 艾肯格林 | eichengreen
莱夫勒 | 莱弗勒 | leffler
加鲁菲斯 | 加劳菲斯 | garaufis
拉文 | 雷文 | raven
黑文纳 | 哈文纳 | havenner
多尔兹 | 德尔兹 | doelz
莫布斯比 | 莫布兹比 | mobsby
赛雷斯 | 西尔斯 | cyres
西波伦 | 西波隆 | cipollone
阿奎约 | 阿夸约 | aquayo
赛丝 | 赛斯 | sise
帕尔马利夫 | 帕尔莫利夫 | palmolive
弗雷林厄森 | 弗里林海森 | frelinghuysen
帕杰利斯 | 帕盖利斯 | pargellis
莱普尔 | 勒普尔 | lepoer
布雷斯洛夫斯基 | 布雷斯拉夫斯基 | breslawsky
博尼法修斯 | 博尼费修斯 | bonifacius
达夫尼 | 达夫妮 | daphne
麦克利夫 | 麦克拉夫 | mcclave
罗曾塔尔斯 | 罗森塔尔斯 | rozentals
费尔霍尔姆 | 费尔霍姆 | fairholme
麦肯基 | 麦康希 | macconchy
桑德姆 | 桑达姆 | sandham
马宁 | 曼宁 | maning
布莱赫特 | 布拉胡特 | blachut
赫明 | 亨明 | hemming
蒂夫文达姆 | 蒂文加杜姆 | tirvengadum
杰内罗 | 吉尼罗 | genero
比斯特 | 比伊斯特 | buist
拉马莫尔 | 拉腊莫尔 | laramore
德里南 | 德赖南 | drynan
海克 | 黑克 | hake
哈沙根 | 哈舍根 | hashagen
杰威克 | 格威克 | gerwick
赖阿尔斯 | 赖亚尔斯 | ryalls
特里梅因 | 特里曼 | tremain
梅伦 | 默龙 | merron
范德利德 | 范德克利德 | vanderkleed
汉斯伯格 | 亨斯伯格 | hunsberger
格鲁科特 | 格劳科特 | groucott
鲁兹 | 吕埃 | ruez
拉德布罗克 | 拉德布鲁克 | ladbroke
休斯蒂格 | 卢斯蒂格 | luistig
奥斯莱格 | 奥恩斯莱格 | oenslager
哈加丁 | 哈格丁 | hargadine
利克姆 | 利克希姆 | leikhim
沃切夫特 | 沃特沙夫特 | wirtschafter
伊默斯 | 伊穆斯 | imus
托赫 | 托克 | toch
德翁特 | 德温特 | dewenter
加瓦尔特 | 加沃尔特 | gawalt
哈雷尔 | 哈勒尔 | harrel
斯普勒 | 施普勒 | spuhler
阿马尼 | 阿尔马尼 | armani
弗莱布 | 弗莱比 | flebbe
汤姆斯 | 图姆斯 | tombs
达夫隆 | 杜弗隆 | duflon
梅罗维奇 | 迈罗维奇 | meirovitch
泰伊 | 赛伊 | thye
克里斯梅尼奇 | 克里斯马尼奇 | crismanich
本恩 | 本 | benn
梅纳厄姆 | 梅纳汉 | menaham
米尔哈姆 | 米勒姆 | millham
麦基利肯 | 麦基利坎 | mackillican
多里 | 多丽 | dorrie
法努夫 | 法纳夫 | faneuf
科尔克拉瑟 | 科尔克拉泽 | colclaser
洛温克龙 | 洛温克伦 | lowenkron
多罗 | 多拉夫 | dorough
鲍尼尔 | 巴尼尔 | balniel
菲林 | 法尔林 | firing
克莱姆 | 克莱米 | klemme
费尔 | 费雷 | ferre
菲沙蒂 | 菲谢蒂 | fischetti
安娜贝尔 | 安娜贝勒 | annabelle
福齐 | 福西 | feusi
赞伯格 | 宗伯格 | zumberg
萨加 | 塞格尔 | sagar
恩格兰 | 英格兰 | england
诺特 | 纽特 | newt
林克 | 伦克 | renk
塔尔曼 | 托尔曼 | tallman
阿布 | 阿贝 | abbe
博伊斯丰丁 | 博伊斯方丹 | boisfontaine
麦卡哈蒂 | 麦克哈蒂 | mccahearty
麦克门 | 麦克蒙 | mcmunn
塞弗里 | 萨弗里 | savery
韦斯特摩兰 | 威斯特摩兰 | westmoreland
伯格哈德 | 伯格哈特 | burghard
埃尔普 | 厄普 | earp
蒙多尔 | 蒙多 | mondor
格尔泽 | 盖尔泽 | gelzer
斯塔布尔菲尔德 | 斯塔布菲尔德 | stubblefield
弗皮勒 | 韦皮勒 | verpilleux
布罗克特 | 布勒克特 | broekert
戴安门特 | 迪亚门特 | diament
汤南德 | 汤恩德 | townend
艾内斯 | 伊内兹 | inez
杰彭 | 杰波恩 | jepoen
伯肯霍尔茨 | 伯肯霍尔兹 | birkenholtz
默蒂斯 | 默特斯 | mertes
勒克特 | 勒基特 | luckett
斯珀拉 | 斯珀尔 | spurr
埃德 | 伊德尔 | eader
维诺格拉德 | 维诺格勒 | vinograd
安纳莫尔 | 安纳克莫尔 | annaghmore
斯塔德曼 | 斯蒂德曼 | studeman
莱利恩 | 勒林 | lelean
布里森 | 布赖森 | bridson
扎克利 | 朱克利 | zuckley
皮尔斯廷 | 皮里斯坦 | pearistine
拉尚 | 拉申 | raschen
马达维奇 | 马达维赫 | mhadavikh
戈洛布 | 戈卢布 | golub
伊尔格里茨 | 伊尔根弗里茨 | ilgenfritz
杜拉克 | 杜拉奇 | dullach
佐尔德 | 索尔德 | szold
杜普卡克 | 杜普恰克 | dupcak
布雷登 | 布拉顿 | bradon
贝姆 | 巴姆 | bame
莱西 | 利西 | leisy
普利马尔 | 普莱梅尔 | plymale
布罗梅特 | 布罗米特 | bromet
皮科维亚克 | 皮乔维亚克 | piechowiak
欧纳 | 沃纳 | woerner
奥雷斯卡 | 奥雷斯坎 | orescan
惠特伯格 | 惠特伯勒 | whitburgh
西比尔 | 塞比尔 | sebire
法法勒 | 法伊勒 | pfeiler
霍莫尔卡 | 霍穆尔卡 | homolka
海斯伯格 | 海斯堡 | heisborg
费尔德布里尔 | 费德布里尔 | feldbrill
杰农 | 热农 | gernon
斯邦特 | 斯坦特 | stunt
埃利斯 | 埃莉丝 | elyse
朗利 | 伦利 | lungley
克罗勒 | 克雷勒 | kroehler
谢米宁 | 切米宁特 | cheminint
迪本 | 德本 | deben
克赖扎 | 克里扎 | kryza
沃林 | 瓦林 | wahlin
布根 | 巴根 | bugan
佩奇 | 皮奇 | pechey
马戈德 | 马格福德 | mugford
施瓦姆 | 施万布 | schwamb
麦克米切尔 | 麦克迈克尔 | macmichael
奥奥里 | 奥赖 | ory
艾尔弗里克 | 阿尔弗里克 | aelfric
艾尔加 | 艾尔格 | eylgar
耶 | 伊 | yee
桑纳曼 | 索恩曼 | sonnemann
奥赞妮 | 奥赞 | ozanne
德黑 | 德哈恩 | dehaan
雷诺 | 雷纳 | raynor
贝克哈特 | 贝克哈德 | beckhard
松塔格 | 桑塔格 | sontag
麦克尔霍蒙 | 麦克尔哈农 | mcelhanon
梅赞 | 马赞 | mazan
麦康 | 梅肯 | macon
德拉丰斯 | 德拉方斯 | delafons
戴维 | 达维 | davee
戈希 | 戈伊 | gohey
克莱弗 | 克拉弗 | claver
桑瑟姆 | 桑森 | sansum
吉吉 | 吉盖 | giggey
达科姆 | 戴科姆 | dacombe
邦廷 | 邦坦 | bontein
多本 | 多宾 | doben
格穆特 | 格穆思 | germuth
泰恩什 | 坦什 | tainsh
克雷斯皮尼 | 克雷皮尼 | crespigny
休梅尔森 | 休梅尔辛 | humelsine
马夸里 | 麦夸里 | maquarie
比尔基 | 伯基 | buerki
斯沃迪 | 斯沃德什 | swadesh
巴贝尔 | 贝布尔 | babell
博德温 | 博德瓦恩 | bordwine
布朗塔斯 | 布龙塔斯 | brountas
迈尔森 | 迈耶森 | mayerson
德雷沃贾拉 | 德沃尔吉拉 | drevorguilla
科特兰 | 柯特兰 | kirtland
奥弗拉哈蒂 | 奥弗莱厄蒂 | o'flahertie
塞维 | 西维 | sevey
博克尔 | 博克 | boker
麦克内罗 | 麦肯罗 | mcenroe
埃肖 | 埃舒 | eshoo
马金卡斯 | 马辛克斯 | marcinkus
佩雷兹 | 佩雷斯 | perez
蒂利 | 蒂莉 | tillie
赖格 | 里格 | riger
阿利森 | 艾莉森 | alyson
德雷塞尔 | 德雷斯尔 | dressel
朱利 | 朱莉 | julie
丹尼恩 | 达尼恩 | danyon
希克 | 舍克 | shirk
马休伦 | 马胡兰 | mahuran
齐 | 切赫 | czeh
西尔瓦纳斯 | 西尔维纳斯 | silvanus
埃克斯坦斯 | 埃克斯滕斯 | exstance
艾尼斯 | 安斯 | aines
普桑特里 | 普萨泰里 | pusateri
尼恩 | 奈恩 | nyhen
霍里修斯 | 霍雷修斯 | horatius
克利瑟 | 克莱瑟 | cleather
阿里迪厄斯 | 阿拉迪厄斯 | aradius
阿格内洛 | 阿涅洛 | agnello
伊莱 | 艾莱 | ilay
纳西 | 纳休 | nathiew
休达克 | 赫达克 | hudak
麦凯尔弗里什 | 麦克尔弗里什 | macelfrish
塞西利厄斯 | 塞西莉厄斯 | cecilius
伍纳科特 | 旺纳科特 | wonnacott
尤 | 约 | yoe
哈姆斯 | 黑姆斯 | hammes
雷贝尔 | 里贝尔 | rebel
查格尔斯 | 查格利斯 | chagles
格里博诺 | 格里布诺 | griebenow
肖厄尔 | 肖尔 | schauer
加南吉安 | 加南吉扬 | ganangiyan
泰特 | 廷特 | tynte
古拉德 | 戈拉德 | goulard
格罗杰 | 格罗格 | grogger
布里斯 | 布赖斯 | brise
洛林达 | 洛琳达 | lorinda
怀特利瑟 | 怀特莱瑟 | whiteleather
埃夫勒 | 埃弗勒 | effler
罗亚利 | 罗亚尔 | royale
惠西特 | 惠特西特 | whitsett
明图恩 | 明特恩 | minturn
赫德克 | 赫德基 | hedke
瓦斯默 | 沃斯默 | wasmer
勒克龙 | 莱克龙 | leckrone
布雷斯纳恩 | 布雷斯纳汉 | bresnahan
波 | 鲍 | pow
拉克索尔 | 拉克斯尔 | wraxhall
曼柳斯 | 曼利厄斯 | manlius
莱托克 | 勒托克 | letocq
谢拉格 | 希拉 | shelagh
内格尔 | 尼格尔 | negel
乔弗里翁 | 乔夫里翁 | joffrion
罗克特 | 罗基特 | rockett
伯恩 | 贝尼 | boehne
格鲁尔 | 格劳尔 | grouer
德沃拉克 | 德沃夏克 | dvorak
马乔斯 | 梅杰斯 | majors
福伊尔克 | 福伊尔沃克 | feuerwerker
塔吉 | 塔姬 | taggy
麦科克 | 麦科奇 | mccoch
蒂默韦尔 | 泰姆韦尔 | timewell
巴克纳 | 巴赫纳 | bachner
蒂格雷特 | 泰格雷特 | tigrett
卡迪奥 | 卡迪厄 | cadieux
纳蒂 | 克努蒂 | knutti
凯嫩 | 凯南 | kainen
德普特克 | 德普塔克 | deptuck
莱 | 利 | ley
格尔 | 吉尔 | gehl
阿利布兰德多 | 阿利布兰多 | alibrando
唐纳姆 | 多纳姆 | donham
利德福 | 利德福德 | lydford
希彻尔 | 希切尔 | hitchell
科南 | 科奈恩 | conein
法雷尔 | 法勒 | farer
格雷博 | 格里博 | grebow
弗里斯 | 弗雷斯 | frece
朗莱因 | 朗莱恩 | longhlein
德林斯基 | 德克林斯基 | deklinski
埃勒斯 | 埃利斯 | elles
德斯巴拉茨 | 德巴拉茨 | desbarats
克兰多尔 | 克兰德尔 | crandall
卡尼尔尼 | 卡奈尔尼 | carnearney
坦嫩鲍姆 | 特南鲍姆 | tennenbaum
霍金 | 霍根 | hodgan
卡基亚 | 卡夏 | cachia
莫森 | 莫桑 | morsan
阿加里斯 | 阿吉里斯 | argeris
明内特 | 明妮特 | minnette
斯坦卡德 | 斯顿卡德 | stunkard
安斯帕彻 | 安斯帕赫尔 | anspacher
贾西诺夫斯基 | 贾西诺斯基 | jasinowski
克雷弗 | 克里弗 | crever
沃尔休夫 | 瓦尔塞奥夫 | waltheof
拉帕亚诺 | 拉普阿诺 | rapuano
托比特 | 托贝特 | torbett
谢弗斯 | 查弗斯 | chavers
安德雷斯 | 安德烈斯 | andress
埃尔斯皮 | 伊丽莎白 | elspie
哈根 | 黑根 | hagan
麦卡拉克 | 麦柯拉克 | maccurrach
凯特林萨克 | 卡特林萨克 | katrinsak
托普尔 | 托佩尔 | topple
塔姆斯 | 泰晤士 | thames
巴查特 | 布查特 | butchart
斯维克 | 斯韦克 | svec
肯奈尔德 | 肯奈德 | kennaird
勒克拉斯 | 勒克拉 | lecras
安德琳 | 安德林 | andelin
艾克纳 | 艾希纳 | eichner
费鲁 | 费劳 | ferrao
奥弗拉哈蒂 | 奥弗莱厄蒂 | o'flaherty
克里恩 | 克林 | crean
萨马罗 | 萨马鲁 | samaroo
卡赫特 | 卡彻特 | kachert
伯杰文 | 伯格文 | bergevin
珀克 | 珀基 | pyrke
恩布林 | 恩布琳 | emblin
卡尔索普 | 考尔索普 | calthorpe
西森 | 特森 | thesen
吉尔德豪姆 | 吉尔多姆 | guildhaume
埃尤 | 埃维尤 | evjue
贾斯珀 | 贾斯帕 | jaspar
威尔科夫斯基 | 维尔科夫斯基 | wilkowski
法尼伊尔 | 法纳尔 | faneuil
伯尼特 | 伯内特 | burnett
里查特 | 理查特 | richart
朗尼加 | 朗内加 | runnegar
卡萨 | 卡撒 | cartha
扬格尔 | 扬格 | younger
多尔格 | 德尔格 | dolger
希尔密斯 | 希尔史密斯 | shearsmith
赫贝斯特里特 | 赫布斯特雷特 | herbestreit
香肯 | 尚肯 | shanken
沙克 | 舒克 | schuck
克拉姆 | 克鲁姆 | krumm
凯伦 | 克伦 | keren
鲍金 | 鲍德金 | baudkin
迪林 | 迪尔林 | deerlin
科森 | 科瑟恩 | cothern
埃尔韦斯 | 埃尔威斯 | elwes
泰沃 | 塔沃尔 | tavor
韦赫 | 韦伊尔 | weiher
维特 | 维特尔 | vetter
赫米恩 | 赫米奥娜 | hermione
约翰森 | 约翰逊 | johnson
杭德里奇 | 杭德里克 | honderich
劳格林 | 劳克林 | laughlin
利伯廷 | 利伯蒂娜 | libertine
达莱佩兹 | 达莱佩泽 | dallepezze
迈尔斯特拉普 | 迈尔斯特勒普 | meilstrup
朗斯莱蒂斯 | 朗斯利特斯 | launceletus
埃德利 | 埃德尔 | ederle
阿迪奥 | 阿德奥 | addeo
科莫尼亚克 | 科莫尼亚雷克 | komoniarek
德拉罗 | 德拉鲁 | delarue
格恩斯巴克 | 根斯巴克 | gernsback
马兹拉夫 | 马兹卢夫 | marzluf
蒂托 | 蒂特 | teetor
比尔 | 伯尔 | birr
邓坎森 | 邓肯森 | duncanson
格拉迪厄斯 | 格拉迪厄 | gladieux
高迪安 | 高迪恩 | gaudian
迪尔 | 代尔 | diel
菲茨韦伦 | 菲茨沃伦 | fitzwarren
迪思里希 | 迪特里希 | diethrich
德黑 | 德海 | dehay
唐齐 | 当齐 | dauntsey
沃索 | 瓦索 | wasow
霍沃思 | 豪沃思 | howarth
吉尔迪 | 吉亚尔迪 | ghiardi
阿拉姆 | 奥勒姆 | allam
博迪科姆 | 博迪库姆 | bodycombe
施韦姆 | 施韦布 | schwelb
伊泽诺尔 | 艾泽努尔 | izenour
布尔 | 布雷 | buhre
雷纳尔夫 | 雷纳夫 | ranulph
帕尼特 | 帕内特 | panet
罗尼 | 龙尼 | ronne
伊尔格 | 伊尔克 | ilg
查森 | 蔡森 | chasen
科佩拉 | 科皮拉 | coppela
茹拉贝安 | 朱拉布奇安 | joorabchian
斯拉特里 | 斯莱特里 | slattery
弗雷克利顿 | 弗雷克尔顿 | freckleton
图罗 | 陶罗 | tauro
埃尔马思 | 厄马思 | earmarth
希拉克 | 希莱克 | shillaker
诺斯 | 克瑙斯 | knause
梅约 | 梅奥 | mayo
安蒂维尔 | 安特维尔 | antevil
基珀斯 | 凯珀斯 | kuipers
梅恩多尔德 | 梅因唐纳德 | maindonald
麦卡勒里 | 麦卡利里 | mcalery
哈兹尔廷 | 黑兹尔坦 | hazeltine
斯莱茨 | 斯卢茨 | slutz
迈希尔 | 迈伊尔 | mighill
赫曼 | 希曼 | heman
布罗瑟 | 布拉泽 | brother
赛恩 | 锡恩 | thynne
多克沃拉 | 多克拉 | dockwra
莱滕代尔 | 勒滕德 | letendre
杰斯 | 杰西 | jesse
海恩特 | 海因特 | heinte
格温福弗 | 格温弗 | gwynfor
利夫斯克 | 莱韦斯克 | levesque
奥德里 | 奥德丽 | audrey
约瓦诺维奇 | 约万诺维奇 | yovanovitch
派尤什 | 皮尤什 | piyush
安德烈尔 | 安德里奥尔 | andriole
丹尼罗 | 达尼罗 | daniero
因奇凯 | 英奇昆 | inchiquin
勒彭内克 | 勒佩内克 | lepennec
赛义德 | 赛德 | side
多南菲尔德 | 多宁费尔德 | donenfeld
沃尔德雷普 | 沃尔德里普 | waldrep
德马西奥 | 德马肖 | demascio
穆科夫斯基 | 穆科斯基 | mukowski
泽谢拉 | 泽克拉 | zechella
卡莉 | 凯莉 | kallie
斯凯特 | 斯卡特 | skate
麦吉尔福 | 麦吉尔伍尔 | macgillvoor
博古德 | 布古尔 | bougourd
塞文 | 西文 | sevin
欣恩 | 希恩 | shinn
庞南帕拉姆 | 庞南佩鲁马 | ponnamperuma
米曾 | 迈曾 | mizen
拉梅尔 | 隆梅尔 | lommel
穆雷恩 | 穆兰 | murane
马赫 | 马奇 | much
金尼弗 | 珍妮弗 | gennifer
查萨尼斯 | 沙萨涅 | chassagnes
厄尔利 | 厄利 | earley
布鲁德 | 鲍赫鲁德 | boughrood
吉隆 | 吉伦 | gillon
多沃德 | 道尔德 | doward
贝尼诺夫 | 贝尼奥夫 | benioff
基尔里 | 基里 | kearey
瓦克 | 瓦克尔 | wacker
卢易祖 | 路易祖 | louizou
弗兰兹 | 弗朗兹 | franz
特里菲尼迪斯 | 特里福尼迪斯 | trifonidis
米泽尔 | 米泽勒 | mizelle
托雷斯 | 托里斯 | torres
沃利本 | 沃莱本 | wohlleben
福尔茨格拉夫 | 法尔茨格拉夫 | pfaltzgraff
沃申科 | 瓦申科 | washenko
博尼特 | 博内特 | bonett
戴沃尔 | 达沃尔 | davol
伊利特 | 艾利特 | ilett
多伊施 | 多伊施尔 | deuschl
马库斯 | 马库塞 | marcuse
厄明格 | 艾尔明格 | irminger
阿伦 | 艾伦 | allen
布杰克 | 布亚克 | bujake
斯泰特 | 斯滕特 | stent
约瑟姆 | 乔撒姆 | jotham
古卡斯 | 古奥卡斯 | guokas
科萨塔 | 科苏塔 | cossutta
费滕 | 法滕 | phaten
杜尔费 | 德菲 | durfee
克里维利 | 克里韦利 | crivelli
菲策尔温 | 菲茨艾尔温 | fitzailwyn
埃迪生 | 埃迪森 | eddison
加雷特 | 加勒特 | garret
登宁 | 丹宁 | denning
斯维里斯 | 斯威里斯 | sweeris
比利尤 | 比利厄 | bilyeu
马杰 | 马季 | marj
哈纳姆 | 汉纳姆 | hannum
布加斯 | 巴加斯 | bugas
埃奇达尔 | 埃奇代尔 | edgedal
凯伊 | 基 | key
林德斯滕 | 林斯滕 | lindsten
本内特 | 贝内特 | bennete
贝拉尔 | 伯罗尔 | berall
凯特伦 | 卡特伦 | catron
斯威特凯 | 斯威凯 | switkay
布里哈特 | 布里尔哈特 | brillhart
索布洛夫 | 索贝洛夫 | sobeloff
兹巴斯基 | 兹巴尔斯基 | zbarskiy
德尔克森 | 德克森 | dirksen
贝格尔 | 贝尔 | beighle
梅奥 | 梅约 | maio
麦卡利基 | 麦卡利克西 | mcaliksey
苏伊利尔 | 特威利尔 | thuillier
弗兰西斯科 | 弗朗西斯科 | francisco
科德 | 科尔德 | coard
德加拉比迪安 | 德加拉贝迪安 | dergarabedian
戈特奇韦 | 戈特格特鲁 | gottgetereu
赫伦布兰德 | 海伦布兰德 | hellenbrand
厄布 | 厄尔布 | erb
吉妮 | 吉尼 | genee
西西 | 锡西 | cissie
莱兰 | 利兰 | lelland
弗雷德丽卡 | 弗雷德里卡 | fredrica
温泽尔 | 温策尔 | wenzel
巴蒙特 | 贝蒙特 | bamont
奥尔德希泽 | 奥尔迪泽 | aldhizer
姆利纳西克 | 姆利纳奇克 | mlinarchik
贝格尔 | 比格尔 | begel
德尔 | 杜尔 | durr
米齐 | 梅齐 | meazey
格鲁乔 | 格劳乔 | groucho
普拉亨 | 普拉欣 | prahin
迪伦福思 | 迪伦弗思 | dhyrenfurth
扬克威奇 | 扬克维奇 | yankwich
萨格曼 | 塞奇曼 | sageman
库达希 | 卡达希 | cudahy
克凯维尔 | 克切维尔 | kercheville
德西雷 | 德西蕾 | desiree
凯利 | 丘利 | kewley
迪德 | 戴德 | dyde
乔瑟林 | 乔斯林 | josselyn
考德拉 | 夸德拉 | cuadra
休什 | 休伊什 | huish
德保米耶 | 德波米耶 | depommier
拜恩 | 拜昂 | bion
加哈根 | 加黑根 | gahagen
麦金托夫 | 麦金塔夫 | mcinturff
莫法德 | 莫维兹 | morfudd
桑克利 | 尚克利 | sankley
罗梅因 | 罗曼 | romaine
凯米 | 卡米 | camy
西马拉 | 赛马拉 | saemala
维斯坦 | 威斯坦 | wystan
博德威恩 | 鲍德温 | bodwine
勒斯 | 卢斯 | luss
尼普迈尔 | 尼普迈耶 | knipmeyer
昂斯 | 奥恩斯 | owns
鲍科姆 | 鲍库姆 | bawcombe
查伦格 | 查林杰 | challenger
塞特 | 撒特 | thaete
赛伊 | 西赫 | sih
弗兰西娅 | 弗朗西亚 | francia
亨特雷斯 | 亨特里斯 | huntress
图乌苏南 | 蒂乌萨宁 | tiusanen
特里布 | 特赖布 | tribe
迈尔德文 | 米尔德文 | mildvan
阿尼尼 | 阿内尼 | aneny
马斯曼 | 穆斯曼 | mussman
恩德斯 | 恩德雷斯 | endres
克龙 | 克罗姆 | cromb
沃朗德 | 沃尔龙德 | walrond
蒙塔文 | 蒙塔冯 | montavon
萨奇 | 萨特杰 | satge
杰龙 | 吉伦 | gearon
贾尼斯 | 贾尼西 | janisse
比基特 | 比克特 | bicket
迪西 | 达西 | duthie
加汉 | 加恩 | gahan
希索姆 | 希瑟姆 | heesom
德雷波 | 德拉珀 | drapeau
霍加特 | 霍贾特 | hodgart
德斯博瓦 | 德布瓦 | desbois
考斯兰 | 库斯兰 | cousland
斯韦布 | 斯韦比 | swaebe
弗鲁伊特 | 弗鲁特 | fruit
伊利恩 | 伊尔伦 | illearn
阿布洛姆 | 阿布隆 | ablom
博尔加塔 | 博加塔 | borgatta
埃斯梅尔 | 伊斯梅尔 | esmail
沃滕伯格 | 瓦滕伯格 | wattenberg
安东尼斯 | 安图尼斯 | antunes
阿迪内特 | 阿迪尼特 | adinet
邓科姆 | 邓库姆 | duncombe
迪克 | 迪克尔 | dicker
德塞 | 德瑟 | desser
格贝尔 | 格巴尔 | geballe
豪耶莱贝克 | 胡尔贝克 | houiellebecq
布希 | 布舍 | busche
卡梅尔福德 | 卡姆尔福德 | camelford
卢金贝尔 | 卢金比尔 | lukingbeal
比伊 | 布伊 | buie
埃斯特哈 | 埃斯特海 | esterhai
马尔欣恩 | 马尔夏恩 | mulshine
埃莱克拉 | 伊莱克特拉 | electra
德普尔 | 德佩尔 | doepel
查费茨 | 查菲茨 | chafetz
瑟米厄斯 | 瑟缪斯 | sermeus
德根特 | 德甘特 | degandt
安德里斯 | 安德雷斯 | anderes
耶曼斯 | 伊曼斯 | yeamans
伊卡 | 伊坎 | icahn
里尔 | 鲁埃尔 | reuel
桑恩 | 图恩 | thun
劳恩斯伯里 | 朗斯伯里 | lonsbury
海森 | 希森 | hyson
沃姆索 | 沃姆泽 | wormsor
吉诺尔 | 格瑙尔 | genauer
默里 | 缪里 | murie
克莱夫 | 克拉夫 | clave
蒙东纳 | 蒙顿纳 | montonna
卡莎 | 卡沙 | kasha
利多姆 | 利德姆 | leedom
马拉布尔 | 梅拉伯 | malabre
苏里纳 | 苏雷纳 | surena
雷德尼斯 | 雷德尼厄斯 | redenius
迪尔基 | 德基 | durkee
马比 | 梅比 | mabie
埃伊拉 | 埃斯拉 | esra
利希特沃特 | 利希特瓦尔特 | lichtwardt
加恩斯 | 加农斯 | garnons
奥弗罗尔 | 奥费拉尔 | o'ferrall
马琴 | 梅琴 | machen
希登 | 黑登 | headon
沃默 | 沃尔默 | wolmer
塔舍罗 | 塔什罗 | taschereau
安纳尼 | 阿纳尼 | anany
克劳斯 | 克卢斯 | clews
福尔维 | 法尔维 | falvey
德拉德 | 达拉德 | durrad
查蓬 | 沙蓬 | chapone
柯普夫曼 | 柯夫曼 | curfman
蒂拉西娅 | 特拉西娅 | therasia
林迪 | 琳迪 | lynndie
多纳莫尔 | 多诺莫尔 | donoughmore
奇德尔 | 切德尔 | chedell
艾利 | 艾尔利 | airlie
甘博萨 | 甘博亚 | gamboa
巴蒂兹尔 | 巴蒂扎尔 | bartizal
康伯 | 库默 | comber
赫施 | 胡希 | husch
阿克利 | 埃克利 | akeley
尤泽 | 尤伊泽 | ueyser
奥拉 | 奥尔拉 | orla
西拉 | 赛拉 | thyra
卡丹 | 卡登 | kadane
埃弗伯里 | 埃夫伯里 | avebury
维拉巴博斯 | 比利亚洛沃斯 | villalobos
卢什 | 勒什 | lush
迪达姆 | 迪德姆 | deedham
纳尔 | 诺尔 | nall
迪克迈尼耶 | 杜克米尼尔 | dukeminier
斯特朗伯格 | 斯特龙伯格 | stromberg
格维茨 | 格威茨 | gurwitz
宾克 | 本克 | benke
德梅特 | 德梅特尔 | demaitre
哈特内特 | 哈特尼特 | hartnett
科夫 | 科普夫 | kopf
海因菲尔德 | 汉费尔德 | hainfeld
沃拉 | 瓦拉 | walla
埃尔德姆姆 | 埃尔德姆 | ealdhelm
斯坦内克 | 斯托尔内克 | stalnecker
马格里 | 马格丽 | margery
德尔韦斯 | 德尔夫斯 | delves
贝尔沃德 | 贝瓦尔德 | baerwald
盖伊 | 贾伊 | ghey
莱姆斯 | 里姆斯 | rheims
蒙特科姆 | 蒙特卡姆 | montcalm
费罗兹 | 费罗祖德 | ferozud
普拉杰 | 普拉奇 | plugge
基埃阿 | 凯乔 | kejoa
博斯顿 | 波士顿 | boston
费克塔基蒂 | 费克特库蒂 | feketekuty
赫芬 | 赫法恩 | huffine
瑟希 | 塞希 | sershey
拉克克里思 | 拉克斯弗里思 | laxfrith
塞利格曼 | 塞利希曼 | seligmann
加韦德 | 加维德 | gaved
科奇尼希 | 科奇尼格 | kotschnig
斯特伦洛 | 斯特里姆劳 | stremlau
德罗姆高尔 | 德罗姆古尔 | dromgoole
拜尔 | 贝耶尔 | beier
马钱洛尼斯 | 马查洛尼斯 | marchalonis
瑟瓦克 | 瑟瓦奇 | serwach
阿塞林 | 阿斯林 | acelin
杰肯斯 | 格肯斯 | gerckens
阿菲 | 埃菲 | afee
西德博特姆 | 赛德博特姆 | sidebotham
格德 | 格尔德 | gerd
埃克洛夫 | 埃克勒夫 | eklof
芬格勒 | 芬勒 | fengler
豪恩谢尔 | 霍恩谢尔 | hounshell
奥因 | 约恩 | eoin
索 | 托 | thau
赛妮 | 西妮 | sydni
法克托 | 法克特 | factor
赖内基特 | 赖内克特 | reinecket
德西德拉思 | 德西德蕾塔 | desiderata
朱埃特 | 朱厄特 | jouett
布龙克 | 布朗克 | bronk
班顿 | 贝恩顿 | baynton
约克威廉斯 | 约克威廉 | yorkwilliams
弗拉利克 | 弗雷利克 | fralick
维奇滕 | 维克滕 | vechten
瑟纳 | 塞尔纳 | serna
伦宁 | 伦南 | lennen
罗格特 | 罗热 | roget
弗雷伊 | 弗雷 | frej
伊登 | 艾登 | idden
杰塞里奇 | 杰塞里克 | jeserich
希格内特 | 希格尼特 | hignett
杜庞特 | 杜邦 | dupont
克利姆克 | 克利姆基 | klimcke
赫尔布利 | 赫布尔 | helble
比尔布罗 | 比尔伯勒 | bilbrough
斯温托 | 斯温特 | swintor
特拉皮耶 | 特拉皮尔 | trapier
伦德罗 | 伦德弗罗 | rendfrow
布里斯宾 | 布里斯本 | brisben
昂布赖特 | 昂布里特 | umbreit
凯格 | 凯加鲁 | caegarw
萨姆斯塔格 | 扎姆斯塔格 | samstag
麦克诺杰 | 麦克诺尔 | mcnaugher
贾格斯 | 贾格尔斯 | jaggers
凯克 | 西克 | cyker
凯斯 | 基斯 | keys
赫吉伊 | 赫吉 | hegyi
萨基纳 | 萨金娜 | sakinah
勒福恩 | 勒方 | lefaune
拉夫肖 | 拉夫肖恩 | rafshoon
休曼 | 舒曼 | shuman
贝曼 | 比曼 | beman
西弗特 | 索伊弗特 | seufert
斯坦纳姆 | 斯塔纳姆 | stanham
麦克沃登 | 麦克瓦登 | mcvadon
阿克蒂翁 | 埃克申 | action
梅延沙因 | 梅恩沙因 | maienschein
齐米曼 | 齐梅曼 | zimmeman
桑兹 | 桑德斯 | sondes
法奇 | 富奇 | fudge
穆普森 | 马普森 | mupson
奥克林科斯 | 奥金克洛斯 | auchincloss
埃尔利 | 埃尔勒 | ehrle
勒克赫斯特 | 卢克赫斯特 | luckhurst
纳伯斯 | 内伯斯 | nabors
卡罗尔 | 卡萝尔 | carole
埃丁杰 | 埃丁格 | edinger
德维尔 | 德韦尔 | deveulle
麦高兰 | 麦戈兰 | mcgauran
福尔库布里奇 | 福尔肯布里奇 | falconbridge
马库斯 | 马克斯 | marcuss
格林斯特德 | 格林斯蒂德 | grinstead
阿尔文 | 奥尔文 | allvine
林德尼斯 | 莱因德尼斯 | rhindness
米多斯 | 梅多斯 | meadows
帕德西 | 帕齐 | pudsey
汉德瓦格 | 汉德沃格 | handwerger
塞诺维奇 | 切尔诺维奇 | cernovitch
莱加特 | 莱格特 | legatt
尼科莱迪斯 | 尼古拉迪斯 | nikolaidis
戈利特利 | 戈莱特利 | golightly
芒尼基森 | 芒尼克海森 | munnikhuysen
奇尔德 | 蔡尔德 | child
杰科威茨 | 尤尔科维茨 | jurkowitz
休 | 舍韦 | schewe
麦钦金 | 麦克琼金 | mcjunkin
拉比特 | 拉贝 | rabet
彭特 | 庞特 | punter
麦克法迪安 | 麦克法迪恩 | mcfadyean
卢内德 | 莉内德 | luned
乔莫 | 肖莫 | chomeau
科克兰 | 科克伦 | cochrane
布扎纳 | 布尔扎纳 | brzana
莫尔霍尔特 | 莫霍尔特 | molholt
阿加西亚 | 阿加西娅 | agacia
梅佩尔 | 马佩尔 | mapel
西克斯 | 赛克斯 | sikes
布罗多斯基 | 布罗多夫斯基 | brodowski
克里茨 | 克赖茨 | crites
布兰特里 | 布伦特里 | braintree
钱伯尔辛 | 钱伯辛 | chamberlsin
格青格 | 格青杰 | getsinger
英格尔比 | 英吉尔比 | ingilby
厄韦特 | 艾尔薇特 | irvette
德尼奥 | 迪奈欧 | denio
基尔 | 基利 | kille
奥思内尔 | 奥塞内尔 | othenel
坦迪恩 | 坦丁 | tandien
福克斯 | 富克斯 | fooks
马尼奥利亚 | 马格诺利娅 | magnolia
索瑟登 | 萨瑟登 | southerden
埃莱斯米尔 | 埃尔斯米尔 | ellesmere
戴西 | 黛西 | daisy
戈德菲 | 戈德夫 | godefe
沃瑟姆 | 沃特海姆 | wertheim
克里斯特加 | 克里斯戈 | christgau
奥科因 | 奥库安 | aucoin
彼得罗 | 佩特罗 | petro
诺库伊 | 诺基 | norquoy
米克沃 | 米克瓦 | mikva
梅克厄姆 | 梅卡姆 | makeham
斯特拉布里奇 | 斯特劳布里奇 | strawbridge
伯纳尔夫 | 伯纳夫 | bernulf
希肯洛珀 | 希肯卢珀 | hickenlooper
巴尔塔萨 | 巴尔塔泽 | baltassar
杜克 | 杜凯 | duque
阿姆里德 | 安弗里德 | amfrid
海尔卡 | 海尔基 | heilkay
弗利金格 | 弗利金杰 | flickinger
泽比娜 | 泽拜纳 | zebina
麦卡纳尼 | 麦卡内尼 | mcaneney
格拉斯戈 | 格拉斯哥 | glasgow
赫钦格 | 赫金杰 | hechinger
哈尼迪 | 哈内迪 | harnedy
布拉斯内特 | 布拉斯尼特 | brasnett
斯梅因 | 斯梅奇 | smaje
奥利文特 | 奥利万特 | ollivant
戈洛琴科 | 戈洛夫琴科 | golovchenko
麦克利尔 | 麦克勒莫尔 | mclemore
德布勒勒 | 德布鲁勒 | debruler
麦克费德兰 | 麦克费德伦 | macphedran
奥迪吉尔 | 奥迪吉耶 | audigier
赫蒙 | 哈蒙 | hummon
伯特胡德 | 伯绍德 | berthoud
帕克特 | 帕赫特 | pachter
比奥利 | 比利 | beoley
古比托什 | 古比托西 | gubitoshi
克利平 | 克利彭 | klippen
比塔 | 比塔尔 | bitar
姆莱卡 | 姆拉卡 | mlakar
耶登 | 伊登 | yeadon
达尔维奇 | 达利奇 | dulwich
霍斯 | 豪斯 | howes
戈弗雷 | 戈弗里 | goeffrrey
格罗塞斯特 | 格罗斯泰特 | grosseteste
施蒂贝林 | 斯蒂贝林 | stiebeling
洛克希尔 | 洛希尔 | lochiel
弗里尔 | 弗雷耶 | freyere
斯科菲尔德 | 舍恩菲尔德 | schonfield
齐克 | 齐亚克 | dziak
斯托尔普 | 施托尔普曼 | stolpman
弗兰普蒂恩 | 弗兰普申 | framption
博雷特 | 博里特 | borrett
米克尔霍恩 | 米克尔约翰 | meiklejohn
拉肯迈耶 | 拉肯米尔 | lackenmier
费彻姆 | 费克姆 | feachem
拉库帕涅 | 拉康帕涅 | lacampagne
索维奇 | 索瓦热 | sauvage
普鲁德富特 | 普劳德富特 | proudfoot
蔡夫 | 泽夫 | zeff
科帕德 | 科珀德 | coppard
斯塔雷斯 | 斯泰尔斯 | stares
巴思 | 巴特 | barthe
埃斯科菲 | 伊斯科菲 | escoffey
吉利亚姆 | 吉列姆 | gilliam
皮尔 | 皮埃尔 | pierre
博施威茨 | 博希威茨 | boschwitz
哈德格里 | 哈迪格里 | hardegree
弗利克拉拉夫特 | 弗利特克拉夫特 | flitcraft
皮尔 | 珀尔 | pearl
维勒里尔 | 维拉里尔 | villarreal
洛西安 | 洛西恩 | lowthian
多姆詹 | 多米扬 | domjan
阿巴斯尼亚 | 阿巴斯蒂尼亚 | abastenia
阿利斯 | 阿莱斯 | allies
休伊泽 | 哈伊泽 | huyser
科马杰 | 康马杰 | commager
卡拉贝蒂安 | 卡拉佩琴 | carapetyan
布林宁 | 布赖宁 | bryning
麦凯恩 | 麦克钦 | mccheane
哈德 | 哈达德 | haddad
切尔滕纳姆 | 切尔特纳姆 | cheltenham
布罗德布特 | 布罗德本特 | broadbent
克拉布里 | 克拉布特里 | crabtree
里克伯格 | 里奇伯格 | richbourg
特洛 | 特略 | tello
威克斯蒂德 | 威克斯第德 | wicksteed
维斯洛斯基 | 维斯克洛斯基 | visclosky
杰吉斯 | 格吉斯 | gergis
斯科格伦 | 斯科格隆 | skoglund
拉萨尔 | 拉萨 | lassar
万诺伊 | 范诺伊 | vannoy
温塔尔 | 温特尔 | weintal
贾夫 | 贾菲 | jaffe
斯坦姆 | 施塔姆 | stamm
法扎 | 法扎尔 | fazar
马塞尔 | 玛塞勒 | marcelle
尤因斯 | 尤温斯 | uwins
克里斯塔克斯 | 克里斯塔科斯 | christakos
切切尔斯基 | 切赫尔斯基 | cehelsky
乌尔维奇 | 乌莱维奇 | ulevich
达尔斯特龙 | 达尔斯特伦 | dahlstrom
康尼利 | 康奈利 | conneally
勒肯 | 卢肯 | lukken
德赫斯 | 德海斯 | dehayes
马顿 | 梅顿 | maton
希拉 | 夏伊拉 | shyla
比恩 | 比汉 | beehan
迪安娜 | 黛安娜 | dianna
法尔肯海姆 | 福尔肯海姆 | falkenheim
哈努舍克 | 哈努谢克 | hanushek
斯庞斯 | 斯波斯 | spouse
洛恩 | 洛温 | lowen
达夫勒 | 德夫勒 | doerfler
施朗茨 | 施龙茨 | shrontz
贝默赛德 | 比默赛德 | bemersyde
米姆诺 | 明诺 | mimno
罗明 | 罗梅因 | romeyn
布雷克斯派尔 | 布雷克斯皮尔 | breakspear
扬格斯本德 | 扬哈斯本 | younghusband
夏皮 | 沙比 | sharpey
勒西奇 | 勒萨热 | lesage
杰普萨 | 杰普撒 | jeptha
布布利斯 | 布勃利斯 | bublys
辛皮克 | 辛皮奇 | simpich
伯特霍尔夫 | 伯索夫 | bertholf
西迪亚 | 切迪亚 | ceddia
沙特利夫 | 舒特莱夫 | shurtleff
斯波塔德 | 斯波蒂德 | spotted
乔齐 | 乔茜 | jozy
黛安 | 戴安 | dian
马霍恩 | 马洪 | mahone
劳克霍夫 | 劳卡夫 | laukhuff
德拉基斯 | 德拉奎斯 | delaquis
米尔希 | 米尔海 | milhy
卡德温 | 卡杜根 | cadwgan
博希尔 | 博舍尔 | boshier
斯克里伯 | 斯克赖伯 | scriber
博维 | 博韦 | bovee
赫克顿 | 赫克通 | hektoen
莱维 | 利瓦伊 | levi
克里 | 克雷 | crea
卡祖克雷亚 | 库佐克雷亚 | cuzzocrea
阿德金森 | 阿基森 | adkisson
施莱 | 施利 | schlie
伊菲涅妮 | 伊菲吉妮 | iphigene
塞金格 | 塞金杰 | seckinger
德拜茨基 | 德比茨基 | debicki
泽费雷利 | 泽菲雷利 | zeffirelli
泰菲翁 | 泰维恩 | teifion
亚历克西斯 | 亚历克西丝 | alexys
本哈明 | 本杰明 | benjamin
菲沙利斯 | 菲谢利斯 | fischelis
拉罗姆 | 拉勒姆 | larom
坎帕内 | 坎佩恩 | campaigne
格茨怀勒 | 古茨维勒 | gutzwiller
马奎斯 | 马克斯 | marques
勒金 | 勒德金 | ludgin
阿尔皮娜 | 阿尔皮纳 | alpina
韦雷尔 | 沃雷尔 | werrell
福尔兹 | 福尔茨 | folz
德福德 | 德福特 | deford
博比萨德 | 博比苏德 | bobisud
图尔 | 特尔 | tourle
图利特 | 塔利特 | tulett
斯塔克 | 斯图克 | stucke
尚伯格 | 舍恩伯格 | schonberger
兰贝利特 | 兰伯利特 | lambelet
孔希尼克 | 康施尼克 | konschnik
盖 | 贾伊 | gye
利希滕斯坦 | 利克滕斯坦 | liechtenstein
安德鲁斯丘维奇 | 安德鲁斯克维奇 | andruskevich
托德里亚斯 | 托德雷亚斯 | todreas
伯金 | 布尔金 | bourgin
泰林厄姆 | 蒂林厄姆 | tyringham
比 | 布埃 | bue
斯拉克斯 | 斯莱克斯 | slacks
阿维斯 | 阿维丝 | aveis
斯卡珀罗 | 斯卡佩罗 | scarpero
斯特兰格 | 斯特兰杰 | stranger
阿伦 | 阿龙 | aaron
马尔克斯 | 马尔库斯 | malkus
杜奇 | 杜格 | dhooge
格尔巴克 | 盖尔博 | gelbach
布雷克兰 | 布里克兰 | brekland
比钱拉 | 布阿哈拉 | buachalla
里丁斯 | 赖丁斯 | ridings
沃尔克 | 沃克 | walke
考特尼 | 考特妮 | kourtney
马尔贝利 | 马尔伯利 | mulberly
布隆姆伦 | 布洛姆格伦 | blomgren
凯尔 | 屈尔 | kuehl
比利埃 | 比埃 | billiere
曼恩 | 曼 | mann
库利希 | 库利格 | kulig
施纳克 | 施努克 | schnuck
普钦斯基 | 普辛斯基 | pucinski
帕雷斯 | 佩尔斯 | pares
尼科莱 | 尼古拉 | nicolay
弗雷塔格 | 弗赖塔格 | freytag
撒尔肯 | 萨尔肯 | thalken
基米特 | 金米特 | kimmitt
克罗斯曼 | 克罗斯蒙 | croasmun
乔登斯 | 乔丹斯 | jordans
艾勒 | 艾拉 | ayla
利塔特 | 利撒特 | leathart
赖津 | 里津 | ryzin
内马特 | 纳马思 | namath
伯娜 | 伯纳 | berna
索利 | 索莱 | saulez
布莱谢登 | 布莱钦登 | blechynden
巴索尔缪 | 巴托洛缪 | bartholemeu
安德烈娜 | 安德里娜 | andrina
柯克 | 瑟克 | cirker
德文特 | 德温特 | derwent
恩德科特 | 恩迪科特 | endecott
阿尔文 | 阿尔温 | alwin
拉索姆 | 莱瑟姆 | lathom
霍塞尔 | 休塞尔 | heusel
莱弗勒 | 莱弗拉尔 | leflar
罗莎佩普 | 罗萨皮普 | rosapepe
赫宁伯格 | 赫宁堡 | heningburg
巴萨德 | 巴萨德雷 | basadre
康纳尔 | 科纳尔 | conall
斯威策 | 斯韦策 | sweitzer
梅卢普斯 | 梅拉普斯 | mellups
巴尔西格 | 巴尔西杰 | balsiger
希拉伯 | 希莱伯 | shillaber
布兰德帕斯 | 布兰德法斯 | brandfas
斯卡普西特 | 斯卡尔普西特 | sculpsit
休马森 | 赫马森 | humason
斯蒂夫斯 | 斯特弗斯 | steffes
卡斯特伯里 | 卡斯尔伯里 | castelberry
吉尔博德 | 吉尔博 | guillebaud
贝切特 | 贝谢 | bechet
梅利奥尔 | 梅莉奥尔 | melior
威弗里斯 | 韦弗里斯 | weffries
鲁马塞特 | 罗马塞特 | roumasset
比阿特里夏 | 比阿特丽西娅 | beatricia
福尔法 | 福法 | forfar
梅努欣 | 梅纽因 | menuhin
休尔 | 舒尔 | shure
凯格 | 基格 | keig
菲阿尔卡 | 菲亚尔卡 | fialka
伊萨科 | 伊萨科夫 | isakow
克伦西克 | 赫伦奇克 | chrencik
奈莎 | 尼萨 | neysa
彭沃尔特 | 佩恩沃尔特 | pennwalt
库塞维茨基 | 科乌谢维茨基 | koussevitzky
米尼奥 | 米内奥 | mineo
伊尔塔德 | 伊尔蒂德 | illtud
弗罗斯 | 弗勒泽 | froese
阿什利 | 阿什莉 | ashleigh
斯图扎 | 斯图尔扎 | stoorza
切内里 | 切纳里 | chenery
弗拉赫蒂 | 弗莱厄蒂 | flaherty
诺克斯 | 努克斯 | nokes
奇亚鲁奇 | 基亚鲁奇 | chiarucci
图尔默 | 瑟默 | thuermer
舍戈尔斯 | 舍加尔斯 | shergals
贝格特拉普 | 贝格特鲁普 | begtrup
安巴德卡 | 安贝德卡 | ambedkar
迪克诺伊 | 迪克努瓦 | duquenoy
柯彻 | 基尔舍 | kircher
斯托尔森巴赫 | 斯托曾巴赫 | stolzenbach
柯蒂斯 | 柯蒂兹 | curtiz
耶格 | 杰格 | jeger
马德里德 | 马德里 | madrid
凯特尔比 | 基特尔比 | ketelbey
怀甘特 | 威甘特 | wygant
博弗里 | 博韦里 | boverie
洛伦森 | 洛伦岑 | lorenzen
阿利加拉 | 阿利格拉 | allegra
阿姆什威茨 | 阿姆谢维茨 | amshewitz
奥法雷尔 | 奥法雷 | o'farrell
卡图布 | 卡图博 | catubo
卢宁 | 吕宁 | luening
特金 | 图尔金 | turkin
努里克 | 纽里克 | newrick
西里 | 蒂里 | thierry
阿斯彭登 | 阿斯普登 | aspden
乔西 | 约瑟 | josee
迈斯兰 | 迈斯拉恩 | meislahn
利昂内尔 | 莱昂内尔 | lionel
格尔纳 | 盖尔纳 | gellner
高因 | 高英 | gowing
亨尼卡特 | 亨尼克特 | hunnicutt
本恩 | 贝恩 | benne
科斯 | 库斯 | coes
斯库斯 | 斯丘斯 | skuce
舍内曼 | 舍尼曼 | schoeneman
维尼斯 | 维内斯 | veness
穆斯 | 缪斯 | muse
哈伊克斯博里克 | 哈维克斯布罗克 | hawixbrock
冈希利 | 贡希利 | goonhilly
哈里尔 | 哈丽尔 | harriel
奎恩 | 奎因 | queen
塞塞尔 | 塞斯尔 | sessel
费尔马纳 | 费尔曼纳 | fairmaner
埃德霍姆 | 埃德霍尔姆 | edholm
阿尔西夫龙 | 阿尔西弗龙 | alciphron
特雷西 | 特蕾西 | tracey
劳克 | 吉奥克 | giauque
厄斯勒 | 奥斯勒 | oursler
埃尼德 | 伊妮德 | enid
西金特 | 瑟金特 | searjeant
拉金 | 莱金 | laging
莫尼尔 | 莫内尔 | monell
尚伯格 | 舍恩伯格 | schonberg
米塞夫 | 米采夫 | mitseff
伊普尔 | 耶普尔 | yeaple
范格 | 范杰 | fanger
布兰钦 | 布兰昌 | blanchan
霍尔迪曼德 | 哈尔迪曼德 | haldimand
吉利亚斯 | 吉利亚姆 | guilliams
多奇 | 道奇 | dodge
梅莉娅 | 米利亚 | melia
斯威恩 | 斯温 | sween
弗赖赖克 | 弗赖雷克 | freireich
戈梅兹拉塔 | 戈梅斯普拉塔 | gomezplata
布古瓦 | 布儒瓦 | bourgeois
安东尼奥 | 安东尼乌 | antoniou
奥利维雷 | 奥利瓦雷斯 | olivarez
罗伊巴尔 | 罗伊鲍尔 | roybal
布谢夫 | 布舒夫 | bushueff
萨格特里厄斯 | 萨吉泰里厄斯 | sagittarius
比克 | 贝克 | beek
福斯 | 富斯 | fuoss
特怀德尔 | 特威德尔 | twidell
雷诺尔德 | 伦瓦尔 | renouard
希拉斯 | 希勒斯 | heelas
考尔德洛夫 | 考尔德克拉夫 | caldcleugh
克拉格 | 克莱格 | clague
贾西娜 | 杰西纳 | jacyna
切希尔 | 切斯希尔 | chesshyre
布雷钦 | 布里金 | brechin
亚格 | 耶格尔 | yager
巴尔恩 | 鲍恩 | balne
赫普 | 霍伊普 | heup
富尔赫姆 | 富勒姆 | fulham
希曼娜 | 希曼纳 | sheemanna
施雷尔 | 施赖尔 | schreyer
阿查尼奇 | 阿德查尼克 | ardcharnich
贝迪利恩 | 贝迪利翁 | bedillion
斯迈思 | 史密斯 | smyth
赖道特 | 赖德奥特 | rideout
麦考斯兰 | 麦考斯伦 | mcauslan
尼思代尔 | 尼斯代尔 | nithsdale
皮阿特罗斯 | 皮特罗斯 | peatross
马蒂奥 | 马泰奥 | matteo
斯科格伦 | 肖格伦 | sjogren
多罗西 | 多萝西 | dorothy
斯塔宾 | 斯图宾 | stubbing
索洛茨 | 索尔特斯 | solotesz
坎普施勒 | 坎普施罗尔 | kampschror
布姆斯特德 | 巴姆斯特德 | bumstead
坦普拉 | 坦普勒 | templar
伦 | 莱恩 | len
德马托 | 德马尔托 | desmarteau
马古雷尔 | 马圭雷尔 | maguirel
霍茜 | 霍西 | hosie
夏伊普 | 谢普 | shairp
格赖德 | 格雷德 | greider
克洛德纳 | 科洛德纳 | kolodner
索恩代克 | 桑代克 | thorndike
马沙姆 | 马香 | marsham
切尔尼克 | 切尔内克 | chelnek
奥伯赫尔曼 | 奥伯黑尔曼 | oberhelman
帕特里亚 | 佩特里亚克 | patriach
谢尼斯 | 切尼斯 | chenies
里查兹 | 理查兹 | richards
艾奇森 | 艾奇逊 | eytchison
布里恩特 | 布赖恩特 | briant
丹鲁瑟 | 丹罗伊特 | dannreuther
巴恩比 | 巴恩贝 | barnebey
梅林达 | 梅琳达 | melinda
弗伦泽 | 弗伦策 | frenzer
康西尔 | 康斯尔 | council
谢因鲍姆 | 欣鲍姆 | sheinbaum
泰雷 | 泰里 | tyree
戈德博勒 | 戈德伯勒 | goldborough
沃拉尼厄斯 | 瓦拉尼厄斯 | waranius
赫马纽亚克 | 赫马纽克 | hermaniuk
瓦思 | 韦思 | vaeth
拉曾 | 拉津 | razeen
古赫 | 高夫 | gough
巴塔格尔 | 巴塔杰尔 | battagel
埃里克 | 埃厄克 | earwaker
格林达尔 | 格林德尔 | grindal
贝克斯泰特 | 贝克施泰特 | beckstedt
西弗林豪斯 | 塞夫林豪斯 | sevringhaus
贾科特 | 贾科泰 | jacottet
布里利 | 布里厄利 | brealey
麦科沙奈格 | 麦科尚奈格 | maco'shannaig
麦克廷格 | 马赫廷格 | machtinger
内内曼 | 南尼曼 | nenneman
梅贝 | 梅布 | mabe
卡尼格 | 凯尼格 | koernig
马米特 | 马梅特 | mamet
卡塞尔 | 卡瑟尔 | cuthell
迪尤斯 | 德威斯 | dewees
桑杜姆 | 桑德姆 | sandum
奥琳达 | 奥林达 | orinda
斯塔林 | 斯托林 | stalling
基茨哈伯 | 基察伯 | kitzhaber
布雷齐尔 | 布雷热 | brazier
阿纳斯塔西修斯 | 阿纳斯塔修斯 | anastasius
芬尼 | 菲尼 | phinney
里维特 | 里韦特 | rivet
奥尔迪 | 阿尔迪 | alday
赛纳 | 西纳尔 | synar
康科拉 | 康科勒 | concholar
默茨基 | 默茨克 | mertzke
斯库勒 | 朔伊勒 | scheuler
特拉曼 | 杜鲁门 | truman
惠伦 | 惠兰 | whelan
里卡西 | 里斯卡西 | riscassi
达奇 | 达基 | dachi
迪奥 | 德奥 | deo
拉思 | 雷思 | rathe
霍尔巴克 | 哈尔巴赫 | halbach
戈德温 | 戈尔德温 | goldwyn
赫利 | 赫尔利 | hurleigh
克罗嫩贝格 | 克罗嫩伯格 | kronenberg
克里奇顿 | 克赖顿 | crichton
格威尼德 | 格威内思 | gwynedd
特罗蒂耶 | 特罗蒂尔 | trottier
凯利 | 基利 | kealy
科特 | 考特 | cawte
纳特尔 | 纳塔尔 | natal
布奇 | 布谢 | bouchey
鲍尔斯 | 鲍威尔斯 | powels
罗雷姆 | 罗勒姆 | rorem
沃蒂埃 | 沃捷 | vautier
安德赖奥 | 安德里厄 | andrieux
阿莱恩 | 阿林 | alleine
贝克 | 贝克尔 | becker
纳奇芒诺夫 | 纳赫马诺夫 | nachmanoff
怀索基 | 维索茨基 | wysocki
埃里克 | 埃里格 | ehrig
艾尔布拉克特 | 艾尔布拉赫特 | eilbracht
西里奇 | 瑟里奇 | surridge
杜尤 | 迪尤 | dew
唐西娅 | 唐西亚 | donsia
达克罗 | 迪克罗 | ducrow
沃尔克 | 沃克 | walk
沃尔克 | 沃克 | walker
马西厄斯 | 马修斯 | masius
梅迪森 | 麦迪逊 | madison
德格拉克特 | 德格拉赫特 | dergracht
斯坦达洛夫特 | 斯坦德洛夫特 | standaloft
莱恩斯 | 莱昂斯 | lyons
德沃查克 | 德沃夏克 | dvorchak
亨格格勒 | 亨格勒 | hennggeler
菲伦 | 法林 | filene
肖尔 | 肖勒 | scholle
拉尔 | 勒尔 | lull
查克里斯 | 查基里斯 | chakiris
希尔茨 | 希尔兹 | shields
菲内尔 | 芬内尔 | feennell
塞门扎 | 西门扎 | semenza
哈森富斯 | 哈森弗斯 | hasenfus
加索夫 | 加特霍夫 | garthoff
沃尔拉特 | 沃尔拉思 | walrath
彼得龙 | 佩特龙 | petrone
格里桑蒂 | 格里桑迪 | grisanti
梅尔斯 | 马雷斯 | mares
庞蒂尼 | 庞特尼 | pounteney
阿奈林 | 阿内林 | aneirin
冈利 | 高恩利 | gownley
博尔达什 | 博达什 | bordash
阿图鲁厄斯 | 阿图罗斯 | arturous
拉腊比 | 拉勒比 | larabee
埃斯卡迪里安 | 伊斯坎达里安 | eskandarian
乔洛伦齐 | 贾洛伦齐 | giallorenzi
加格 | 盖杰 | gager
塞默多 | 塞穆多 | themudo
斯隆普 | 斯卢普 | sloop
科尔奎特 | 科尔基特 | colquitt
贝松 | 贝森 | bessone
塞科夫斯基 | 赛科夫斯基 | saikowski
塞格雷夫 | 西格雷夫 | segrave
苏伊尔 | 舍代尔 | suirdale
哈莫尔 | 哈默 | hamor
博索沃思 | 博索姆沃思 | bosomworth
普普 | 普珀 | puppe
施米德 | 施密德 | schmid
塔姆格尔 | 塔穆格尔 | tarmugl
黑尔 | 海尔 | haire
哈克威尔 | 黑克威尔 | hakewill
冈扎莱兹 | 冈萨雷斯 | gonzalez
莫纳 | 莫娜 | mona
格雷恩 | 格兰妮 | grainne
兹韦德林 | 兹沃德林 | zwerdling
特鲁赫特 | 特鲁哈特 | trueheart
布拉德斯泰特 | 布拉德斯特里特 | bradstreet
麦克斯琴奥芬 | 麦克斯蒂奥芬 | macstiofain
亚里莫维奇 | 雅里莫维奇 | yarymovych
登尼斯顿 | 丹尼斯顿 | denniston
塞尼奥尔 | 西尼尔 | senior
哈特赛德 | 哈齐德 | hartsid
博伊斯拉贡 | 博勒根 | boisragon
雷伯特 | 雷巴特 | rebut
梅特罗普洛斯 | 梅特罗波利斯 | metropolis
索山 | 索热尔 | saussure
费里比 | 费尔比 | ferebee
科克森 | 考克森 | coxon
斯克鲁塔塔 | 斯克鲁泰特 | scrutator
格里泽 | 格赖泽 | griser
贝拉尼娅 | 贝拉尼亚 | berania
舒尔霍尔兹 | 许霍尔茨 | schuerholz
科尔赫普 | 科尔黑普 | kohlhepp
鲁阿科 | 罗科 | ruocco
加诺尔 | 加诺 | ganor
鲍德施韦勒 | 巴尔德施维勒 | baldeschwieler
斯洛尼姆 | 斯洛宁 | slonim
马萨 | 玛莎 | martha
福内斯 | 福尼斯 | forness
鲍杜因 | 鲍德温 | bauduin
珀塞克 | 佩塞克 | perseck
维伦 | 瓦伊伦 | viron
索尔茨 | 肖尔茨 | soults
奇瑟姆 | 奇塔姆 | cheatham
乔西亚斯 | 乔赛亚斯 | josias
埃夫瓦德 | 埃瓦德 | evvard
格劳尔德 | 杰罗尔德 | gerould
杰尔 | 耶格 | jaegher
赫里霍夫 | 赫雷斯霍夫 | herreshoff
加弗 | 盖弗 | gaver
柯兰 | 柯伦 | curran
瓦伦兹拉 | 巴伦苏埃拉 | valenzuela
瓦迪 | 韦迪 | wadey
阿格 | 阿古 | agwu
弗卢克斯 | 弗勒克斯 | flux
考斯利 | 库斯利 | cousley
索勒 | 索莱尔 | sohler
特劳布里奇 | 特鲁布里奇 | troubridge
阿达曼 | 阿达姆南 | adamnan
林恩 | 林 | linn
里查德 | 理查德 | richard
罗伯森 | 罗伯逊 | robertson
吉查姆 | 吉彻姆 | gitsham
利维亚克 | 莱夫奥克 | liveoak
范德霍夫 | 范德胡夫 | vanderhoof
普鲁斯曼 | 普拉斯曼 | prusman
基弗 | 凯弗 | keifer
吉恩 | 吉亨 | gehan
施纳克纳 | 施努克内 | schnukne
马格 | 马杰 | mager
阿戈尔 | 阿高尔 | argall
温纳斯特拉姆 | 温纳斯特鲁姆 | wennerstrum
伦德尔 | 伦达尔 | lundahl
利德克 | 利迪克 | luedecke
乔德雷 | 乔德尔 | jordre
普伦内基 | 普伦尼克 | pluenneke
布卡奇奇 | 布卡奇 | bukatzsch
贝拉德 | 贝拉尔 | berard
韦格姆 | 威格姆 | wigham
马尔文 | 马尔韦农 | mulvenon
道宁 | 唐宁 | downing
巴特伦 | 巴特拉姆 | battram
麦吉蒂 | 麦金蒂 | mcguinty
皮珀 | 派珀 | piper
卡莉什 | 卡利什 | kalish
格里索奥尼娅 | 格丽索戈尼娅 | grisogonia
德保 | 德波 | depauw
豪瑟姆 | 豪萨姆 | howsam
迈伯格 | 迈伯勒 | myburgh
德沃尔金 | 德沃金 | dworkin
阿特尔西 | 阿特莱西 | attlesey
加格尼宾 | 加涅班 | gagnebin
布莱什密特 | 布莱希施米特 | blechschmidt
赫维茨 | 赫威茨 | herwitz
梅恩斯 | 梅因斯 | mains
马托拉佐 | 马塔拉佐 | matarazzo
德雷斯克 | 德赖斯克 | dreiske
普雷尔 | 普里尔 | preil
拜勒姆 | 比鲁姆 | biroum
巴约克 | 贝尤克 | bayuk
奎伦 | 奎林 | quillen
斯托克斯 | 斯托克维斯 | stokvis
贝思 | 贝丝 | beth
约厄 | 约埃 | yohe
耶特龙 | 亚特隆 | yatron
斯凯姆 | 斯基姆 | skym
西埃斯 | 西斯 | siess
布思利 | 布思莱 | buthlay
安杰莉娜 | 安杰利娜 | angelina
奥尔莫尼 | 阿尔莫尼 | almony
里瓦塔 | 里乌塔 | riutta
普伦蒂 | 普朗蒂 | prunty
奥洛克林 | 奥劳克林 | o'laughlin
梅奥拉斯 | 马约拉斯 | mayoras
维西 | 维齐 | veysey
拉里莎 | 拉丽莎 | larissa
沃尔斯塔拉塔夫特 | 沃斯通克拉夫特 | wollstonecraft
法夫罗特 | 法夫罗 | favrot
阿曼 | 阿尔曼 | arman
萨拉曾 | 萨拉津 | sarazyn
阿德尼 | 埃德尼 | adney
波克 | 普克 | poock
莫勒诺 | 莫勒瑙尔 | mollenauer
芬夫西 | 芬韦西 | fenvessy
帕奇 | 帕克 | pach
吉尔德 | 格尔德 | gelder
于里安 | 尤里安 | urien
索瑟恩 | 萨瑟恩 | southern
巴查尔 | 巴卡尔 | bachar
奥尔博 | 阿尔博 | allbaugh
加米特 | 加梅特 | gamet
凯尼斯 | 基尼斯 | kiness
德利贾治厄斯 | 德利乔治斯 | deligiorgis
加雷尔 | 加勒尔 | garel
拉希 | 莱希 | lahee
奥尔 | 奥利 | ole
巴德温 | 布德温 | budwine
迪奥 | 戴奥 | dio
布罗尔奇 | 布勒尔施 | broelsch
哈巴赫 | 哈巴克 | harbach
塞维尔 | 萨维尔 | savele
莱维 | 利维 | levie
格朗基 | 格朗茨基 | groncki
加康 | 加肯 | garcon
达姆里奇 | 德姆里克 | daemmrich
肖尔德勒 | 斯科德勒 | scholderer
杜比 | 达比 | duby
贝尔比 | 比尔比 | beilby
博斯金德 | 博斯坎德 | boskind
诺尼梅克 | 努尼梅克 | nunemaker
阿妮斯 | 安妮斯 | anis
阿布林 | 埃布林 | ablin
班德 | 班德尔 | bander
罗萨尔 | 罗塞尔 | rossall
谢德 | 沙德 | shad
埃奇逊 | 艾奇逊 | etcheson
福塞特 | 福西特 | fawssett
奥利夫 | 奥拉夫 | olave
莫菲 | 莫夫 | maufe
吉尔德福德 | 吉尔福德 | guildford
阿伊克 | 阿威克 | aawick
阿蒂亚 | 阿提耶 | atiyeh
伦芬特 | 朗方 | lenfant
尤普弗罗因 | 尤弗罗西尼 | euphrosyne
里奥赫 | 里奥克 | reoch
艾娅拉 | 阿亚拉 | ayala
梅恩林 | 梅因沃林 | mainwaring
彼特里兹 | 佩特里迪斯 | petrides
科德尔 | 科德 | corder
戴文 | 达文 | davern
罗赞妮 | 罗珊 | rozanne
洛格 | 洛奇 | lorge
格林霍 | 格里诺 | greenhow
格利莫尔 | 格利穆尔 | glymour
戈特沙尔 | 戈查尔 | gotshal
斯利 | 斯莱 | sligh
希斯 | 谢斯 | shays
埃莱娜 | 埃琳娜 | elena
布雷德 | 布里德 | breder
麦加恩 | 麦加亨 | mcgahern
温特罗普 | 温思罗普 | winthrop
穆拉尔特 | 缪拉尔持 | muralt
萨洛姆 | 萨洛米 | salome
利克曼 | 莱克曼 | likeman
玛丽萨 | 马里萨 | marisa
尤金尼亚 | 尤金妮亚 | eugenia
梅德沃多斯基 | 梅德瓦多夫斯基 | medwadowski
希厄特 | 海厄特 | hieatt
科德尔 | 科格德尔 | cogdell
特里布瓦瑟 | 特里布沃瑟 | triebwasser
惠奇利夫 | 惠特克利夫 | whitchliffe
卡莱斯 | 卡莱尔 | carlisle
德赫特 | 德克特 | dechert
洛芙登 | 洛夫登 | loveden
邓纳希 | 邓纳基 | dunnachie
德夫尼 | 迪夫尼 | deveney
海姆索思 | 海姆塞特 | heimsoth
希伯德 | 希巴德 | hibbard
科斯博 | 科斯莫 | cosmo
盖斯特菲尔德 | 盖斯特费尔德 | geistfeld
塔利亚福罗 | 托利弗 | taliaferro
蒂特勒 | 泰特勒 | tytler
伊博罗尔 | 埃博拉尔 | eborall
莱塞特 | 莱西特 | lycett
莱贡 | 利根 | lygon
奥莱齐 | 奥莱克休 | oleksiw
阿莱兹 | 阿莱 | allez
卡德瓦拉达 | 卡德瓦拉德 | cadwaladyr
里德尔 | 里迪尔 | rideal
萨尔温 | 西尔温 | sulwen
坦克蕾托 | 坦克雷托 | tancreto
法迪安 | 法迪恩 | fadyean
伯克隆 | 伯克伦 | berklund
拜萨特 | 比萨特 | bisat
埃莱克 | 埃勒克 | ellerker
德雷南 | 德雷宁 | drennen
德沙 | 德谢尔 | decher
巴特伦 | 巴特拉姆 | buttram
特鲁齐 | 特拉齐 | truzzi
阿布迪安 | 阿布迪恩 | abdian
蒙蒂马罗诺 | 蒙特莫雷诺 | montemoreno
托里 | 托丽 | tori
卡里洛 | 卡里略 | carrillo
马莎娜 | 马塞纳 | marthena
杰尼森 | 吉尼森 | genesen
凯莉 | 卡利 | cali
