戈妮娅 | 戈尼亚 | gonia
布雷金里奇 | 布雷肯里奇 | breckinridge
塞德 | 切德 | cedd
玛莉 | 马利 | maly
阿西尼加 | 阿西涅加 | arciniega
法莱恩 | 法兰 | farlane
霍普特 | 豪普特 | houpt
沃尔斯塔特 | 沃尔施塔特 | wollstadt
派珀特 | 佩珀特 | peipert
皮内 | 皮奈 | pinay
梅雷斯曼 | 米尔斯曼 | meresman
伊兹比基 | 伊兹比茨基 | izbicky
埃卡维斯特 | 埃沙韦斯特 | echaveste
舒普 | 肖普 | shoupp
蒙斯巴赫 | 蒙斯巴克 | maunsbach
沃塞尔 | 瓦塞尔 | wassell
瑟金特 | 萨金特 | seargent
海巴克 | 亨巴赫 | heimbach
基布勒 | 库布勒 | kuebler
杰米马 | 杰迈玛 | jemima
海伊 | 希 | hie
莫杜伊特 | 莫德维 | mauduit
惠塔克 | 惠特克 | whitacre
艾特 | 艾厄特 | eyet
耶德利 | 亚德利 | yeardley
博比 | 鲍比 | bobbie
麦基尔文娜 | 麦基尔温纳 | macilvenna
莱恩斯 | 赖恩斯 | rines
博查尔 | 博索尔 | botsal
科勒兰 | 科尔雷因 | coleraine
瓦格尼 | 韦恩 | wagne
赖格纳尔德 | 赖格纳德 | reignald
厄德曼 | 厄尔德曼 | erdman
戈伦比夫斯基 | 戈伦别夫斯基 | golembiewski
格雷戈尔 | 格雷瓜尔 | gregoire
米卡贾 | 迈凯亚 | micajah
莱德洛 | 莱德劳 | laidlaw
科姆萨罗夫 | 科梅萨罗夫 | komesaroff
雷默克斯 | 拉马克斯 | raemakers
比伦森 | 贝伦森 | beilenson
皮凯弗 | 皮卡弗 | piccaver
福图内多 | 福图纳多 | fortunado
斯克拉顿 | 斯克鲁顿 | scrutton
费尔本 | 费尔伯恩 | fairburn
津嫩 | 津宁 | zinnen
布盖兹 | 布尔盖兹 | bourgaize
珀利蒂尔 | 佩尔蒂埃 | pelletier
帕塞尔 | 帕斯尔 | parcel
霍诺里 | 霍诺丽 | honori
艾梅希 | 伊梅施 | imesch
西明顿 | 赛明顿 | symington
马奥 | 玛奥 | mahault
法克 | 菲克 | fike
奥德斯 | 奥杜斯 | audus
沃伊奇 | 沃伊蒂奇 | woytych
韦克特尔 | 瓦赫特尔 | wachtel
夏夫尔 | 希维尔 | shivell
马基宁 | 马基嫩 | makinen
拉凯斯 | 拉雪兹 | lachaise
达伦 | 达龙 | daron
麦科瑙希 | 麦康瑙希 | mcconaughy
达维格多 | 达维多尔 | d'avigdor
加莱夫 | 加利夫 | galef
曼纳韦 | 马纳韦 | mannaway
基利 | 基利亚 | killea
费迪斯科 | 弗迪斯科 | verdisco
阿福特 | 阿富尔蒂特 | affourtit
米塞尔 | 米赛尔 | misael
赫默里克 | 亨默里克 | hemmerich
黑伍德 | 希伍德 | heawood
詹宁斯 | 杰宁斯 | jenyns
弗里霍夫 | 弗里德霍夫 | friedhoff
斯坦姆斯 | 斯泰姆斯 | stames
比比 | 毕比 | beebe
博查特 | 博哈特 | borchardt
卡明 | 卡迈恩 | carmine
巴特伦 | 巴特拉姆 | bartram
派尔 | 皮尔 | peile
麦康恩 | 麦肯 | mccon
麦卡里 | 麦凯里 | mccarey
克雷扬 | 克雷恩 | crayon
拉布尔 | 鲁布尔 | ruble
英范特 | 因方特 | infant
高尔珀恩 | 加尔珀恩 | galpern
杰勒尔 | 杰拉尔 | gerall
亨内肯斯 | 亨尼肯斯 | hennekens
吉弗 | 贾埃弗 | giaever
贾米 | 杰米 | jamie
鲍尔霍恩 | 巴尔霍恩 | ballhorn
斯特吉斯 | 斯特奇斯 | sturges
莫克瑟姆 | 莫克塞姆 | moxam
唐 | 道 | daw
卡姆 | 卡尔姆 | culme
比克姆 | 比卡姆 | bickham
夏尔曼 | 沙伊尔曼 | shireman
梅索利 | 梅索伊 | meszoly
格格拉德 | 古格拉德 | ghugrad
埃森斯 | 埃森丝 | essence
格沃思米 | 格瓦思米 | gwathmey
利布 | 利比 | luebbe
哈兹尔 | 黑兹尔 | hazell
金德雷德 | 金德里德 | kindred
纽索尔 | 纳托尔 | nuthall
佐扎 | 佐尔扎 | zorza
迪 | 戴伊 | daigh
埃廷 | 埃泰恩 | etain
巴策 | 巴策尔 | batzer
莱思科特 | 利思科特 | lythcott
廷肯 | 廷康 | tinkon
德弗拉茨 | 迪弗雷特斯 | defrates
尤拉姆 | 乌拉姆 | ulam
达劳 | 达罗 | darraugh
沙德伯格 | 谢德伯格 | schadeberg
戴多 | 德多 | dedow
蒂利 | 泰利 | tiley
格罗布 | 格罗比 | grobe
塔塔利诺 | 塔尔塔利诺 | tartaglino
兰姆 | 拉姆 | lambe
卡德韦尔 | 考德威尔 | caldwell
利多尔 | 利德尔 | liddall
泽米娜 | 泽米纳 | zemina
坎特伯里 | 坎特伯雷 | canterbury
塔肯 | 泰肯 | tacon
基尔施 | 基尔希 | kirsch
古特穆特 | 古特穆思 | gutermuth
弗森 | 费尔森 | ferson
托皮 | 托毕 | torpey
洛多维克 | 洛多威克 | lodowicke
泰希曼 | 泰克曼 | teichmann
普鲁德霍姆 | 普鲁多姆 | prudhomme
坎比 | 坎贝 | cumbey
赫姆尔 | 赫姆利 | hermle
蒙冈 | 蒙贡 | mongon
穆塞尔 | 马塞尔 | mussehl
亨佩尔 | 亨普尔 | hempel
艾罗 | 艾罗尔特 | ayrault
赖蒂娜 | 赖蒂纳 | rytina
雷亚 | 雷 | rea
富加特 | 富盖特 | fugate
罗林格 | 罗林杰 | rollinger
德卢吉 | 德路易吉 | deluigi
科切雷斯 | 科克里斯 | cocheres
鲁德 | 鲁阿兹 | ruadh
巴斯凯特 | 巴斯克特 | baskette
马尔特比 | 莫尔特比 | maltby
埃塞雷达 | 埃塞丽达 | ethelreda
迪娜 | 迪恩纳 | dienna
博里尔 | 博雷尔 | boreel
布雷洪 | 布里恩 | brehon
盖尔 | 圭尔 | guire
尤彻克 | 尤尔丘克 | yurchuck
坦尼肯 | 滕尼肯 | tennican
麦金泰尔 | 麦金太尔 | mcintire
利文 | 莱文 | levene
克莱尔斯 | 克拉雷斯 | clares
韦顿 | 瓦顿 | vaton
切普林斯基 | 西普林斯基 | cieplinski
索乔恩 | 索杰纳 | sojourner
克努贝尔 | 努贝尔 | knubel
卡诺汉 | 卡诺坎 | carnochan
吉希诺 | 吉赫诺 | giheno
乔伊齐 | 乔伊西 | joicey
罗克辛 | 罗克西娜 | roxinne
贾姆森 | 詹姆森 | jameson
古妮拉 | 古尼拉 | gunilla
比哈里尔 | 贝哈里尔 | beharriell
朗彻普 | 朗香 | longchamp
舒尔金德 | 舒尔坎德 | schulkind
威尔希特 | 威尔海特 | willhite
洛伦兹 | 洛伦茨 | lorenz
特普尔 | 蒂普尔 | tepoel
贾莫 | 贾伊莫 | giaimo
库尔吉安 | 库尔金 | kuljian
吉耶 | 吉利特 | guillet
哈米利恩 | 哈米里恩 | hamilyon
利安妮 | 利安娜 | leanne
弗兰库姆 | 弗兰克姆 | frankum
布雷巴特 | 布赖巴特 | breibart
基尔库西 | 基尔科西 | kilcoursie
雷森诺沃 | 里曾诺弗 | reasonover
查根 | 查康 | chacon
雷布萨门 | 里布萨门 | rebsamen
托菲琴 | 托菲肯 | torphichen
哈鲁普 | 哈勒普 | harrup
沃格斯塔夫 | 瓦格斯塔夫 | wagstaffe
戈特尔斯 | 戈瑟尔斯 | goethals
瓜尔蒂埃 | 瓜尔蒂耶里 | gualtieri
泽兰 | 齐伦 | zeran
奥尔德斯代尔 | 奥尔德斯泰尔 | oldstyle
西门斯 | 西门子 | siemens
特普西奇 | 特普西克 | tepsic
普莱本 | 普利邦 | plybon
拜克纳 | 比克纳 | beichner
恩霍姆 | 恩格霍姆 | engholm
惠特洛 | 怀特洛 | whytlaw
杜瓦斯 | 德瓦斯 | dewas
杰奎兰 | 杰奎琳 | jacqueline
桑德威克 | 桑威克 | sandwick
怀思 | 韦思 | wyeth
施韦基尔德 | 施韦柴尔德 | schweichild
斯坦霍普 | 斯坦诺普 | stanhope
因沃尔德施塔德 | 英沃斯塔德 | ingvoldstad
森霍尔 | 桑戈尔 | senghor
布里豪斯 | 布里格豪斯 | brighouse
克伦布哈尔 | 克伦巴尔 | krumbhaar
莫拉尔 | 莫勒 | morar
路伊西 | 路易西 | louisy
弗里利 | 弗赖利 | friley
赖兰斯 | 赖伦斯 | rylance
赫斯莱普 | 赫斯利普 | heslep
鲍托尔 | 鲍塔尔 | boutall
哈扎德 | 哈泽德 | hazard
穆谢特 | 马希特 | mushet
布拉姆利 | 布伦利 | brumley
明 | 米恩 | min
菲格雷斯 | 菲格斯 | figures
埃加尔 | 埃加 | eggar
特库姆什 | 特库姆塞 | tecumseh
伊万杰斯塔 | 埃万杰利斯塔 | evangelista
韦布利 | 韦伯利 | webley
帕门蒂尔 | 帕尔芒捷 | parmentier
丁格利斯 | 迪安杰利斯 | deangelis
格里纳尔特 | 格里纳沃尔特 | greenawalt
麦格拉斯里奇 | 麦格拉斯里克 | macglasrich
索恩顿 | 桑顿 | thornton
巴洛克 | 巴洛赫 | balloch
切尔内斯基 | 切尔涅斯基 | chernesky
克伦 | 克朗 | kron
贝勒沃 | 贝尔维 | bellevue
里斯伯格 | 赖斯伯格 | riseberg
德尔钱普斯 | 德尔尚 | delchamps
布劳恩 | 布朗 | braun
特里利文 | 特里莱文 | treleaven
阿文特 | 埃文特 | avent
比斯内尔 | 比尤内尔 | buesnel
阿迪 | 埃迪 | adye
哈格迈耶 | 哈格迈尔 | hagemeyer
阿拉蒙 | 阿拉芒 | allamong
西米恩 | 西明 | siemien
普里亚尔 | 普赖尔 | prial
布利萨克 | 布利萨茨 | blisac
马尼斯 | 马内斯 | maness
拜德斯 | 比德兹 | bidez
伊威尔 | 厄维尔 | irwil
威尔梅特 | 薇尔梅特 | wilmett
尼迪 | 内迪 | neddy
纳兰乔 | 纳兰霍 | naranjo
布雷兰 | 布里兰 | breland
卡尔 | 卡利 | karle
勒尔克 | 罗尔克 | roelker
阿德莉娜 | 阿德利娜 | adelina
斯特尔特 | 斯泰尔特 | stelter
门韦尔 | 米恩韦尔 | meanwell
科克伦 | 科克兰 | cockran
保斯 | 波斯 | paus
古尔 | 瓜尔 | guare
朱皮特 | 丘辟特 | jupiter
多伊特里克 | 多伊特里希 | deutrich
托厄里 | 托尔里 | towery
马德林 | 马德琳 | madlin
威舍 | 维舍 | wischer
戴加德 | 迪格 | dygard
巴利克 | 巴利奇 | balich
基姆尔曼 | 基梅尔曼 | kimelman
卡比特 | 丘比特 | cubitt
西克雷斯特 | 西克里斯特 | secrest
拉扎 | 拉扎尔 | lazar
麦高恩 | 麦古恩 | macgoun
佩茨 | 皮特斯 | petes
皮克斯 | 皮尔克斯 | pearkes
费尔哈文 | 费尔黑文 | fairhaven
索恩伯格 | 索恩伯勒 | thornburgh
特里德格 | 特里迪加 | tredegar
阿蒂盖尔 | 阿蒂格尔 | attygalle
马西娅 | 玛西娅 | mathea
卡姆 | 凯姆 | kaim
费布勒 | 法布勒 | fabler
彼得鲁斯卡 | 彼特鲁斯卡 | petruska
弗恩 | 维恩 | verne
尤迪切洛 | 尤迪塞洛 | iudicello
韦姆 | 瓦伊姆 | waim
鲁尔兰 | 鲁伦 | ruellan
拉赫特 | 拉克特 | lachter
拉哈布 | 雷哈布 | rahab
麦金纳尼 | 麦基纳尼 | macinerney
埃根 | 伊根 | egan
斯蒂格勒 | 施蒂格勒 | stigler
特威宁 | 特文宁 | twining
西达罗斯 | 西达劳斯 | sidarouss
弗洛尔迪尤 | 弗劳尔迪 | flowerdew
盖兰 | 格兰 | gellan
吉梅内斯 | 希门尼斯 | jimenez
普勒 | 普拉 | pullar
韦尔纳 | 沃尔纳 | woellner
杜因特 | 德温特 | dewint
布拉德劳 | 布拉德洛 | bradlaugh
布鲁因 | 布勒因 | bruyn
塔米赫尔 | 塔米希尔 | tamihere
库劳 | 库罗 | courau
迪莫 | 迪梅奥 | dimeo
贝内迪卡斯 | 贝内迪克斯 | benedicus
麦格罗伊瑟 | 麦格鲁瑟 | macgreuther
柯蒂尼厄斯 | 柯特纽斯 | curtenius
阿斯基思 | 阿斯奎思 | asquith
赫利娜 | 赫莉娜 | helina
帕策尔 | 普策尔 | putzel
斯特朗奇 | 斯特朗 | stronge
埃沃伊 | 伊沃伊 | evoy
坦盖 | 坦圭 | tanguay
布里尼希 | 布里尼格 | brinig
杜布拉斯 | 杜布拉 | dubras
亚兹明 | 亚斯明 | yazmin
劳德代尔 | 劳德戴尔 | lauderdale
伯贝奇 | 伯比奇 | burbage
巴多夫 | 巴特多夫 | batdorf
泽纳 | 策纳 | zaehner
科尔尼特 | 科尔内特 | collnette
波洛斯 | 普洛斯 | poulos
莱安多 | 柳安多 | lewando
麦克沃尼什 | 麦克瓦尼什 | macvarnish
弗里岑 | 弗里曾 | fritzen
格尔廷 | 格廷 | guertin
特佩伊卡 | 特佩卡 | tepaika
麦克米克尔 | 麦克迈克尔 | mcmichael
布朗考 | 布劳考 | browkaw
贝尔希 | 贝尔赫 | bailhe
金泽特 | 金瑟特 | gensert
阿尔曼 | 阿利芒 | allemang
赛奇 | 赛什 | saich
沃克 | 沃恩克 | warnke
皮奥特罗夫斯基 | 彼得罗夫斯基 | piotrowski
贾恩 | 扬 | jahn
康加尔顿 | 康高尔顿 | congalton
杜达克斯 | 杜阿克斯 | duax
戴森霍费尔 | 戴森霍弗 | deisenhofer
沙滕克克 | 沙滕柯克 | schattenkerk
法隆 | 法伦 | falloon
奥斯柳 | 奥斯威尤 | oswiu
兰沃西 | 兰德沃西 | landwirthy
索锡 | 索西 | southee
米隆 | 米伦 | millon
艾利 | 艾莉 | eily
埃肯 | 伊肯 | ekern
菲利恩 | 菲利翁 | filion
莫普斯 | 莫皮斯 | moppes
菲茨希蒙斯 | 菲齐蒙斯 | fitzimons
格林斯彭 | 格林斯庞 | greenspun
帕塞尔 | 帕斯尔 | parcell
索尔 | 苏尔 | soul
门南 | 门嫩 | mennen
德迪奥 | 戴德奥 | dedeo
麦克里思 | 麦克勒思 | mackereth
奥瑟 | 奥泽 | orser
帕珀马斯特 | 佩珀马斯特 | papermaster
贝伦德斯 | 贝伦兹 | berendes
埃拉齐姆 | 伊拉齐姆 | erazim
施雷德 | 施拉德 | schrade
伯克 | 比尔克 | birck
斯普金 | 斯庞金 | spungin
巴托尔森 | 巴托尔松 | bartholdson
因格林 | 英林 | yingling
查努廷 | 查纽廷 | chanutin
埃塞克 | 伊塞克 | esek
梅尔霍弗 | 迈尔霍费尔 | maierhofer
艾尔莎 | 艾尔萨 | ailsa
马伦普尔 | 马伦普雷 | malempre
阿尔顿 | 阿里顿 | arreton
莫尔菲 | 莫菲 | morfee
菲尔布兰斯 | 法尔布兰斯 | firebrance
埃斯特斯 | 埃斯蒂斯 | estes
安南伯格 | 安嫩伯格 | annenberg
富洛姆 | 富勒姆 | fullom
肯尼 | 森尼 | cenni
博尔多 | 波尔多 | bordeaux
德西德里厄斯 | 德西迪里厄斯 | desiderius
塔尔戈特 | 索尔戈特 | thalgott
布里克斯 | 布雷克斯 | breaks
马尼尔 | 马尼耶 | magnier
阿尔特林彻姆 | 奥特林厄姆 | altrincham
艾纳姆 | 埃努姆 | aernum
拉万 | 拉文 | lavan
麦基尔维 | 麦基雷维 | macilrevie
艾肯格琳 | 艾肯格林 | eichengreen
莱夫勒 | 莱弗勒 | leffler
科卡姆 | 科克姆 | corkum
拉文 | 雷文 | raven
多尔兹 | 德尔兹 | doelz
埃维兹 | 阿维兹 | avids
莫布斯比 | 莫布兹比 | mobsby
南迪 | 农迪 | nundy
赛尔斯 | 西尔斯 | cyres
泰夫 | 塔夫 | tave
格特曼 | 古特曼 | gutman
阿奎约 | 阿夸约 | aquayo
弗雷林休森 | 弗里林海森 | frelinghuysen
帕吉利斯 | 帕盖利斯 | pargellis
奥尔施塔特 | 阿尔斯塔特 | alstadt
博尼法修斯 | 博尼费修斯 | bonifacius
达夫尼 | 达夫妮 | daphne
麦康基 | 麦康希 | macconchy
桑德姆 | 桑达姆 | sandham
里穆斯基 | 里莫斯基 | rimouski
马宁 | 曼宁 | maning
布莱胡特 | 布拉胡特 | blachut
赫明 | 亨明 | hemming
特文加德姆 | 蒂文加杜姆 | tirvengadum
比斯特 | 比伊斯特 | buist
拉拉莫尔 | 拉腊莫尔 | laramore
福韦尔 | 福尔韦尔 | faulwell
哈克 | 黑克 | hake
哈什哈根 | 哈舍根 | hashagen
赖尔斯 | 赖亚尔斯 | ryalls
特里梅因 | 特里曼 | tremain
梅伦 | 默龙 | merron
贝基 | 巴基 | bakey
鲁兹 | 吕埃 | ruez
怀曼 | 威曼 | wiman
拉德布罗克 | 拉德布鲁克 | ladbroke
恩斯莱格 | 奥恩斯莱格 | oenslager
哈加丁 | 哈格丁 | hargadine
莱基姆 | 利克希姆 | leikhim
沃彻夫特 | 沃特沙夫特 | wirtschafter
艾默斯 | 伊穆斯 | imus
托赫 | 托克 | toch
杜恩特 | 德温特 | dewenter
佩特菲尔德 | 彼得菲尔德 | peterfield
哈雷尔 | 哈勒尔 | harrel
斯普勒 | 施普勒 | spuhler
阿马尼 | 阿尔马尼 | armani
弗莱布 | 弗莱比 | flebbe
汤布斯 | 图姆斯 | tombs
达夫隆 | 杜弗隆 | duflon
谢里克 | 谢雷克 | sherek
贝恩 | 本 | benn
麦基利肯 | 麦基利坎 | mackillican
多里 | 多丽 | dorrie
法努夫 | 法纳夫 | faneuf
罗赫 | 罗奇 | roch
凯尔希纳 | 凯尔克纳 | kelchner
多罗 | 多拉夫 | dorough
菲林 | 法尔林 | firing
克莱姆 | 克莱米 | klemme
费尔 | 费雷 | ferre
安娜贝尔 | 安娜贝勒 | annabelle
布瓦文 | 博伊文 | boivin
福伊西 | 福西 | feusi
江伯格 | 宗伯格 | zumberg
萨加 | 塞格尔 | sagar
恩格兰 | 英格兰 | england
艾琳妮 | 艾琳 | irene
利弗塞奇 | 利弗西奇 | liverseidge
基劳森 | 西劳森 | cilawson
艾德斯梅 | 艾兹莫 | eidsmoe
阿布 | 阿贝 | abbe
博瓦斯方坦 | 博伊斯方丹 | boisfontaine
麦卡尔蒂 | 麦克哈蒂 | mccahearty
麦克芒 | 麦克蒙 | mcmunn
塞弗里 | 萨弗里 | savery
迪波特 | 杜波特 | duport
伯格哈德 | 伯格哈特 | burghard
厄尔普 | 厄普 | earp
蒙多尔 | 蒙多 | mondor
格尔泽 | 盖尔泽 | gelzer
施赖纳 | 施里纳 | shriner
斯塔布尔菲尔德 | 斯塔布菲尔德 | stubblefield
弗皮利厄克斯 | 韦皮勒 | verpilleux
迪安门特 | 迪亚门特 | diament
汤南德 | 汤恩德 | townend
伊内丝 | 伊内兹 | inez
杰彭 | 杰波恩 | jepoen
麦肯恩 | 麦肯 | mackeng
伯肯霍尔茨 | 伯肯霍尔兹 | birkenholtz
默茨 | 默特斯 | mertes
勒克特 | 勒基特 | luckett
伊德 | 伊德尔 | eader
维诺格拉德 | 维诺格勒 | vinograd
安纳格莫尔 | 安纳克莫尔 | annaghmore
斯图德曼 | 斯蒂德曼 | studeman
利利恩 | 勒林 | lelean
布里森 | 布赖森 | bridson
佩尔斯廷 | 皮里斯坦 | pearistine
米达维克 | 马达维赫 | mhadavikh
戈勒布 | 戈卢布 | golub
达拉克 | 杜拉奇 | dullach
杜普卡克 | 杜普恰克 | dupcak
布雷登 | 布拉顿 | bradon
奥奇 | 奥齐 | orczy
贝姆 | 巴姆 | bame
普莱默尔 | 普莱梅尔 | plymale
布罗梅特 | 布罗米特 | bromet
皮科威亚克 | 皮乔维亚克 | piechowiak
沃尔纳 | 沃纳 | woerner
奥雷斯潘 | 奥雷斯坎 | orescan
阿查博尔 | 阿查巴尔 | archabal
格罗贝格 | 格罗伯格 | groberg
西比尔 | 塞比尔 | sebire
普法勒 | 法伊勒 | pfeiler
霍莫尔卡 | 霍穆尔卡 | homolka
海斯伯格 | 海斯堡 | heisborg
费尔德布里尔 | 费德布里尔 | feldbrill
杰农 | 热农 | gernon
斯顿特 | 斯坦特 | stunt
埃莉斯 | 埃莉丝 | elyse
伦格利 | 伦利 | lungley
蒂索 | 泰索 | tysoe
克勒勒 | 克雷勒 | kroehler
谢米宁特 | 切米宁特 | cheminint
迪本 | 德本 | deben
法斯纳赫特 | 法斯纳克特 | fasnacht
布根 | 巴根 | bugan
佩奇 | 皮奇 | pechey
施瓦姆 | 施万布 | schwamb
麦克米克尔 | 麦克迈克尔 | macmichael
奥里 | 奥赖 | ory
埃尔弗里克 | 阿尔弗里克 | aelfric
艾尔加 | 艾尔格 | eylgar
桑纳曼 | 索恩曼 | sonnemann
奥扎妮 | 奥赞 | ozanne
德黑恩 | 德哈恩 | dehaan
雷诺 | 雷纳 | raynor
弗西瓦尔 | 费西瓦尔 | fercival
贝克哈特 | 贝克哈德 | beckhard
松塔格 | 桑塔格 | sontag
阿维洛 | 阿韦洛 | arvelo
塔利奥 | 图利奥 | tullio
梅康 | 梅肯 | macon
格里韦 | 格里纳韦 | greenaway
奥勒 | 阿勒 | aller
戈希 | 戈伊 | gohey
克莱弗 | 克拉弗 | claver
利亚尔 | 莱尔 | lyal
桑萨姆 | 桑森 | sansum
吉吉 | 吉盖 | giggey
达科姆 | 戴科姆 | dacombe
多本 | 多宾 | doben
杰穆特 | 格穆思 | germuth
泰恩什 | 坦什 | tainsh
克雷斯皮尼 | 克雷皮尼 | crespigny
布莱克斯兰 | 布拉克斯兰 | blaxland
比尔基 | 伯基 | buerki
巴贝尔 | 贝布尔 | babell
克拉丽达 | 克拉里达 | clarida
博德威恩 | 博德瓦恩 | bordwine
布朗塔斯 | 布龙塔斯 | brountas
梅耶森 | 迈耶森 | mayerson
德雷沃尔吉拉 | 德沃尔吉拉 | drevorguilla
奥弗拉赫蒂 | 奥弗莱厄蒂 | o'flahertie
塞维 | 西维 | sevey
克拉恩 | 克拉汉 | crahan
博克尔 | 博克 | boker
埃休 | 埃舒 | eshoo
戴布尔 | 戴贝尔 | deibel
马辛库斯 | 马辛克斯 | marcinkus
佩雷兹 | 佩雷斯 | perez
维泽 | 维佐尔 | vizor
蒂利 | 蒂莉 | tillie
赖格 | 里格 | riger
道德 | 多德 | dowd
阿利森 | 艾莉森 | alyson
德雷塞尔 | 德雷斯尔 | dressel
朱利 | 朱莉 | julie
芬格胡特 | 芬格赫特 | fingerhut
丹尼恩 | 达尼恩 | danyon
马休伦 | 马胡兰 | mahuran
佩耶 | 派尔 | peyer
谢赫 | 切赫 | czeh
西尔瓦纳斯 | 西尔维纳斯 | silvanus
埃克斯坦斯 | 埃克斯滕斯 | exstance
艾尼斯 | 安斯 | aines
拉尔肯 | 拉肯 | larken
普萨特里 | 普萨泰里 | pusateri
尼恩 | 奈恩 | nyhen
克利瑟 | 克莱瑟 | cleather
埃迈尔 | 埃米尔 | emyr
沃基特 | 瓦克特 | wackett
阿格内洛 | 阿涅洛 | agnello
伊莱 | 艾莱 | ilay
斯蒂格利茨 | 施蒂格利茨 | stiglitz
塞西利厄斯 | 塞西莉厄斯 | cecilius
尤 | 约 | yoe
纳登 | 内登 | naden
哈姆斯 | 黑姆斯 | hammes
雷贝尔 | 里贝尔 | rebel
查格尔斯 | 查格利斯 | chagles
麦凯克琴 | 麦凯琴 | maceachen
甘南吉安 | 加南吉扬 | ganangiyan
古拉德 | 戈拉德 | goulard
考沃特 | 科沃特 | cowart
格罗杰 | 格罗格 | grogger
怀特利瑟 | 怀特莱瑟 | whiteleather
埃夫勒 | 埃弗勒 | effler
惠特塞特 | 惠特西特 | whitsett
瓦斯默 | 沃斯默 | wasmer
勒克龙 | 莱克龙 | leckrone
波 | 鲍 | pow
拉克歇尔 | 拉克斯尔 | wraxhall
曼柳斯 | 曼利厄斯 | manlius
布里梅科姆 | 布里马科姆 | brimacombe
谢拉 | 希拉 | shelagh
乔弗里翁 | 乔夫里翁 | joffrion
伯恩 | 贝尼 | boehne
德沃拉克 | 德沃夏克 | dvorak
贝纳维德斯 | 贝纳维兹 | benavides
福伊韦克 | 福伊尔沃克 | feuerwerker
塔吉 | 塔姬 | taggy
麦科克 | 麦科奇 | mccoch
蒂姆韦尔 | 泰姆韦尔 | timewell
巴克纳 | 巴赫纳 | bachner
图德霍 | 塔杜 | tudhoe
蒂格雷特 | 泰格雷特 | tigrett
卡迪尤斯 | 卡迪厄 | cadieux
拉克斯顿 | 勒克斯顿 | luxton
纳蒂 | 克努蒂 | knutti
凯嫩 | 凯南 | kainen
德普图克 | 德普塔克 | deptuck
迪特 | 迪特尔 | dieter
莱 | 利 | ley
格尔 | 吉尔 | gehl
迪斯特伯格 | 杜斯特伯格 | duesterberg
科奈因 | 科奈恩 | conein
巴尔诺 | 巴诺 | barno
法雷尔 | 法勒 | farer
格雷博 | 格里博 | grebow
弗里斯 | 弗雷斯 | frece
朗莱因 | 朗莱恩 | longhlein
德斯巴拉茨 | 德巴拉茨 | desbarats
沃拉克 | 沃勒克 | wallack
克兰多尔 | 克兰德尔 | crandall
卡尼尔尼 | 卡奈尔尼 | carnearney
坦嫩鲍姆 | 特南鲍姆 | tennenbaum
霍奇根 | 霍根 | hodgan
莫森 | 莫桑 | morsan
阿杰里斯 | 阿吉里斯 | argeris
明内特 | 明妮特 | minnette
安斯帕彻 | 安斯帕赫尔 | anspacher
亚西诺夫斯基 | 贾西诺斯基 | jasinowski
克雷弗 | 克里弗 | crever
沃尔西奥夫 | 瓦尔塞奥夫 | waltheof
拉普诺 | 拉普阿诺 | rapuano
泰雷尔 | 蒂雷尔 | tyrell
埃尔斯皮 | 伊丽莎白 | elspie
托普尔 | 托佩尔 | topple
塞姆斯 | 泰晤士 | thames
斯维克 | 斯韦克 | svec
斯坦布罗 | 斯坦伯勒 | stanbrough
肯奈尔德 | 肯奈德 | kennaird
莱克拉斯 | 勒克拉 | lecras
安德琳 | 安德林 | andelin
斯普赖尔 | 斯普雷耶 | spreyer
艾克纳 | 艾希纳 | eichner
费罗 | 费劳 | ferrao
杜雷 | 杜里 | durey
奥弗拉赫蒂 | 奥弗莱厄蒂 | o'flaherty
邦恩斯蒂尔 | 博恩斯蒂尔 | bonesteel
克里恩 | 克林 | crean
萨马鲁奥 | 萨马鲁 | samaroo
伯格万 | 伯格文 | bergevin
皮尔克 | 珀基 | pyrke
恩布林 | 恩布琳 | emblin
卡尔索普 | 考尔索普 | calthorpe
罗维塔 | 罗韦塔 | rovetta
森 | 特森 | thesen
吉尔德豪姆 | 吉尔多姆 | guildhaume
法纽伊尔 | 法纳尔 | faneuil
蕾塔 | 里塔 | rheta
波 | 普 | poo
伯尼特 | 伯内特 | burnett
里查特 | 理查特 | richart
朗尼加 | 朗内加 | runnegar
卡莎 | 卡撒 | cartha
多尔格 | 德尔格 | dolger
赫比斯特赖特 | 赫布斯特雷特 | herbestreit
赫尔斯顿 | 赫尔斯特恩 | hellstern
普莱斯顿 | 普利斯顿 | puleston
埃杰曼 | 埃格曼 | egerman
迪林 | 迪尔林 | deerlin
科森 | 科瑟恩 | cothern
埃尔韦斯 | 埃尔威斯 | elwes
塔弗 | 塔沃尔 | tavor
韦赫尔 | 韦伊尔 | weiher
科格韦尔 | 科格斯韦尔 | cogswell
韦特 | 维特尔 | vetter
赫米恩 | 赫米奥娜 | hermione
约翰森 | 约翰逊 | johnson
杭德里奇 | 杭德里克 | honderich
劳赫林 | 劳克林 | laughlin
利伯丁 | 利伯蒂娜 | libertine
达利佩齐 | 达莱佩泽 | dallepezze
梅尔斯特拉普 | 迈尔斯特勒普 | meilstrup
朗塞利特斯 | 朗斯利特斯 | launceletus
埃德利 | 埃德尔 | ederle
阿迪奥 | 阿德奥 | addeo
韦恩 | 惠恩 | whayne
科莫尼亚克 | 科莫尼亚雷克 | komoniarek
格恩斯巴克 | 根斯巴克 | gernsback
贝塔 | 伯塔 | berta
比尔 | 伯尔 | birr
邓坎森 | 邓肯森 | duncanson
格拉迪克斯 | 格拉迪厄 | gladieux
高迪安 | 高迪恩 | gaudian
迪尔 | 代尔 | diel
迪撒里希 | 迪特里希 | diethrich
迪海 | 德海 | dehay
布拉米尔斯 | 布拉迈尔斯 | blamires
迈斯利希 | 迈斯利奇 | meislich
马斯凯廷 | 马斯卡廷 | muscatine
沃索 | 瓦索 | wasow
吉尔迪 | 吉亚尔迪 | ghiardi
阿勒姆 | 奥勒姆 | allam
博迪科姆 | 博迪库姆 | bodycombe
施韦尔布 | 施韦布 | schwelb
贾丁 | 杰丁 | jadyn
伊泽尔 | 艾泽努尔 | izenour
哥 | 高 | gow
拉纳夫 | 雷纳夫 | ranulph
特里里斯 | 特里赖斯 | trerise
罗恩 | 龙尼 | ronne
平乔 | 平肖 | pinchot
费格特 | 范格特 | fanget
伊尔格 | 伊尔克 | ilg
查森 | 蔡森 | chasen
科佩拉 | 科皮拉 | coppela
茹拉巴安 | 朱拉布奇安 | joorabchian
斯顿博 | 斯通博 | stombaugh
斯拉特里 | 斯莱特里 | slattery
厄尔马思 | 厄马思 | earmarth
希拉克 | 希莱克 | shillaker
贝格尔曼 | 比格尔曼 | begelman
休金斯 | 哈金斯 | hugghins
梅约 | 梅奥 | mayo
杜纳文特 | 杜纳万特 | dunavant
基珀斯 | 凯珀斯 | kuipers
麦卡勒里 | 麦卡利里 | mcalery
贝斯托克 | 贝尔斯托克 | behrstock
米吉尔 | 迈伊尔 | mighill
赫曼 | 希曼 | heman
恩斯拉德 | 恩斯鲁德 | ensrud
布罗瑟 | 布拉泽 | brother
辛尼 | 锡恩 | thynne
弗里斯 | 弗里亚斯 | freas
皮尼 | 派尼 | piney
布里安 | 布赖恩 | brian
勒滕德尔 | 勒滕德 | letendre
利特伯恩 | 莱特伯恩 | lightbourne
杰斯 | 杰西 | jesse
奥德里 | 奥德丽 | audrey
英奇坎 | 英奇昆 | inchiquin
勒彭内克 | 勒佩内克 | lepennec
津巴尔多 | 津巴多 | zimbardo
多嫩菲尔德 | 多宁费尔德 | donenfeld
沃尔德雷普 | 沃尔德里普 | waldrep
德马西奥 | 德马肖 | demascio
穆科夫斯基 | 穆科斯基 | mukowski
泽凯拉 | 泽克拉 | zechella
考莉 | 凯莉 | kallie
斯凯特 | 斯卡特 | skate
麦吉尔沃 | 麦吉尔伍尔 | macgillvoor
鲍古德 | 布古尔 | bougourd
塞文 | 西文 | sevin
尤曼斯基 | 乌曼斯基 | umansky
希德利 | 黑德利 | headley
欣因 | 希恩 | shinn
庞纳珀拉马 | 庞南佩鲁马 | ponnamperuma
米曾 | 迈曾 | mizen
洛梅尔 | 隆梅尔 | lommel
马赫 | 马奇 | much
金尼弗 | 珍妮弗 | gennifer
查萨尼斯 | 沙萨涅 | chassagnes
艾尤托 | 阿尤托 | aiuto
布克鲁德 | 鲍赫鲁德 | boughrood
吉隆 | 吉伦 | gillon
多沃德 | 道尔德 | doward
基尔里 | 基里 | kearey
沃克 | 瓦克尔 | wacker
卢易乌 | 路易祖 | louizou
弗兰兹 | 弗朗兹 | franz
米泽尔 | 米泽勒 | mizelle
托雷斯 | 托里斯 | torres
沃利本 | 沃莱本 | wohlleben
普尔茨格拉夫 | 法尔茨格拉夫 | pfaltzgraff
玛丽恩 | 马里恩 | maryon
沃申科 | 瓦申科 | washenko
博尼特 | 博内特 | bonett
伊利特 | 艾利特 | ilett
马库斯 | 马库塞 | marcuse
欧明格 | 艾尔明格 | irminger
伊布斯利 | 耶布斯利 | yeabsley
阿伦 | 艾伦 | allen
布贾克 | 布亚克 | bujake
艾桑巴德 | 伊桑巴德 | isambard
约瑟姆 | 乔撒姆 | jotham
加诺 | 加诺特 | garnaut
温切尔茜亚 | 温切尔西 | winchelsea
高卡斯 | 古奥卡斯 | guokas
迪特特 | 迪泰特 | dittert
达尔菲 | 德菲 | durfee
菲查尔温 | 菲茨艾尔温 | fitzailwyn
埃迪逊 | 埃迪森 | eddison
希金博瑟姆 | 希金博特姆 | higinbotham
登宁 | 丹宁 | denning
马杰 | 马季 | marj
布加斯 | 巴加斯 | bugas
埃奇达尔 | 埃奇代尔 | edgedal
本内特 | 贝内特 | bennete
贝罗尔 | 伯罗尔 | berall
图里基安 | 图雷基安 | turekian
凯特伦 | 卡特伦 | catron
斯威特凯 | 斯威凯 | switkay
索布洛夫 | 索贝洛夫 | sobeloff
兹巴斯基 | 兹巴尔斯基 | zbarskiy
麦卡西克 | 麦库西克 | mckusick
贝格尔 | 贝尔 | beighle
梅奥 | 梅约 | maio
图利耶 | 特威利尔 | thuillier
戴亚曼特 | 迪亚曼特 | diamant
弗里达 | 弗雷达 | freda
诺森普顿 | 诺桑普顿 | northampton
尼迪 | 内迪 | neddie
赫伦布兰德 | 海伦布兰德 | hellenbrand
厄布 | 厄尔布 | erb
吉妮 | 吉尼 | genee
茜茜 | 锡西 | cissie
莱兰 | 利兰 | lelland
弗雷德丽卡 | 弗雷德里卡 | fredrica
奇瓦蒂罗 | 奇瓦特罗 | chivatero
温泽尔 | 温策尔 | wenzel
巴蒙特 | 贝蒙特 | bamont
奥尔德希泽 | 奥尔迪泽 | aldhizer
洛弗林 | 洛夫林 | lovering
纳根 | 纳金 | nagean
姆利纳基克 | 姆利纳奇克 | mlinarchik
道兹韦尔 | 多德斯韦尔 | dowdeswell
德尔 | 杜尔 | durr
米齐 | 梅齐 | meazey
尤特 | 尤思 | uthe
斯坦纳 | 斯蒂纳 | stiner
扬克威奇 | 扬克维奇 | yankwich
赛格尔 | 西格尔 | sigel
萨奇曼 | 塞奇曼 | sageman
克尔切维尔 | 克切维尔 | kercheville
德西雷 | 德西蕾 | desiree
奎利 | 丘利 | kewley
乔瑟林 | 乔斯林 | josselyn
休什 | 休伊什 | huish
比昂 | 拜昂 | bion
加哈根 | 加黑根 | gahagen
麦金图夫 | 麦金塔夫 | mcinturff
莫福德 | 莫维兹 | morfudd
桑克利 | 尚克利 | sankley
罗马因 | 罗曼 | romaine
萨马拉 | 赛马拉 | saemala
怀斯坦 | 威斯坦 | wystan
吉尔哈利 | 吉尔胡利 | gilhuly
博德瓦恩 | 鲍德温 | bodwine
勒斯 | 卢斯 | luss
霍博利 | 霍巴利 | horbaly
莱瑟夫 | 勒瑟夫 | lesurf
查伦格 | 查林杰 | challenger
塞特 | 撒特 | thaete
约基尔森 | 约克尔森 | yochelson
弗朗西娅 | 弗朗西亚 | francia
亨特雷斯 | 亨特里斯 | huntress
图瓦嫩 | 蒂乌萨宁 | tiusanen
米尔温 | 米尔德文 | mildvan
金凯尔尼 | 金凯尼 | kincairney
马斯曼 | 穆斯曼 | mussman
沃伦 | 沃尔龙德 | walrond
蒙塔文 | 蒙塔冯 | montavon
阿尔韦尔 | 奥尔韦尔 | alwell
萨奇 | 萨特杰 | satge
吉龙 | 吉伦 | gearon
贾尼斯 | 贾尼西 | janisse
迪西 | 达西 | duthie
加汉 | 加恩 | gahan
德拉波 | 德拉珀 | drapeau
霍奇特 | 霍贾特 | hodgart
桑比 | 桑德比 | saundby
德斯布伊斯 | 德布瓦 | desbois
斯韦布 | 斯韦比 | swaebe
弗鲁伊特 | 弗鲁特 | fruit
伊利恩 | 伊尔伦 | illearn
阿布洛姆 | 阿布隆 | ablom
埃斯梅尔 | 伊斯梅尔 | esmail
沃滕伯格 | 瓦滕伯格 | wattenberg
安东尼斯 | 安图尼斯 | antunes
阿迪内特 | 阿迪尼特 | adinet
邓科姆 | 邓库姆 | duncombe
吉尔克雷斯特 | 吉尔克里斯特 | gilchrest
霍耶利贝克 | 胡尔贝克 | houiellebecq
布希 | 布舍 | busche
米迪奇 | 梅迪奇 | meditch
布吕恩 | 布鲁恩 | bruene
比伊 | 布伊 | buie
马尔欣 | 马尔夏恩 | mulshine
埃莱克特拉 | 伊莱克特拉 | electra
查费茨 | 查菲茨 | chafetz
塞米斯 | 瑟缪斯 | sermeus
安杰莱斯 | 安杰利斯 | angeles
艾肯 | 伊坎 | icahn
罗厄尔 | 鲁埃尔 | reuel
桑 | 图恩 | thun
泰瑟 | 特瑟 | tether
沙帕特 | 查帕特 | tschappat
海森 | 希森 | hyson
吉诺尔 | 格瑙尔 | genauer
克莱夫 | 克拉夫 | clave
蒙东纳 | 蒙顿纳 | montonna
卡莎 | 卡沙 | kasha
马拉布尔 | 梅拉伯 | malabre
苏里纳 | 苏雷纳 | surena
里德尼厄斯 | 雷德尼厄斯 | redenius
利希特沃特 | 利希特瓦尔特 | lichtwardt
奥弗罗尔 | 奥费拉尔 | o'ferrall
马琴 | 梅琴 | machen
塔斯切罗 | 塔什罗 | taschereau
埃廷杰 | 埃廷格 | ettinger
福尔维 | 法尔维 | falvey
查彭 | 沙蓬 | chapone
林迪 | 琳迪 | lynndie
多努迈尔 | 多诺莫尔 | donoughmore
卡琳 | 卡莱恩 | carline
甘博阿 | 甘博亚 | gamboa
巴蒂泽尔 | 巴蒂扎尔 | bartizal
费耶 | 费尔 | fayer
康伯 | 库默 | comber
赫施 | 胡希 | husch
尤泽 | 尤伊泽 | ueyser
奥拉 | 奥尔拉 | orla
卡丹 | 卡登 | kadane
阿夫伯里 | 埃夫伯里 | avebury
维拉洛洛斯 | 比利亚洛沃斯 | villalobos
卢什 | 勒什 | lush
迪达姆 | 迪德姆 | deedham
纳尔 | 诺尔 | nall
格特威思 | 格特沃思 | gutwirth
斯特朗伯格 | 斯特龙伯格 | stromberg
格维茨 | 格威茨 | gurwitz
德梅特 | 德梅特尔 | demaitre
哈特内特 | 哈特尼特 | hartnett
汤姆兰 | 汤姆林 | tomline
贝尔里 | 比尔里 | beary
达姆勒 | 杜姆勒 | dumler
莱奥尼达斯 | 利奥尼达斯 | leonidas
海因菲尔德 | 汉费尔德 | hainfeld
加勒蒂 | 加拉蒂 | garraty
沃拉 | 瓦拉 | walla
斯托尼克 | 斯托尔内克 | stalnecker
萨莱尔 | 萨勒 | saller
马杰里 | 马格丽 | margery
贝沃尔德 | 贝瓦尔德 | baerwald
盖伊 | 贾伊 | ghey
雷姆斯 | 里姆斯 | rheims
蒙特姆 | 蒙特卡姆 | montcalm
普拉格 | 普拉奇 | plugge
基乔阿 | 凯乔 | kejoa
博斯顿 | 波士顿 | boston
杜布纳 | 达布纳 | dubner
赫芬 | 赫法恩 | huffine
梅尔韦瑟 | 梅里韦瑟 | mereweather
瑟西 | 塞希 | sershey
埃诺 | 伊诺 | eno
塞利格曼 | 塞利希曼 | seligmann
加韦德 | 加维德 | gaved
科奇尼希 | 科奇尼格 | kotschnig
斯特雷姆劳 | 斯特里姆劳 | stremlau
拜尔 | 贝耶尔 | beier
塞瓦克 | 瑟瓦奇 | serwach
阿菲 | 埃菲 | afee
西德博特姆 | 赛德博特姆 | sidebotham
格德 | 格尔德 | gerd
埃克洛夫 | 埃克勒夫 | eklof
博格特 | 博格蒂尔 | boghatyr
芬格勒 | 芬勒 | fengler
豪谢尔 | 霍恩谢尔 | hounshell
伊德弗里德 | 埃德弗里德 | eadfrid
奥因 | 约恩 | eoin
索 | 托 | thau
西德尼 | 西妮 | sydni
德西德拉塔 | 德西德蕾塔 | desiderata
茹埃特 | 朱厄特 | jouett
班顿 | 贝恩顿 | baynton
塞格尔 | 西格尔 | seigel
勒费弗 | 勒费布尔 | lefebvre
沃伊格特 | 沃伊特 | voigt
约克威廉斯 | 约克威廉 | yorkwilliams
塞尔娜 | 塞尔纳 | serna
伦嫩 | 伦南 | lennen
弗雷伊 | 弗雷 | frej
阿伯恩 | 阿本 | abern
迪安尼斯 | 迪亚尼斯 | dianis
杰塞里奇 | 杰塞里克 | jeserich
希格内特 | 希格尼特 | hignett
杜庞特 | 杜邦 | dupont
克利姆克 | 克利姆基 | klimcke
赫尔布尔 | 赫布尔 | helble
比尔布罗 | 比尔伯勒 | bilbrough
昂布赖特 | 昂布里特 | umbreit
布劳恩 | 布朗 | browne
凯加夫 | 凯加鲁 | caegarw
赫沃斯 | 休沃斯 | huvos
萨姆斯特格 | 扎姆斯塔格 | samstag
贾格斯 | 贾格尔斯 | jaggers
凯斯 | 基斯 | keys
萨基纳 | 萨金娜 | sakinah
勒福 | 勒方 | lefaune
拉夫斯胡恩 | 拉夫肖恩 | rafshoon
贝曼 | 比曼 | beman
瑟弗特 | 索伊弗特 | seufert
史特里文斯 | 斯特雷文斯 | strevens
斯坦纳姆 | 斯塔纳姆 | stanham
阿克蒂恩 | 埃克申 | action
梅因沙因 | 梅恩沙因 | maienschein
桑兹 | 桑德斯 | sondes
班格 | 班 | bang
穆普森 | 马普森 | mupson
埃尔利 | 埃尔勒 | ehrle
勒克赫斯特 | 卢克赫斯特 | luckhurst
卡罗尔 | 卡萝尔 | carole
埃丁杰 | 埃丁格 | edinger
麦高兰 | 麦戈兰 | mcgauran
登帕赛 | 登帕西 | dempasay
马格尼 | 马格内 | magnay
法尔肯布里奇 | 福尔肯布里奇 | falconbridge
马库斯 | 马克斯 | marcuss
穆恩 | 穆安 | muan
格林斯特德 | 格林斯蒂德 | grinstead
阿尔文 | 奥尔文 | allvine
欣德尼斯 | 莱因德尼斯 | rhindness
米多斯 | 梅多斯 | meadows
帕德西 | 帕齐 | pudsey
罗勒夫斯 | 罗卢夫斯 | rolufs
切诺维奇 | 切尔诺维奇 | cernovitch
凯思琳 | 凯瑟琳 | cathryn
奈斯利 | 尼斯利 | knisely
莱加特 | 莱格特 | legatt
尼科莱迪斯 | 尼古拉迪斯 | nikolaidis
贝特拉 | 伯特拉 | bertera
芒尼克威森 | 芒尼克海森 | munnikhuysen
奇尔德 | 蔡尔德 | child
尤科维茨 | 尤尔科维茨 | jurkowitz
鲁宾斯坦 | 鲁本斯坦 | rubenstein
谢尤 | 舍韦 | schewe
麦农金 | 麦克琼金 | mcjunkin
拉贝特 | 拉贝 | rabet
麦克法迪安 | 麦克法迪恩 | mcfadyean
卢内德 | 莉内德 | luned
库明 | 卡明 | cumin
乔莫 | 肖莫 | chomeau
科拉斯 | 科雷斯 | corace
科克兰 | 科克伦 | cochrane
布鲁赞娜 | 布尔扎纳 | brzana
莫尔霍尔特 | 莫霍尔特 | molholt
阿加西亚 | 阿加西娅 | agacia
梅佩尔 | 马佩尔 | mapel
西克斯 | 赛克斯 | sikes
布兰特里 | 布伦特里 | braintree
钱伯尔辛 | 钱伯辛 | chamberlsin
格青格 | 格青杰 | getsinger
英格尔比 | 英吉尔比 | ingilby
欧维特 | 艾尔薇特 | irvette
艾舍伍德 | 伊舍伍德 | isherwood
德尼奥 | 迪奈欧 | denio
卡琳纳 | 卡伦娜 | karenna
基尔 | 基利 | kille
奥西内尔 | 奥塞内尔 | othenel
马尼奥利亚 | 马格诺利娅 | magnolia
索瑟登 | 萨瑟登 | southerden
埃莱斯梅尔 | 埃尔斯米尔 | ellesmere
戴西 | 黛西 | daisy
戈迪夫 | 戈德夫 | godefe
克里斯图 | 克里斯戈 | christgau
奥科因 | 奥库安 | aucoin
休尔塔 | 许尔塔 | huerta
彼得罗 | 佩特罗 | petro
诺科伊 | 诺基 | norquoy
马克厄姆 | 梅卡姆 | makeham
斯特罗布里奇 | 斯特劳布里奇 | strawbridge
希肯洛珀 | 希肯卢珀 | hickenlooper
巴尔塔萨 | 巴尔塔泽 | baltassar
迪克 | 杜凯 | duque
海尔凯 | 海尔基 | heilkay
弗利金格 | 弗利金杰 | flickinger
泽比娜 | 泽拜纳 | zebina
布拉夫 | 布劳 | blough
格拉斯戈 | 格拉斯哥 | glasgow
赫钦格 | 赫金杰 | hechinger
斯梅耶 | 斯梅奇 | smaje
奥利文特 | 奥利万特 | ollivant
戈洛琴科 | 戈洛夫琴科 | golovchenko
布利肯施塔夫 | 布利肯斯塔夫 | blickenstaff
麦克莱莫尔 | 麦克勒莫尔 | mclemore
麦克费德兰 | 麦克费德伦 | macphedran
奥迪吉尔 | 奥迪吉耶 | audigier
赫蒙 | 哈蒙 | hummon
伯特豪德 | 伯绍德 | berthoud
奥尔卡德 | 阿尔卡德 | alcalde
比奥利 | 比利 | beoley
古比托什 | 古比托西 | gubitoshi
比塔 | 比塔尔 | bitar
洛伊 | 洛 | loew
耶登 | 伊登 | yeadon
杜尔维奇 | 达利奇 | dulwich
格罗塞特 | 格罗斯泰特 | grosseteste
洛基尔 | 洛希尔 | lochiel
弗里尔 | 弗雷耶 | freyere
斯康菲尔德 | 舍恩菲尔德 | schonfield
斯托尔普曼 | 施托尔普曼 | stolpman
弗兰普欣 | 弗兰普申 | framption
博雷特 | 博里特 | borrett
迈克尔约翰 | 米克尔约翰 | meiklejohn
费切姆 | 费克姆 | feachem
拉坎派涅 | 拉康帕涅 | lacampagne
索维奇 | 索瓦热 | sauvage
赫曼 | 赫尔曼 | herman
古布尔曼 | 古贝尔曼 | gubelmann
科帕德 | 科珀德 | coppard
盖曼 | 格曼 | gehman
埃尔齐 | 埃尔扎伊 | elzay
巴思 | 巴特 | barthe
埃斯科菲 | 伊斯科菲 | escoffey
吉利亚姆 | 吉列姆 | gilliam
皮尔 | 皮埃尔 | pierre
博施威茨 | 博希威茨 | boschwitz
哈德格里 | 哈迪格里 | hardegree
皮尔 | 珀尔 | pearl
维拉雷尔 | 维拉里尔 | villarreal
洛西安 | 洛西恩 | lowthian
多姆曼 | 多米扬 | domjan
阿利斯 | 阿莱斯 | allies
休伊泽 | 哈伊泽 | huyser
尚巴斯 | 钱巴斯 | chambas
康马格 | 康马杰 | commager
卡拉佩蒂安 | 卡拉佩琴 | carapetyan
布里宁 | 布赖宁 | bryning
格利多尔 | 格利德尔 | gleadall
麦克琴 | 麦克钦 | mccheane
丹尼斯 | 德尼斯 | deneys
特洛 | 特略 | tello
纽伯勒 | 纽伯格 | newburgh
威克斯蒂德 | 威克斯第德 | wicksteed
维斯洛斯基 | 维斯克洛斯基 | visclosky
斯科格伦 | 斯科格隆 | skoglund
海尔兹 | 希尔兹 | hilds
拉萨尔 | 拉萨 | lassar
万诺伊 | 范诺伊 | vannoy
温塔尔 | 温特尔 | weintal
贾夫 | 贾菲 | jaffe
斯塔姆 | 施塔姆 | stamm
法扎 | 法扎尔 | fazar
萨西妮 | 萨西尼 | sassienie
玛塞尔 | 玛塞勒 | marcelle
尤因斯 | 尤温斯 | uwins
切谢尔斯基 | 切赫尔斯基 | cehelsky
尤莱维奇 | 乌莱维奇 | ulevich
康尼利 | 康奈利 | conneally
勒肯 | 卢肯 | lukken
德黑斯 | 德海斯 | dehayes
马顿 | 梅顿 | maton
希拉 | 夏伊拉 | shyla
比恩 | 比汉 | beehan
斯普斯 | 斯波斯 | spouse
洛恩 | 洛温 | lowen
伊尼戈 | 奇尼戈 | chinigo
伊利希 | 伊利格 | illig
贝默赛德 | 比默赛德 | bemersyde
米姆诺 | 明诺 | mimno
布平达 | 布平达尔 | bhupindar
罗明 | 罗梅因 | romeyn
塔尔博克斯 | 塔博克斯 | tarbox
扬格斯班德 | 扬哈斯本 | younghusband
夏皮 | 沙比 | sharpey
勒热 | 勒萨热 | lesage
巴布利斯 | 布勃利斯 | bublys
辛皮克 | 辛皮奇 | simpich
西德福 | 塞德福德 | thedford
伯特霍尔夫 | 伯索夫 | bertholf
塞迪亚 | 切迪亚 | ceddia
戴文波特 | 达文波特 | davenport
舒特利夫 | 舒特莱夫 | shurtleff
乔齐 | 乔茜 | jozy
迪安 | 戴安 | dian
马霍恩 | 马洪 | mahone
科尔特 | 库尔特 | coult
劳克哈夫 | 劳卡夫 | laukhuff
米尔希 | 米尔海 | milhy
卡德根 | 卡杜根 | cadwgan
博希尔 | 博舍尔 | boshier
斯克里伯 | 斯克赖伯 | scriber
博维 | 博韦 | bovee
赫克顿 | 赫克通 | hektoen
列薇 | 利瓦伊 | levi
查斯 | 蔡斯 | chayes
克里亚 | 克雷 | crea
乔尔万 | 朱尔万 | joulwan
卡佐克里亚 | 库佐克雷亚 | cuzzocrea
韦德伍德 | 韦奇伍德 | wedgwood
克拉茨 | 克卢茨 | clutz
阿德基森 | 阿基森 | adkisson
施莱 | 施利 | schlie
艾菲根 | 伊菲吉妮 | iphigene
塞金格 | 塞金杰 | seckinger
泰菲恩 | 泰维恩 | teifion
格里菲尔 | 格里费尔 | griffel
本贾明 | 本杰明 | benjamin
戈妮娅 | 戈尼亚 | gonya
菲施利斯 | 菲谢利斯 | fischelis
拉罗姆 | 拉勒姆 | larom
坎帕因 | 坎佩恩 | campaigne
格茨威勒 | 古茨维勒 | gutzwiller
斯特芬斯 | 斯蒂芬斯 | steffens
勒金 | 勒德金 | ludgin
阿尔皮娜 | 阿尔皮纳 | alpina
韦勒尔 | 沃雷尔 | werrell
福尔兹 | 福尔茨 | folz
德福德 | 德福特 | deford
博比萨德 | 博比苏德 | bobisud
图尔利 | 特尔 | tourle
图利特 | 塔利特 | tulett
斯塔克 | 斯图克 | stucke
斯康伯格 | 舍恩伯格 | schonberger
兰贝利特 | 兰伯利特 | lambelet
盖伊 | 贾伊 | gye
布卢默菲尔德 | 布卢姆菲尔德 | blumefield
利希滕斯坦 | 利克滕斯坦 | liechtenstein
安德鲁斯凯奇 | 安德鲁斯克维奇 | andruskevich
托德雷斯 | 托德雷亚斯 | todreas
布金 | 布尔金 | bourgin
泰林厄姆 | 蒂林厄姆 | tyringham
兰迈德 | 兰梅德 | langmaid
比尤 | 布埃 | bue
奥尔钦 | 阿尔钦 | alchin
阿维斯 | 阿维丝 | aveis
黑吉斯 | 海吉斯 | haigis
基珀 | 凯珀 | kuiper
斯特兰格 | 斯特兰杰 | stranger
阿伦 | 阿龙 | aaron
马尔克斯 | 马尔库斯 | malkus
杜奇 | 杜格 | dhooge
齐恩 | 蔡恩 | zion
格尔巴赫 | 盖尔博 | gelbach
布雷克兰 | 布里克兰 | brekland
比哈拉 | 布阿哈拉 | buachalla
沃尔克 | 沃克 | walke
考特尼 | 考特妮 | kourtney
库尔 | 屈尔 | kuehl
比利埃 | 比埃 | billiere
埃尔杰 | 埃尔格 | elger
曼恩 | 曼 | mann
埃尔坎 | 埃尔肯 | elkan
赫齐娜 | 赫齐纳 | herzina
施纳克 | 施努克 | schnuck
普钦斯基 | 普辛斯基 | pucinski
佩金 | 帕金 | pagin
尼古利 | 尼古拉 | nicolay
塔图莱斯 | 塔图尔斯 | tatooles
瑟里尔斯 | 塞里尔斯 | serrills
威尔茜 | 威尔西 | willsie
撒尔肯 | 萨尔肯 | thalken
基米特 | 金米特 | kimmitt
克罗斯门 | 克罗斯蒙 | croasmun
赖津 | 里津 | ryzin
卡德韦尔 | 库尔德韦尔 | couldwell
伯娜 | 伯纳 | berna
索莱兹 | 索莱 | saulez
斯坦齐克 | 斯坦奇克 | stanczyk
保林 | 波林 | paulin
梅达华 | 梅达沃 | medawar
巴托尔缪 | 巴托洛缪 | bartholemeu
安德里纳 | 安德里娜 | andrina
柯克 | 瑟克 | cirker
德文特 | 德温特 | derwent
恩德科特 | 恩迪科特 | endecott
阿尔文 | 阿尔温 | alwin
拉索姆 | 莱瑟姆 | lathom
霍伊塞尔 | 休塞尔 | heusel
莱弗拉 | 莱弗拉尔 | leflar
罗莎佩普 | 罗萨皮普 | rosapepe
亨宁格伯格 | 赫宁堡 | heningburg
盖泽 | 盖瑟 | gaisser
巴萨德尔 | 巴萨德雷 | basadre
福伊泽格 | 福伊尔齐格 | feuerzeig
派约特 | 派奥特 | pyott
塞勒斯 | 塞拉斯 | sellars
梅勒普斯 | 梅拉普斯 | mellups
马拉奇 | 马拉克 | malach
巴尔西格 | 巴尔西杰 | balsiger
希拉伯 | 希莱伯 | shillaber
斯卡普西特 | 斯卡尔普西特 | sculpsit
休马森 | 赫马森 | humason
斯特夫斯 | 斯特弗斯 | steffes
卡斯特伯里 | 卡斯尔伯里 | castelberry
吉尔鲍德 | 吉尔博 | guillebaud
贝谢特 | 贝谢 | bechet
梅利奥尔 | 梅莉奥尔 | melior
鲁马塞特 | 罗马塞特 | roumasset
克尔切弗 | 克切弗 | kerchever
比阿特丽娅 | 比阿特丽西娅 | beatricia
福法尔 | 福法 | forfar
梅努欣 | 梅纽因 | menuhin
凯格 | 基格 | keig
菲阿尔卡 | 菲亚尔卡 | fialka
伊萨科 | 伊萨科夫 | isakow
皮尔 | 菲尔 | phear
兹沃 | 兹瓦尔 | zwar
克伦西克 | 赫伦奇克 | chrencik
尼莎 | 尼萨 | neysa
彭沃尔特 | 佩恩沃尔特 | pennwalt
塔锡 | 塔西 | tassie
库塞维茨基 | 科乌谢维茨基 | koussevitzky
布勒宁 | 布罗宁 | broening
伊尔特德 | 伊尔蒂德 | illtud
弗罗斯 | 弗勒泽 | froese
阿什利 | 阿什莉 | ashleigh
弗拉赫蒂 | 弗莱厄蒂 | flaherty
诺克斯 | 努克斯 | nokes
恰鲁奇 | 基亚鲁奇 | chiarucci
休尔默 | 瑟默 | thuermer
舍戈尔斯 | 舍加尔斯 | shergals
贝格鲁普 | 贝格特鲁普 | begtrup
杜克诺伊 | 迪克努瓦 | duquenoy
托里约斯 | 托里霍斯 | torrijos
柯彻 | 基尔舍 | kircher
斯托岑巴赫 | 斯托曾巴赫 | stolzenbach
柯蒂斯 | 柯蒂兹 | curtiz
杜贝格 | 杜伯格 | duberg
马德里德 | 马德里 | madrid
唐恩 | 唐 | donn
凯特尔比 | 基特尔比 | ketelbey
怀甘特 | 威甘特 | wygant
博弗里 | 博韦里 | boverie
贝勒 | 贝利 | behle
阿莱格拉 | 阿利格拉 | allegra
赖克沃特 | 里克沃特 | rykwert
奥法雷尔 | 奥法雷 | o'farrell
利宁 | 吕宁 | luening
特金 | 图尔金 | turkin
西尔里 | 蒂里 | thierry
阿斯登 | 阿斯普登 | aspden
乔西 | 约瑟 | josee
施赖伯 | 施里伯 | shriber
迈斯兰 | 迈斯拉恩 | meislahn
德拜尔 | 德比尔 | derbyl
格尔纳 | 盖尔纳 | gellner
西叙尔 | 塞克索尔 | sexauer
高因 | 高英 | gowing
本尼 | 贝恩 | benne
科斯 | 库斯 | coes
斯库斯 | 斯丘斯 | skuce
穆斯 | 缪斯 | muse
霍维克斯布罗克 | 哈维克斯布罗克 | hawixbrock
古恩希利 | 贡希利 | goonhilly
哈里尔 | 哈丽尔 | harriel
奎恩 | 奎因 | queen
塞塞尔 | 塞斯尔 | sessel
尼纳纳基斯 | 尼奥纳基斯 | nionakis
费尔马纳 | 费尔曼纳 | fairmaner
法尔斯 | 法伊尔斯 | fyles
阿尔西弗伦 | 阿尔西弗龙 | alciphron
特雷西 | 特蕾西 | tracey
若克 | 吉奥克 | giauque
库蒂斯 | 柯蒂斯 | kurtis
乌斯勒 | 奥斯勒 | oursler
埃尼德 | 伊妮德 | enid
萨尔金特 | 瑟金特 | searjeant
拉金 | 莱金 | laging
克里兹曼 | 克里斯曼 | chrisman
斯康伯格 | 舍恩伯格 | schonberg
米特夫 | 米采夫 | mitseff
范格 | 范杰 | fanger
布兰肯 | 布兰昌 | blanchan
霍尔迪曼德 | 哈尔迪曼德 | haldimand
吉利亚斯 | 吉利亚姆 | guilliams
多奇 | 道奇 | dodge
斯威恩 | 斯温 | sween
弗赖赖克 | 弗赖雷克 | freireich
菲克 | 费克 | feake
戈姆斯普拉塔 | 戈梅斯普拉塔 | gomezplata
布治伊斯 | 布儒瓦 | bourgeois
罗伊巴尔 | 罗伊鲍尔 | roybal
布谢夫 | 布舒夫 | bushueff
萨吉塔里厄斯 | 萨吉泰里厄斯 | sagittarius
比克 | 贝克 | beek
福斯 | 富斯 | fuoss
雷努德 | 伦瓦尔 | renouard
希拉斯 | 希勒斯 | heelas
卡尔德卢 | 考尔德克拉夫 | caldcleugh
克拉格 | 克莱格 | clague
雅西娜 | 杰西纳 | jacyna
切什尔 | 切斯希尔 | chesshyre
朗斯伯格 | 劳恩斯伯格 | lounsburg
布雷钦 | 布里金 | brechin
古德勒姆 | 古德哈姆 | gooderham
巴尔恩 | 鲍恩 | balne
霍普 | 霍伊普 | heup
博尔苏克 | 博苏克 | borsook
希曼娜 | 希曼纳 | sheemanna
阿德查尼奇 | 阿德查尼克 | ardcharnich
贝迪利恩 | 贝迪利翁 | bedillion
斯迈思 | 史密斯 | smyth
里道特 | 赖德奥特 | rideout
麦考斯兰 | 麦考斯伦 | mcauslan
彼阿罗斯 | 皮特罗斯 | peatross
马特奥 | 马泰奥 | matteo
乔格伦 | 肖格伦 | sjogren
多罗西 | 多萝西 | dorothy
斯陶布 | 斯托布 | staub
斯塔宾 | 斯图宾 | stubbing
索洛茨 | 索尔特斯 | solotesz
坎普施罗 | 坎普施罗尔 | kampschror
坦普拉 | 坦普勒 | templar
德斯马托 | 德马尔托 | desmarteau
谢尔普 | 谢普 | shairp
格赖德 | 格雷德 | greider
伯德塞尔 | 伯塞尔 | birdsell
索恩代克 | 桑代克 | thorndike
马沙姆 | 马香 | marsham
奥伯赫尔曼 | 奥伯黑尔曼 | oberhelman
帕特里亚克 | 佩特里亚克 | patriach
海内曼 | 海涅曼 | heinemann
里查兹 | 理查兹 | richards
艾奇森 | 艾奇逊 | eytchison
布里安特 | 布赖恩特 | briant
科尔菲亚托 | 科菲亚托 | corfiato
丹纳伊瑟 | 丹罗伊特 | dannreuther
巴恩比 | 巴恩贝 | barnebey
梅林达 | 梅琳达 | melinda
弗伦泽 | 弗伦策 | frenzer
康西尔 | 康斯尔 | council
沙因鲍姆 | 欣鲍姆 | sheinbaum
尚顿 | 桑顿 | szanton
戈德博勒 | 戈德伯勒 | goldborough
赫马尼克 | 赫马纽克 | hermaniuk
哈默特 | 赫默特 | hummert
迈西 | 梅西 | meysey
拉曾 | 拉津 | razeen
埃尔万 | 埃尔温 | elwane
古夫 | 高夫 | gough
巴塔格尔 | 巴塔杰尔 | battagel
埃尔克 | 埃厄克 | earwaker
格林达尔 | 格林德尔 | grindal
麦克利萨特 | 麦克莱萨特 | maclysaght
塞弗林豪斯 | 塞夫林豪斯 | sevringhaus
杰科特 | 贾科泰 | jacottet
布里利 | 布里厄利 | brealey
麦科歇奈格 | 麦科尚奈格 | maco'shannaig
麦克廷格 | 马赫廷格 | machtinger
梅贝 | 梅布 | mabe
康杰 | 康格 | conger
卡思尔 | 卡瑟尔 | cuthell
杜尤斯 | 德威斯 | dewees
奥琳达 | 奥林达 | orinda
基茨哈伯 | 基察伯 | kitzhaber
布雷齐尔 | 布雷热 | brazier
芬尼 | 菲尼 | phinney
里维特 | 里韦特 | rivet
奥尔迪 | 阿尔迪 | alday
阿曼德斯 | 阿曼达斯 | amandus
赛纳 | 西纳尔 | synar
康科拉 | 康科勒 | concholar
塞法蒂 | 瑟法蒂 | serfaty
朔勒 | 朔伊勒 | scheuler
特鲁曼 | 杜鲁门 | truman
达奇 | 达基 | dachi
拉思 | 雷思 | rathe
哈尔巴克 | 哈尔巴赫 | halbach
鲁特 | 鲁尔特 | rurt
克罗嫩贝格 | 克罗嫩伯格 | kronenberg
克里希顿 | 克赖顿 | crichton
格威内德 | 格威内思 | gwynedd
克利姆 | 克莱姆 | clem
沃姆尔多夫 | 沃梅尔多夫 | womeldorph
布奇 | 布谢 | bouchey
波韦尔斯 | 鲍威尔斯 | powels
罗雷姆 | 罗勒姆 | rorem
沃蒂埃 | 沃捷 | vautier
安德里厄斯 | 安德里厄 | andrieux
阿莱恩 | 阿林 | alleine
纳奇马诺夫 | 纳赫马诺夫 | nachmanoff
怀索茨基 | 维索茨基 | wysocki
斯特恩代尔 | 斯滕代尔 | sterndale
唐西娅 | 唐西亚 | donsia
达克罗 | 迪克罗 | ducrow
沃尔克 | 沃克 | walk
沃尔克 | 沃克 | walker
迈尔堡 | 迈尔伯格 | myerburg
斯坦达洛夫特 | 斯坦德洛夫特 | standaloft
德沃查克 | 德沃夏克 | dvorchak
费布里坎特 | 法布里坎特 | fabricant
科克伦 | 库格伦 | coughran
多克特 | 多克托 | docktor
菲伦 | 法林 | filene
巴戈 | 巴戈特 | bagot
希尔茨 | 希尔兹 | shields
菲内尔 | 芬内尔 | feennell
塞门扎 | 西门扎 | semenza
哈森富斯 | 哈森弗斯 | hasenfus
加托夫 | 加特霍夫 | garthoff
夏延 | 夏恩 | cheyenne
彼得龙 | 佩特龙 | petrone
格里桑蒂 | 格里桑迪 | grisanti
梅尔斯 | 马雷斯 | mares
庞蒂尼 | 庞特尼 | pounteney
阿奈林 | 阿内林 | aneirin
高利 | 高恩利 | gownley
阿图鲁斯 | 阿图罗斯 | arturous
布兰肯巴克 | 布兰肯贝克 | blankenbaker
拉腊比 | 拉勒比 | larabee
埃斯坎达里安 | 伊斯坎达里安 | eskandarian
盖格 | 盖杰 | gager
西穆多 | 塞穆多 | themudo
科尔奎特 | 科尔基特 | colquitt
莫莫尼耶 | 蒙莫尼尔 | monmonier
雷兹通 | 雷德斯通 | redstone
伊德博尔德 | 埃德博尔德 | eadbald
贝松 | 贝森 | bessone
萨科夫斯基 | 赛科夫斯基 | saikowski
塞格雷夫 | 西格雷夫 | segrave
休尔代尔 | 舍代尔 | suirdale
哈莫尔 | 哈默 | hamor
博姆沃思 | 博索姆沃思 | bosomworth
普普 | 普珀 | puppe
施米德 | 施密德 | schmid
黑尔 | 海尔 | haire
哈克威尔 | 黑克威尔 | hakewill
冈萨雷兹 | 冈萨雷斯 | gonzalez
莫纳 | 莫娜 | mona
格雷恩 | 格兰妮 | grainne
特鲁赫特 | 特鲁哈特 | trueheart
布拉兹特里特 | 布拉德斯特里特 | bradstreet
麦克斯蒂芬 | 麦克斯蒂奥芬 | macstiofain
亚里莫维奇 | 雅里莫维奇 | yarymovych
登尼斯顿 | 丹尼斯顿 | denniston
塞尼奥尔 | 西尼尔 | senior
哈特赛德 | 哈齐德 | hartsid
博伊斯拉根 | 博勒根 | boisragon
里布特 | 雷巴特 | rebut
索热 | 索热尔 | saussure
费里比 | 费尔比 | ferebee
科克森 | 考克森 | coxon
斯克鲁塔特 | 斯克鲁泰特 | scrutator
格里泽 | 格赖泽 | griser
贝兰妮娅 | 贝拉尼亚 | berania
利宁 | 莱宁 | leining
许尔霍尔兹 | 许霍尔茨 | schuerholz
肖克 | 肖基尔 | showkeir
科尔赫普 | 科尔黑普 | kohlhepp
杰里什 | 格里什 | gerrish
劳奥科 | 罗科 | ruocco
巴齐莱 | 巴尔齐莱 | barzilay
加诺尔 | 加诺 | ganor
鲍德兹威勒 | 巴尔德施维勒 | baldeschwieler
斯洛尼姆 | 斯洛宁 | slonim
马撒 | 玛莎 | martha
福恩斯 | 福尼斯 | forness
鲍杜因 | 鲍德温 | bauduin
珀塞克 | 佩塞克 | perseck
维伦 | 瓦伊伦 | viron
皮尔森 | 皮尔逊 | pirsson
索尔茨 | 肖尔茨 | soults
乔西亚斯 | 乔赛亚斯 | josias
埃夫德 | 埃瓦德 | evvard
格鲁尔德 | 杰罗尔德 | gerould
赫雷霍夫 | 赫雷斯霍夫 | herreshoff
加弗 | 盖弗 | gaver
西金 | 西尔金 | sirkin
柯兰 | 柯伦 | curran
瓦伦朱拉 | 巴伦苏埃拉 | valenzuela
肖尔斯 | 肖沃斯 | showers
阿格休 | 阿古 | agwu
弗拉克斯 | 弗勒克斯 | flux
林恩 | 林 | linn
德赖克 | 德里克 | driker
里查德 | 理查德 | richard
罗伯森 | 罗伯逊 | robertson
达肯 | 达坎 | dakan
吉查姆 | 吉彻姆 | gitsham
皮波 | 波波 | poepoe
利夫瓦克 | 莱夫奥克 | liveoak
普鲁斯曼 | 普拉斯曼 | prusman
基弗 | 凯弗 | keifer
吉汉 | 吉亨 | gehan
施努肯 | 施努克内 | schnukne
阿戈尔 | 阿高尔 | argall
温纳斯特伦 | 温纳斯特鲁姆 | wennerstrum
利德克 | 利迪克 | luedecke
乔德里 | 乔德尔 | jordre
普卢内基 | 普伦尼克 | pluenneke
赫希特里特 | 赫什特里特 | hirschtritt
贝拉德 | 贝拉尔 | berard
格尔托夫 | 格托夫 | gurtov
道宁 | 唐宁 | downing
巴特伦 | 巴特拉姆 | battram
卡莉什 | 卡利什 | kalish
格丽索戈娅 | 格丽索戈尼娅 | grisogonia
德保尤 | 德波 | depauw
罗斯布勒 | 罗斯伯勒 | rosebrough
豪瑟姆 | 豪萨姆 | howsam
阿特尔西 | 阿特莱西 | attlesey
加格宾 | 加涅班 | gagnebin
霍 | 豪 | howe
布莱克施密特 | 布莱希施米特 | blechschmidt
赫维茨 | 赫威茨 | herwitz
梅恩斯 | 梅因斯 | mains
布卢克 | 布劳克 | blouke
德雷斯克 | 德赖斯克 | dreiske
马马杜克 | 马默杜克 | marmaduke
普赖尔 | 普里尔 | preil
科尼罗 | 科内罗 | corneiro
奎伦 | 奎林 | quillen
贝思 | 贝丝 | beth
比尔霍尔特 | 伯霍尔特 | byrholdt
约赫 | 约埃 | yohe
恩格弗 | 恩弗 | engfer
亚特伦 | 亚特隆 | yatron
斯卡姆 | 斯基姆 | skym
巴思利 | 布思莱 | buthlay
安杰莉娜 | 安杰利娜 | angelina
路尤塔 | 里乌塔 | riutta
普伦蒂 | 普朗蒂 | prunty
梅奥拉斯 | 马约拉斯 | mayoras
维西 | 维齐 | veysey
沃尔斯托克夫特 | 沃斯通克拉夫特 | wollstonecraft
法夫罗特 | 法夫罗 | favrot
阿曼 | 阿尔曼 | arman
阿米欧 | 阿米奥特 | amiot
贝德尔 | 比德尔 | bedel
阿德尼 | 埃德尼 | adney
莫勒诺尔 | 莫勒瑙尔 | mollenauer
芬维西 | 芬韦西 | fenvessy
帕奇 | 帕克 | pach
盖尔德 | 格尔德 | gelder
萨森 | 萨瑟恩 | southern
佩皮厄特 | 佩皮奥特 | pepiot
巴查尔 | 巴卡尔 | bachar
奥尔博 | 阿尔博 | allbaugh
加米特 | 加梅特 | gamet
凯尼斯 | 基尼斯 | kiness
德利乔尔吉斯 | 德利乔治斯 | deligiorgis
加雷尔 | 加勒尔 | garel
拉希 | 莱希 | lahee
奥尔 | 奥利 | ole
巴德温 | 布德温 | budwine
迪奥 | 戴奥 | dio
哈巴赫 | 哈巴克 | harbach
塞维尔 | 萨维尔 | savele
利薇 | 利维 | levie
格龙基 | 格朗茨基 | groncki
加康 | 加肯 | garcon
沃梅利 | 沃姆利 | wormeley
戴姆里奇 | 德姆里克 | daemmrich
肖尔德勒 | 斯科德勒 | scholderer
杜比 | 达比 | duby
贝尔比 | 比尔比 | beilby
博斯金德 | 博斯坎德 | boskind
米尔 | 缪尔 | muille
纽尼梅克 | 努尼梅克 | nunemaker
阿尼斯 | 安妮斯 | anis
阿布林 | 埃布林 | ablin
班德 | 班德尔 | bander
罗索尔 | 罗塞尔 | rossall
谢德 | 沙德 | shad
埃奇逊 | 艾奇逊 | etcheson
福塞特 | 福西特 | fawssett
莫弗 | 莫夫 | maufe
奥威克 | 阿威克 | aawick
阿加斯 | 阿加丝 | agase
阿蒂耶 | 阿提耶 | atiyeh
伦法特 | 朗方 | lenfant
尤弗罗因 | 尤弗罗西尼 | euphrosyne
杰雷迈亚 | 杰里迈亚 | jeremiah
佩特里兹 | 佩特里迪斯 | petrides
戴文 | 达文 | davern
罗莎娜 | 罗珊 | rozanne
洛格 | 洛奇 | lorge
格里恩夫 | 格里诺 | greenhow
斯利 | 斯莱 | sligh
埃莉娜 | 埃琳娜 | elena
杜尤 | 杜韦 | duwe
布雷德 | 布里德 | breder
萨韦尔 | 萨维尔 | savelle
利班 | 莱班 | leban
穆拉尔特 | 缪拉尔持 | muralt
萨洛梅 | 萨洛米 | salome
鲍尔丁豪斯 | 博尔廷豪斯 | boultinghouse
尤吉妮亚 | 尤金妮亚 | eugenia
梅德瓦多斯基 | 梅德瓦多夫斯基 | medwadowski
希厄特 | 海厄特 | hieatt
法茨 | 菲茨 | fites
特里布瓦瑟 | 特里布沃瑟 | triebwasser
惠奇利夫 | 惠特克利夫 | whitchliffe
怀森 | 威森 | wison
赫夫施塔德 | 赫夫斯塔德 | hufstader
德彻特 | 德克特 | dechert
德夫尼 | 迪夫尼 | deveney
海姆索特 | 海姆塞特 | heimsoth
弗德里 | 维德里 | verdery
希伯德 | 希巴德 | hibbard
盖斯特菲尔德 | 盖斯特费尔德 | geistfeld
塔利亚费罗 | 托利弗 | taliaferro
威尔希德 | 威尔海德 | wilhide
莱根 | 利根 | lygon
奥莱克西丘 | 奥莱克休 | oleksiw
阿利兹 | 阿莱 | allez
赖迪尔 | 里迪尔 | rideal
苏尔温 | 西尔温 | sulwen
坦克蕾托 | 坦克雷托 | tancreto
法迪安 | 法迪恩 | fadyean
伯克隆 | 伯克伦 | berklund
德雷南 | 德雷宁 | drennen
德彻 | 德谢尔 | decher
巴特伦 | 巴特拉姆 | buttram
帕尔特尼 | 普尔特尼 | pulteney
特鲁齐 | 特拉齐 | truzzi
阿布迪安 | 阿布迪恩 | abdian
托里 | 托丽 | tori
卡里洛 | 卡里略 | carrillo
比比 | 毕比 | beeby
马西纳 | 马塞纳 | marthena
格尼森 | 吉尼森 | genesen
凯利 | 卡利 | cali
