布雷金里奇 | 布雷肯里奇 | breckinridge
锡德 | 切德 | cedd
拉巴雷 | 拉巴里 | labaree
梅莉 | 马利 | maly
阿西尼加 | 阿西涅加 | arciniega
法莱恩 | 法兰 | farlane
霍普特 | 豪普特 | houpt
西恩 | 西根 | seaghan
斯特拉瑟恩 | 斯特拉森 | strathearn
派珀特 | 佩珀特 | peipert
皮内 | 皮奈 | pinay
梅雷斯曼 | 米尔斯曼 | meresman
伊哈维斯特 | 埃沙韦斯特 | echaveste
费尔班 | 费尔贝恩 | fairbairn
米尔黑德 | 缪尔黑德 | muirhead
舒普 | 肖普 | shoupp
芒斯巴奇 | 蒙斯巴克 | maunsbach
沃塞尔 | 瓦塞尔 | wassell
西金特 | 萨金特 | seargent
亨巴克 | 亨巴赫 | heimbach
纳尔迪 | 纳迪 | nardi
杰米马 | 杰迈玛 | jemima
海伊 | 希 | hie
莫杜特 | 莫德维 | mauduit
惠塔克 | 惠特克 | whitacre
艾特 | 艾厄特 | eyet
博比 | 鲍比 | bobbie
麦基尔文纳 | 麦基尔温纳 | macilvenna
赖因斯 | 赖恩斯 | rines
博查尔 | 博索尔 | botsal
科尔雷 | 科尔雷因 | coleraine
科克拉姆 | 科克勒姆 | cockrum
韦格尼 | 韦恩 | wagne
多特曼 | 多伊特曼 | deutermann
厄德曼 | 厄尔德曼 | erdman
戈伦比斯基 | 戈伦别夫斯基 | golembiewski
布罗赖因 | 布罗林 | brorein
夏迪 | 恰尔迪 | ciardi
格雷戈尔 | 格雷瓜尔 | gregoire
米卡贾 | 迈凯亚 | micajah
莱德洛 | 莱德劳 | laidlaw
科姆萨罗夫 | 科梅萨罗夫 | komesaroff
雷马克斯 | 拉马克斯 | raemakers
皮凯弗 | 皮卡弗 | piccaver
苏布林 | 萨布林 | subrin
哈兹利特 | 黑兹利特 | hazlitt
费尔本 | 费尔伯恩 | fairburn
津南 | 津宁 | zinnen
佩莱蒂尔 | 佩尔蒂埃 | pelletier
帕塞尔 | 帕斯尔 | parcel
霍诺里 | 霍诺丽 | honori
伊梅希 | 伊梅施 | imesch
西明顿 | 赛明顿 | symington
马豪 | 玛奥 | mahault
法克 | 菲克 | fike
萨格 | 沙格 | shugg
夏维尔 | 希维尔 | shivell
马基宁 | 马基嫩 | makinen
拉琴斯 | 拉雪兹 | lachaise
麦科瑙希 | 麦康瑙希 | mcconaughy
达维格多 | 达维多尔 | d'avigdor
福尔尼 | 福尼 | fournie
玛吉 | 马吉 | magi
哈巴德 | 哈伯德 | hubbard
曼纳韦 | 马纳韦 | mannaway
梅恩 | 米恩 | meighen
艾索德 | 伊佐德 | izod
图伊马 | 托伊马 | teuma
阿富蒂特 | 阿富尔蒂特 | affourtit
米塞尔 | 米赛尔 | misael
赫默里奇 | 亨默里克 | hemmerich
海伍德 | 希伍德 | heawood
詹宁斯 | 杰宁斯 | jenyns
斯特姆斯 | 斯泰姆斯 | stames
比比 | 毕比 | beebe
考尔德尔 | 考德尔 | caldell
博查特 | 博哈特 | borchardt
卡明 | 卡迈恩 | carmine
巴特兰 | 巴特拉姆 | bartram
佩尔 | 皮尔 | peile
麦康 | 麦肯 | mccon
麦卡里 | 麦凯里 | mccarey
英芬特 | 因方特 | infant
高尔珀恩 | 加尔珀恩 | galpern
亨内肯斯 | 亨尼肯斯 | hennekens
吉弗 | 贾埃弗 | giaever
鲍尔霍恩 | 巴尔霍恩 | ballhorn
斯特格斯 | 斯特奇斯 | sturges
斯泰默 | 斯塔默 | stamer
莫克萨姆 | 莫克塞姆 | moxam
米德尔巴什 | 米德尔布什 | middlebush
多 | 道 | daw
比克姆 | 比卡姆 | bickham
希尔曼 | 沙伊尔曼 | shireman
梅索利 | 梅索伊 | meszoly
格尔德 | 盖尔德 | geld
福伊希万格 | 福伊希特万格 | feuchtwanger
埃森斯 | 埃森丝 | essence
利布 | 利比 | luebbe
哈泽尔 | 黑兹尔 | hazell
克莱农 | 克勒农 | clernon
金德雷德 | 金德里德 | kindred
纳索尔 | 纳托尔 | nuthall
戴格 | 戴伊 | daigh
伊廷 | 埃泰恩 | etain
德尔希戈 | 德尔列戈 | delriego
巴策 | 巴策尔 | batzer
莱思科特 | 利思科特 | lythcott
廷肯 | 廷康 | tinkon
德弗雷茨 | 迪弗雷特斯 | defrates
尤拉姆 | 乌拉姆 | ulam
米恩斯 | 默恩斯 | mearns
拜尔勒姆 | 拜勒姆 | byerrum
蒂利 | 泰利 | tiley
格罗布 | 格罗比 | grobe
塔塔利诺 | 塔尔塔利诺 | tartaglino
兰姆 | 拉姆 | lambe
考德韦尔 | 考德威尔 | caldwell
泽米娜 | 泽米纳 | zemina
坎特伯里 | 坎特伯雷 | canterbury
塔肯 | 泰肯 | tacon
柯施 | 基尔希 | kirsch
古特穆特 | 古特穆思 | gutermuth
弗森 | 费尔森 | ferson
托皮 | 托毕 | torpey
迪兹 | 迪斯 | deese
洛多维克 | 洛多威克 | lodowicke
泰奇曼 | 泰克曼 | teichmann
普鲁德霍姆 | 普鲁多姆 | prudhomme
坎比 | 坎贝 | cumbey
赫梅尔 | 赫姆利 | hermle
蒙根 | 蒙贡 | mongon
亨佩尔 | 亨普尔 | hempel
艾罗 | 艾罗尔特 | ayrault
赖蒂娜 | 赖蒂纳 | rytina
雷亚 | 雷 | rea
布赖登索尔 | 布赖登塔尔 | breidenthal
德卢吉 | 德路易吉 | deluigi
科克雷斯 | 科克里斯 | cocheres
拉德 | 鲁阿兹 | ruadh
巴斯凯特 | 巴斯克特 | baskette
马尔特比 | 莫尔特比 | maltby
埃塞蕾达 | 埃塞丽达 | ethelreda
默基斯顿 | 默奇斯顿 | merchiston
巴特韦尔 | 贝特韦尔 | batewell
黛娜 | 迪恩纳 | dienna
博里尔 | 博雷尔 | boreel
布雷洪 | 布里恩 | brehon
厄丘克 | 尤尔丘克 | yurchuck
坦尼肯 | 滕尼肯 | tennican
麦金泰尔 | 麦金太尔 | mcintire
利文 | 莱文 | levene
克莱尔斯 | 克拉雷斯 | clares
杰普林斯基 | 西普林斯基 | cieplinski
索苏纳 | 索杰纳 | sojourner
纽贝尔 | 努贝尔 | knubel
卡诺肯 | 卡诺坎 | carnochan
吉希诺 | 吉赫诺 | giheno
罗克辛 | 罗克西娜 | roxinne
伦斯莱尔 | 伦塞勒 | rensselaer
伊登斯 | 埃登斯 | edens
贾姆森 | 詹姆森 | jameson
比哈里尔 | 贝哈里尔 | beharriell
朗坎姆 | 朗香 | longchamp
舒尔金德 | 舒尔坎德 | schulkind
皮什 | 佩什 | peche
威德曼 | 沃德曼 | wurdemann
洛伦兹 | 洛伦茨 | lorenz
特普尔 | 蒂普尔 | tepoel
吉莫 | 贾伊莫 | giaimo
库尔贾安 | 库尔金 | kuljian
克鲁克尚克 | 克鲁克香克 | crookshank
吉耶 | 吉利特 | guillet
哈米利恩 | 哈米里恩 | hamilyon
利尼 | 利安娜 | leanne
弗兰库姆 | 弗兰克姆 | frankum
雷索诺弗 | 里曾诺弗 | reasonover
查肯 | 查康 | chacon
雷布萨门 | 里布萨门 | rebsamen
托菲琴 | 托菲肯 | torphichen
布利肯斯多弗 | 布利肯斯德弗 | blickensderfer
斯卡尔普 | 斯卡尔普特 | sculpt
戈特尔斯 | 戈瑟尔斯 | goethals
黑特姆 | 哈特姆 | hatem
瓜蒂埃 | 瓜尔蒂耶里 | gualtieri
泽兰 | 齐伦 | zeran
比贝尔 | 比布尔 | biebel
西门斯 | 西门子 | siemens
普利本 | 普利邦 | plybon
贝克纳 | 比克纳 | beichner
恩格姆 | 恩格霍姆 | engholm
赛迪纳姆 | 西德纳姆 | sydenham
惠特洛 | 怀特洛 | whytlaw
兰内伯格 | 兰恩伯格 | ranneberger
桑德威克 | 桑威克 | sandwick
威思 | 韦思 | wyeth
施韦克菲尔德 | 施韦柴尔德 | schweichild
斯坦霍普 | 斯坦诺普 | stanhope
英沃尔斯塔德 | 英沃斯塔德 | ingvoldstad
森霍尔 | 桑戈尔 | senghor
布赖豪斯 | 布里格豪斯 | brighouse
斯图沃特 | 斯图尔特 | stewart
克伦布哈尔 | 克伦巴尔 | krumbhaar
斯彭泽 | 斯潘塞 | spenser
莫拉尔 | 莫勒 | morar
赖兰斯 | 赖伦斯 | rylance
古德杜 | 古德休 | goodhue
哈勒尔 | 哈拉尔 | harral
哈扎德 | 哈泽德 | hazard
穆谢特 | 马希特 | mushet
杜切斯 | 达切斯 | dutchess
布鲁姆利 | 布伦利 | brumley
比尔特 | 伯特 | birt
明 | 米恩 | min
菲格雷斯 | 菲格斯 | figures
埃加尔 | 埃加 | eggar
特卡姆什 | 特库姆塞 | tecumseh
伊万杰斯塔 | 埃万杰利斯塔 | evangelista
韦布利 | 韦伯利 | webley
帕门蒂尔 | 帕尔芒捷 | parmentier
迪安吉斯 | 迪安杰利斯 | deangelis
麦格拉斯里奇 | 麦格拉斯里克 | macglasrich
索恩顿 | 桑顿 | thornton
芭布 | 巴布 | baab
巴洛克 | 巴洛赫 | balloch
彻内斯基 | 切尔涅斯基 | chernesky
克龙 | 克朗 | kron
贝尔维尤 | 贝尔维 | bellevue
凯肖恩 | 基肖恩 | keyshawn
里斯伯格 | 赖斯伯格 | riseberg
德尔钱普斯 | 德尔尚 | delchamps
布劳恩 | 布朗 | braun
赫雷尼克 | 赫雷查尼克 | hrechanyk
特里利文 | 特里莱文 | treleaven
格罗斯密斯 | 格罗史密斯 | grossmith
比内尔 | 比尤内尔 | buesnel
阿迪 | 埃迪 | adye
哈格迈耶 | 哈格迈尔 | hagemeyer
阿拉蒙 | 阿拉芒 | allamong
西米恩 | 西明 | siemien
罗万德 | 罗安德 | rowand
普里亚尔 | 普赖尔 | prial
布利萨克 | 布利萨茨 | blisac
马尼斯 | 马内斯 | maness
拜德斯 | 比德兹 | bidez
厄威尔 | 厄维尔 | irwil
威尔梅特 | 薇尔梅特 | wilmett
纳兰乔 | 纳兰霍 | naranjo
布雷兰 | 布里兰 | breland
卡尔 | 卡利 | karle
雷尔克 | 罗尔克 | roelker
阿德莉娜 | 阿德利娜 | adelina
斯特尔特 | 斯泰尔特 | stelter
明韦尔 | 米恩韦尔 | meanwell
亚历历森 | 亚历山德森 | alexanderson
科克伦 | 科克兰 | cockran
格尔 | 瓜尔 | guare
朱皮特 | 丘辟特 | jupiter
多尤特里希 | 多伊特里希 | deutrich
托厄里 | 托尔里 | towery
马德林 | 马德琳 | madlin
威舍 | 维舍 | wischer
戴加 | 迪格 | dygard
巴利克 | 巴利奇 | balich
库比特 | 丘比特 | cubitt
福尔兹西 | 福尔德西 | foldessy
西克雷斯特 | 西克里斯特 | secrest
泰特 | 图特 | tuteur
拉扎 | 拉扎尔 | lazar
麦高恩 | 麦古恩 | macgoun
佩茨 | 皮特斯 | petes
皮伦斯 | 佩伦斯 | peirens
费尔哈文 | 费尔黑文 | fairhaven
特里德格 | 特里迪加 | tredegar
阿蒂盖尔 | 阿蒂格尔 | attygalle
马西娅 | 玛西娅 | mathea
卡姆 | 凯姆 | kaim
费布勒 | 法布勒 | fabler
彼得鲁斯卡 | 彼特鲁斯卡 | petruska
弗恩 | 维恩 | verne
尤迪切洛 | 尤迪塞洛 | iudicello
韦姆 | 瓦伊姆 | waim
鲁兰 | 鲁伦 | ruellan
拉赫特 | 拉克特 | lachter
拉哈布 | 雷哈布 | rahab
麦金纳尼 | 麦基纳尼 | macinerney
斯蒂格勒 | 施蒂格勒 | stigler
特威宁 | 特文宁 | twining
西达勒斯 | 西达劳斯 | sidarouss
弗洛厄尤 | 弗劳尔迪 | flowerdew
吉梅内斯 | 希门尼斯 | jimenez
普勒 | 普拉 | pullar
韦尔纳 | 沃尔纳 | woellner
科尔帕齐 | 科帕齐 | corpazzi
斯威特曼 | 斯韦特曼 | sweatman
布拉德劳夫 | 布拉德洛 | bradlaugh
尼斯克恩 | 尼斯肯 | kniskern
布鲁因 | 布勒因 | bruyn
贝尼迪克斯 | 贝内迪克斯 | benedicus
拉弗利什 | 拉弗莱什 | lafleche
麦格罗瑟 | 麦格鲁瑟 | macgreuther
柯蒂尼厄斯 | 柯特纽斯 | curtenius
赫利娜 | 赫莉娜 | helina
伊蒂拉格 | 伊泰拉格 | itteilag
斯特朗奇 | 斯特朗 | stronge
埃沃伊 | 伊沃伊 | evoy
迪伦福思 | 迪伦弗思 | dyhrenfurth
麦肯纳尔蒂 | 麦克纳尔蒂 | macenulty
坦盖 | 坦圭 | tanguay
杜布拉斯 | 杜布拉 | dubras
亚兹明 | 亚斯明 | yazmin
劳德代尔 | 劳德戴尔 | lauderdale
伯贝奇 | 伯比奇 | burbage
基斯托利尼 | 奇斯托利尼 | chistolini
波洛斯 | 普洛斯 | poulos
卢万多 | 柳安多 | lewando
克莱恩 | 克莱因 | clyne
韦德勒 | 维德勒 | vedeler
弗里岑 | 弗里曾 | fritzen
麦克米克尔 | 麦克迈克尔 | mcmichael
贝尔希 | 贝尔赫 | bailhe
斯科克罗夫特 | 斯考克罗夫特 | scowcroft
金泽特 | 金瑟特 | gensert
麦卡尔 | 麦考尔 | mackal
阿利曼 | 阿利芒 | allemang
赛奇 | 赛什 | saich
皮奥特罗夫斯基 | 彼得罗夫斯基 | piotrowski
贾恩 | 扬 | jahn
康戈尔顿 | 康高尔顿 | congalton
乌尔默 | 厄尔默 | ulmer
杜瓦克斯 | 杜阿克斯 | duax
沙滕克 | 沙滕柯克 | schattenkerk
法隆 | 法伦 | falloon
西利森 | 西利格森 | seeligson
克莱本 | 克莱伯恩 | clyburn
奥沃 | 奥斯威尤 | oswiu
米隆 | 米伦 | millon
艾利 | 艾莉 | eily
埃肯 | 伊肯 | ekern
菲利恩 | 菲利翁 | filion
舒申 | 舒尚 | shooshan
莫普斯 | 莫皮斯 | moppes
阿历维 | 阿利维 | alevey
帕塞尔 | 帕斯尔 | parcell
索尔 | 苏尔 | soul
门宁 | 门嫩 | mennen
德代奥 | 戴德奥 | dedeo
麦克里思 | 麦克勒思 | mackereth
奥瑟 | 奥泽 | orser
帕珀马斯特 | 佩珀马斯特 | papermaster
贝伦德斯 | 贝伦兹 | berendes
杜布尔迪 | 道布尔迪 | doubleday
埃拉齐姆 | 伊拉齐姆 | erazim
施雷德 | 施拉德 | schrade
伯克 | 比尔克 | birck
巴索尔森 | 巴托尔松 | bartholdson
麦克斯波兰 | 麦克斯波伦 | macsporran
英格林 | 英林 | yingling
查努廷 | 查纽廷 | chanutin
埃塞克 | 伊塞克 | esek
梅尔霍弗 | 迈尔霍费尔 | maierhofer
马伦普尔 | 马伦普雷 | malempre
富林 | 菲林 | fuelling
多奇 | 德奇 | doetsch
阿雷顿 | 阿里顿 | arreton
贝娅 | 贝亚 | beha
富洛姆 | 富勒姆 | fullom
博多 | 波尔多 | bordeaux
德西德里厄斯 | 德西迪里厄斯 | desiderius
塔尔戈特 | 索尔戈特 | thalgott
切尔凯齐安 | 彻克齐安 | cherkezian
舍恩巴克 | 舍恩巴赫 | schoenbach
马尼尔 | 马尼耶 | magnier
奥特林克姆 | 奥特林厄姆 | altrincham
纳帕施特克 | 纳帕斯特克 | naparstek
艾纳姆 | 埃努姆 | aernum
麦基尔维维 | 麦基雷维 | macilrevie
莱夫勒 | 莱弗勒 | leffler
科卡姆 | 科克姆 | corkum
拉文 | 雷文 | raven
多尔茨 | 德尔兹 | doelz
格威克哈德斯 | 格威查德斯 | gwychardus
莫布斯比 | 莫布兹比 | mobsby
赛雷斯 | 西尔斯 | cyres
西波伦 | 西波隆 | cipollone
阿奎约 | 阿夸约 | aquayo
赛丝 | 赛斯 | sise
弗里林休森 | 弗里林海森 | frelinghuysen
帕吉利斯 | 帕盖利斯 | pargellis
莱珀 | 勒普尔 | lepoer
阿尔施塔特 | 阿尔斯塔特 | alstadt
布雷斯劳斯基 | 布雷斯拉夫斯基 | breslawsky
博尼法修斯 | 博尼费修斯 | bonifacius
达夫纳 | 达夫妮 | daphne
瓦恩 | 瓦因 | vine
里加利亚 | 雷加利亚 | regalia
麦克莱夫 | 麦克拉夫 | mcclave
费尔霍尔姆 | 费尔霍姆 | fairholme
麦康奇 | 麦康希 | macconchy
桑德姆 | 桑达姆 | sandham
里穆夫斯基 | 里莫斯基 | rimouski
马宁 | 曼宁 | maning
布莱赫特 | 布拉胡特 | blachut
赫明 | 亨明 | hemming
特文加登 | 蒂文加杜姆 | tirvengadum
卡尔斯密斯 | 卡尔史密斯 | carlsmith
马米 | 玛米 | mami
格内罗 | 吉尼罗 | genero
拜斯特 | 比伊斯特 | buist
龙特里 | 朗特里 | rowntree
拉拉莫尔 | 拉腊莫尔 | laramore
福韦尔 | 福尔韦尔 | faulwell
哈克 | 黑克 | hake
哈什哈根 | 哈舍根 | hashagen
赖尔斯 | 赖亚尔斯 | ryalls
特里梅因 | 特里曼 | tremain
梅伦 | 默龙 | merron
范德克莱德 | 范德克利德 | vanderkleed
贝基 | 巴基 | bakey
格鲁科特 | 格劳科特 | groucott
鲁兹 | 吕埃 | ruez
怀曼 | 威曼 | wiman
拉德布罗克 | 拉德布鲁克 | ladbroke
奥恩斯拉格 | 奥恩斯莱格 | oenslager
哈加丁 | 哈格丁 | hargadine
利克姆 | 利克希姆 | leikhim
沃奇哈夫特 | 沃特沙夫特 | wirtschafter
艾默斯 | 伊穆斯 | imus
托奇 | 托克 | toch
杜文特 | 德温特 | dewenter
哈雷尔 | 哈勒尔 | harrel
斯普勒 | 施普勒 | spuhler
夏里斯 | 查里斯 | charies
阿马尼 | 阿尔马尼 | armani
弗莱布 | 弗莱比 | flebbe
汤布斯 | 图姆斯 | tombs
达夫隆 | 杜弗隆 | duflon
谢里克 | 谢雷克 | sherek
哈纳 | 哈娜 | hana
本恩 | 本 | benn
梅纳厄姆 | 梅纳汉 | menaham
米尔哈姆 | 米勒姆 | millham
麦基利肯 | 麦基利坎 | mackillican
多里 | 多丽 | dorrie
法诺夫 | 法纳夫 | faneuf
科尔克莱泽 | 科尔克拉泽 | colclaser
罗克 | 罗奇 | roch
罗耶尔 | 罗亚尔 | royall
多鲁 | 多拉夫 | dorough
巴尔尼尔 | 巴尼尔 | balniel
菲林 | 法尔林 | firing
克莱姆 | 克莱米 | klemme
费尔 | 费雷 | ferre
安娜贝尔 | 安娜贝勒 | annabelle
贝伊文 | 博伊文 | boivin
费伊西 | 福西 | feusi
江伯格 | 宗伯格 | zumberg
萨加 | 塞格尔 | sagar
恩格兰 | 英格兰 | england
艾琳妮 | 艾琳 | irene
利弗塞奇 | 利弗西奇 | liverseidge
塔尔曼 | 托尔曼 | tallman
基拉森 | 西劳森 | cilawson
阿布 | 阿贝 | abbe
博瓦施方丹 | 博伊斯方丹 | boisfontaine
麦卡哈蒂 | 麦克哈蒂 | mccahearty
麦克马恩 | 麦克蒙 | mcmunn
厄尔夫 | 厄普 | earp
蒙多尔 | 蒙多 | mondor
格尔泽 | 盖尔泽 | gelzer
施赖纳 | 施里纳 | shriner
斯塔布尔菲尔德 | 斯塔布菲尔德 | stubblefield
弗皮利克斯 | 韦皮勒 | verpilleux
莫尔比 | 莫比 | morby
汤内德 | 汤恩德 | townend
伊内斯 | 伊内兹 | inez
杰彭 | 杰波恩 | jepoen
伯肯霍尔茨 | 伯肯霍尔兹 | birkenholtz
卢克特 | 勒基特 | luckett
斯普尔 | 斯珀尔 | spurr
古莎 | 古沙 | gousha
伊德 | 伊德尔 | eader
维诺格拉德 | 维诺格勒 | vinograd
安纳圭尔 | 安纳克莫尔 | annaghmore
斯图德曼 | 斯蒂德曼 | studeman
布里森 | 布赖森 | bridson
佩里斯坦 | 皮里斯坦 | pearistine
马德维克 | 马达维赫 | mhadavikh
戈勒布 | 戈卢布 | golub
达拉克 | 杜拉奇 | dullach
肖尔德 | 索尔德 | szold
杜普卡克 | 杜普恰克 | dupcak
布雷登 | 布拉顿 | bradon
贝姆 | 巴姆 | bame
莱西 | 利西 | leisy
普利梅尔 | 普莱梅尔 | plymale
布罗梅特 | 布罗米特 | bromet
皮科威亚克 | 皮乔维亚克 | piechowiak
隆巴德 | 伦巴德 | lumbard
奥尔斯坦 | 奥雷斯坎 | orescan
阿查鲍尔 | 阿查巴尔 | archabal
普法勒 | 法伊勒 | pfeiler
赫斯蒂德 | 赫斯特德 | hustead
霍莫尔卡 | 霍穆尔卡 | homolka
海斯伯格 | 海斯堡 | heisborg
费尔德布里尔 | 费德布里尔 | feldbrill
格尔农 | 热农 | gernon
斯顿特 | 斯坦特 | stunt
法布里西奥 | 法布里齐奥 | fabrizio
埃利斯 | 埃莉丝 | elyse
伦格利 | 伦利 | lungley
克勒勒 | 克雷勒 | kroehler
谢米宁特 | 切米宁特 | cheminint
沃林 | 瓦林 | wahlin
法斯纳特 | 法斯纳克特 | fasnacht
赫尔姆霍特 | 赫尔姆霍尔特 | helmholdt
布根 | 巴根 | bugan
施瓦姆 | 施万布 | schwamb
麦克米克尔 | 麦克迈克尔 | macmichael
奥里 | 奥赖 | ory
艾尔弗里克 | 阿尔弗里克 | aelfric
艾 | 伊 | yee
汤内曼 | 索恩曼 | sonnemann
奥赞娜 | 奥赞 | ozanne
沙普尔斯 | 沙普利斯 | sharpless
德黑恩 | 德哈恩 | dehaan
松塔格 | 桑塔格 | sontag
梅赞 | 马赞 | mazan
麦康 | 梅肯 | macon
古德里 | 格德里 | guedry
戴维 | 达维 | davee
戈希 | 戈伊 | gohey
克莱弗 | 克拉弗 | claver
桑萨姆 | 桑森 | sansum
吉吉 | 吉盖 | giggey
达科姆 | 戴科姆 | dacombe
邦廷 | 邦坦 | bontein
多本 | 多宾 | doben
杰穆思 | 格穆思 | germuth
泰恩什 | 坦什 | tainsh
克雷斯皮尼 | 克雷皮尼 | crespigny
哈梅尔辛 | 休梅尔辛 | humelsine
比尔基 | 伯基 | buerki
斯韦德什 | 斯沃德什 | swadesh
巴布尔 | 贝布尔 | babell
克拉丽达 | 克拉里达 | clarida
布朗塔斯 | 布龙塔斯 | brountas
德雷沃尔吉拉 | 德沃尔吉拉 | drevorguilla
奥弗拉赫蒂 | 奥弗莱厄蒂 | o'flahertie
塞维 | 西维 | sevey
鲍厄尔 | 鲍尔 | bouwer
克拉恩 | 克拉汉 | crahan
博克尔 | 博克 | boker
埃肖 | 埃舒 | eshoo
戴布尔 | 戴贝尔 | deibel
马辛库斯 | 马辛克斯 | marcinkus
佩雷兹 | 佩雷斯 | perez
蒂利 | 蒂莉 | tillie
赖格 | 里格 | riger
威泽曼 | 威斯曼 | wieseman
艾利森 | 艾莉森 | alyson
德雷塞尔 | 德雷斯尔 | dressel
朱利 | 朱莉 | julie
芬格休特 | 芬格赫特 | fingerhut
丹尼恩 | 达尼恩 | danyon
马休伦 | 马胡兰 | mahuran
波兰 | 普兰 | poulain
蔡赫 | 切赫 | czeh
西尔瓦纳斯 | 西尔维纳斯 | silvanus
埃克斯坦斯 | 埃克斯滕斯 | exstance
艾恩斯 | 安斯 | aines
普萨特里 | 普萨泰里 | pusateri
尼恩 | 奈恩 | nyhen
罗巴特斯 | 罗巴茨 | robartes
阿格内洛 | 阿涅洛 | agnello
伊莱 | 艾莱 | ilay
内西尤 | 纳休 | nathiew
休达克 | 赫达克 | hudak
斯蒂格利茨 | 施蒂格利茨 | stiglitz
西西利厄斯 | 塞西莉厄斯 | cecilius
纳登 | 内登 | naden
哈姆斯 | 黑姆斯 | hammes
雷贝尔 | 里贝尔 | rebel
查格尔斯 | 查格利斯 | chagles
加南吉安 | 加南吉扬 | ganangiyan
古拉德 | 戈拉德 | goulard
格罗杰 | 格罗格 | grogger
布里斯 | 布赖斯 | brise
沙特勒 | 舒特勒 | shutler
怀特利瑟 | 怀特莱瑟 | whiteleather
埃夫勒 | 埃弗勒 | effler
格雷南 | 格伦南 | grennan
罗亚 | 罗亚尔 | royale
惠特塞特 | 惠特西特 | whitsett
赫克 | 赫德基 | hedke
瓦斯默 | 沃斯默 | wasmer
勒克龙 | 莱克龙 | leckrone
布雷斯纳安 | 布雷斯纳汉 | bresnahan
波 | 鲍 | pow
拉克索尔 | 拉克斯尔 | wraxhall
曼柳斯 | 曼利厄斯 | manlius
布里梅科姆 | 布里马科姆 | brimacombe
谢拉 | 希拉 | shelagh
内格尔 | 尼格尔 | negel
约弗里翁 | 乔夫里翁 | joffrion
伯恩 | 贝尼 | boehne
格鲁尔 | 格劳尔 | grouer
德沃拉克 | 德沃夏克 | dvorak
梅乔斯 | 梅杰斯 | majors
福埃韦克 | 福伊尔沃克 | feuerwerker
塔吉 | 塔姬 | taggy
麦科克 | 麦科奇 | mccoch
蒂姆韦尔 | 泰姆韦尔 | timewell
巴克纳 | 巴赫纳 | bachner
图德杜 | 塔杜 | tudhoe
蒂格雷特 | 泰格雷特 | tigrett
埃金 | 伊金 | eking
卡迪厄斯 | 卡迪厄 | cadieux
卡嫩 | 凯南 | kainen
德普普克 | 德普塔克 | deptuck
努森 | 克努森 | knuthsen
格尔 | 吉尔 | gehl
迪斯特伯格 | 杜斯特伯格 | duesterberg
唐纳姆 | 多纳姆 | donham
莱德福 | 利德福德 | lydford
科宁 | 科奈恩 | conein
格雷博 | 格里博 | grebow
朗莱因 | 朗莱恩 | longhlein
埃勒斯 | 埃利斯 | elles
沃拉克 | 沃勒克 | wallack
卡布尔 | 卡贝尔 | cabell
克兰多尔 | 克兰德尔 | crandall
卡尼尔尼 | 卡奈尔尼 | carnearney
坦嫩鲍姆 | 特南鲍姆 | tennenbaum
霍奇根 | 霍根 | hodgan
卡奇亚 | 卡夏 | cachia
莫尔桑 | 莫桑 | morsan
阿杰里斯 | 阿吉里斯 | argeris
明内特 | 明妮特 | minnette
福尔加 | 福加 | forga
安斯帕彻 | 安斯帕赫尔 | anspacher
雅西诺夫斯基 | 贾西诺斯基 | jasinowski
克雷弗 | 克里弗 | crever
沃尔特霍夫 | 瓦尔塞奥夫 | waltheof
拉普瓦 | 拉普阿诺 | rapuano
托比特 | 托贝特 | torbett
安德雷斯 | 安德烈斯 | andress
埃尔斯皮 | 伊丽莎白 | elspie
哈根 | 黑根 | hagan
麦柯拉奇 | 麦柯拉克 | maccurrach
托普尔 | 托佩尔 | topple
塞姆斯 | 泰晤士 | thames
斯维克 | 斯韦克 | svec
斯坦布勒 | 斯坦伯勒 | stanbrough
肯奈尔德 | 肯奈德 | kennaird
勒克拉斯 | 勒克拉 | lecras
安德琳 | 安德林 | andelin
艾克纳 | 艾希纳 | eichner
费罗 | 费劳 | ferrao
奥弗拉赫蒂 | 奥弗莱厄蒂 | o'flaherty
克里恩 | 克林 | crean
萨马罗 | 萨马鲁 | samaroo
鲁迪杰 | 鲁迪格 | ruediger
皮尔克 | 珀基 | pyrke
恩布林 | 恩布琳 | emblin
卡尔索普 | 考尔索普 | calthorpe
西森 | 特森 | thesen
吉尔德豪姆 | 吉尔多姆 | guildhaume
埃夫尤 | 埃维尤 | evjue
威尔科夫斯基 | 维尔科夫斯基 | wilkowski
法诺艾尔 | 法纳尔 | faneuil
雷塔 | 里塔 | rheta
波 | 普 | poo
伯尼特 | 伯内特 | burnett
里卡特 | 理查特 | richart
朗尼加 | 朗内加 | runnegar
阿恩索尔兹 | 安索尔兹 | ahntholz
法森 | 富森 | fuson
麦克莱恩 | 麦克林 | mcclean
扬杰 | 扬格 | younger
多尔杰 | 德尔格 | dolger
希尔斯密斯 | 希尔史密斯 | shearsmith
赫贝斯特赖特 | 赫布斯特雷特 | herbestreit
赫尔斯顿 | 赫尔斯特恩 | hellstern
诺威布 | 诺韦布 | norweb
普莱斯顿 | 普利斯顿 | puleston
埃杰曼 | 埃格曼 | egerman
鲍金 | 鲍德金 | baudkin
迪林 | 迪尔林 | deerlin
科森 | 科瑟恩 | cothern
埃尔韦斯 | 埃尔威斯 | elwes
塔弗 | 塔沃尔 | tavor
韦赫 | 韦伊尔 | weiher
韦特 | 维特尔 | vetter
赫米恩 | 赫米奥娜 | hermione
斯韦沃 | 斯维沃 | svewar
约翰森 | 约翰逊 | johnson
杭德里奇 | 杭德里克 | honderich
拉克林 | 劳克林 | laughlin
利伯坦 | 利伯蒂娜 | libertine
达利佩齐 | 达莱佩泽 | dallepezze
迈尔斯特拉普 | 迈尔斯特勒普 | meilstrup
阿代奥 | 阿德奥 | addeo
科莫尼亚克 | 科莫尼亚雷克 | komoniarek
格恩斯巴克 | 根斯巴克 | gernsback
维图凯蒂斯 | 韦图凯蒂斯 | vaitukaitis
格伦尼斯特 | 格莱尼斯特 | glenister
比尔 | 伯尔 | birr
邓坎森 | 邓肯森 | duncanson
格拉迪厄斯 | 格拉迪厄 | gladieux
高迪安 | 高迪恩 | gaudian
迪尔 | 代尔 | diel
迪思里奇 | 迪特里希 | diethrich
迪海 | 德海 | dehay
马斯凯廷 | 马斯卡廷 | muscatine
唐特西 | 当齐 | dauntsey
沃索 | 瓦索 | wasow
吉尔迪 | 吉亚尔迪 | ghiardi
艾勒姆 | 奥勒姆 | allam
博迪科姆 | 博迪库姆 | bodycombe
施韦尔布 | 施韦布 | schwelb
艾森诺尔 | 艾泽努尔 | izenour
布尔 | 布雷 | buhre
雅各布坦 | 雅各布斯坦 | jacobstein
拉纳夫 | 雷纳夫 | ranulph
特雷里斯 | 特里赖斯 | trerise
帕尼特 | 帕内特 | panet
罗恩 | 龙尼 | ronne
平科特 | 平肖 | pinchot
范热 | 范格特 | fanget
伊尔格 | 伊尔克 | ilg
查森 | 蔡森 | chasen
科佩拉 | 科皮拉 | coppela
胡拉比安 | 朱拉布奇安 | joorabchian
斯拉特里 | 斯莱特里 | slattery
厄尔马思 | 厄马思 | earmarth
希拉克 | 希莱克 | shillaker
贝格尔曼 | 比格尔曼 | begelman
海金斯 | 哈金斯 | hugghins
梅约 | 梅奥 | mayo
安蒂维尔 | 安特维尔 | antevil
达纳文特 | 杜纳万特 | dunavant
基珀斯 | 凯珀斯 | kuipers
梅因唐德 | 梅因唐纳德 | maindonald
麦卡勒里 | 麦卡利里 | mcalery
黑兹尔廷 | 黑兹尔坦 | hazeltine
迈格希尔 | 迈伊尔 | mighill
赫曼 | 希曼 | heman
布罗瑟 | 布拉泽 | brother
泰恩 | 锡恩 | thynne
弗里斯 | 弗里亚斯 | freas
布里安 | 布赖恩 | brian
勒滕德尔 | 勒滕德 | letendre
杰斯 | 杰西 | jesse
利夫斯丘 | 莱韦斯克 | levesque
奥德里 | 奥德丽 | audrey
安德里尔 | 安德里奥尔 | andriole
英奇坎 | 英奇昆 | inchiquin
勒彭内克 | 勒佩内克 | lepennec
津巴尔多 | 津巴多 | zimbardo
多南费尔德 | 多宁费尔德 | donenfeld
内诺斯 | 纳诺斯 | nanos
沃尔德雷普 | 沃尔德里普 | waldrep
德马西奥 | 德马肖 | demascio
穆科夫斯基 | 穆科斯基 | mukowski
泽谢拉 | 泽克拉 | zechella
卡莉 | 凯莉 | kallie
斯凯特 | 斯卡特 | skate
布古尔德 | 布古尔 | bougourd
塞文 | 西文 | sevin
欣恩 | 希恩 | shinn
庞纳珀拉马 | 庞南佩鲁马 | ponnamperuma
米曾 | 迈曾 | mizen
洛梅尔 | 隆梅尔 | lommel
金尼弗 | 珍妮弗 | gennifer
查萨尼斯 | 沙萨涅 | chassagnes
厄尔利 | 厄利 | earley
艾尤托 | 阿尤托 | aiuto
布夫鲁德 | 鲍赫鲁德 | boughrood
吉隆 | 吉伦 | gillon
沃克 | 瓦克尔 | wacker
路易佐 | 路易祖 | louizou
弗兰兹 | 弗朗兹 | franz
米泽尔 | 米泽勒 | mizelle
托雷斯 | 托里斯 | torres
沃尔本 | 沃莱本 | wohlleben
普法尔茨格拉夫 | 法尔茨格拉夫 | pfaltzgraff
沃申科 | 瓦申科 | washenko
博尼特 | 博内特 | bonett
伊利特 | 艾利特 | ilett
多伊施格尔 | 多伊施尔 | deuschl
马克斯威尔 | 马克斯维尔 | maxvill
马库斯 | 马库塞 | marcuse
伊尔明杰 | 艾尔明格 | irminger
阿伦 | 艾伦 | allen
布贾克 | 布亚克 | bujake
约瑟姆 | 乔撒姆 | jotham
加诺 | 加诺特 | garnaut
古卡斯 | 古奥卡斯 | guokas
迪特特 | 迪泰特 | dittert
杜尔菲 | 德菲 | durfee
克里维利 | 克里韦利 | crivelli
菲查伊尔温 | 菲茨艾尔温 | fitzailwyn
埃迪生 | 埃迪森 | eddison
希金博瑟姆 | 希金博特姆 | higinbotham
马杰 | 马季 | marj
布加斯 | 巴加斯 | bugas
埃奇达尔 | 埃奇代尔 | edgedal
凯伊 | 基 | key
林兹滕 | 林斯滕 | lindsten
贝罗尔 | 伯罗尔 | berall
凯特伦 | 卡特伦 | catron
斯威特凯 | 斯威凯 | switkay
布里哈特 | 布里尔哈特 | brillhart
索比洛夫 | 索贝洛夫 | sobeloff
兹瓦尔斯基 | 兹巴尔斯基 | zbarskiy
麦卡西克 | 麦库西克 | mckusick
贝格尔 | 贝尔 | beighle
休利尔 | 特威利尔 | thuillier
法拉古特 | 法拉格特 | farragut
科德 | 科尔德 | coard
德加拉迪安 | 德加拉贝迪安 | dergarabedian
诺萨普顿 | 诺桑普顿 | northampton
赫伦布兰德 | 海伦布兰德 | hellenbrand
厄布 | 厄尔布 | erb
西茜 | 锡西 | cissie
莱兰 | 利兰 | lelland
弗雷德丽卡 | 弗雷德里卡 | fredrica
温泽尔 | 温策尔 | wenzel
雷蒂农 | 拉蒂农 | ratinon
巴蒙特 | 贝蒙特 | bamont
奥尔德海泽 | 奥尔迪泽 | aldhizer
纳吉恩 | 纳金 | nagean
道兹韦尔 | 多德斯韦尔 | dowdeswell
托宁 | 索宁 | thorning
米齐 | 梅齐 | meazey
尤特 | 尤思 | uthe
格鲁乔 | 格劳乔 | groucho
迪伦福思 | 迪伦弗思 | dhyrenfurth
扎尔米 | 扎尔梅 | zalmay
扬克威奇 | 扬克维奇 | yankwich
萨奇曼 | 塞奇曼 | sageman
克奇维尔 | 克切维尔 | kercheville
德西雷 | 德西蕾 | desiree
奎利 | 丘利 | kewley
迪德 | 戴德 | dyde
比恩 | 拜昂 | bion
加根 | 加黑根 | gahagen
麦金图夫 | 麦金塔夫 | mcinturff
莫富兹 | 莫维兹 | morfudd
桑克利 | 尚克利 | sankley
罗马因 | 罗曼 | romaine
塞马拉 | 赛马拉 | saemala
怀斯坦 | 威斯坦 | wystan
吉尔赫利 | 吉尔胡利 | gilhuly
博德瓦恩 | 鲍德温 | bodwine
勒斯 | 卢斯 | luss
鲍科姆 | 鲍库姆 | bawcombe
莱因斯 | 莱恩斯 | lines
莱瑟夫 | 勒瑟夫 | lesurf
查伦杰 | 查林杰 | challenger
塞特 | 撒特 | thaete
约基尔森 | 约克尔森 | yochelson
西伊 | 西赫 | sih
弗朗西娅 | 弗朗西亚 | francia
亨特雷斯 | 亨特里斯 | huntress
图尤森 | 蒂乌萨宁 | tiusanen
塞博尔德 | 西博尔德 | seybold
安尼 | 阿内尼 | aneny
马斯曼 | 穆斯曼 | mussman
沃朗德 | 沃尔龙德 | walrond
阿尔韦尔 | 奥尔韦尔 | alwell
萨奇 | 萨特杰 | satge
吉龙 | 吉伦 | gearon
贾尼斯 | 贾尼西 | janisse
杜西 | 达西 | duthie
加汉 | 加恩 | gahan
德雷波 | 德拉珀 | drapeau
巴里克 | 巴威克 | barwick
迪利 | 杜利 | duley
霍奇加特 | 霍贾特 | hodgart
桑比 | 桑德比 | saundby
德斯博伊斯 | 德布瓦 | desbois
斯韦布 | 斯韦比 | swaebe
弗鲁伊特 | 弗鲁特 | fruit
伊尔恩 | 伊尔伦 | illearn
阿布洛姆 | 阿布隆 | ablom
博尔加塔 | 博加塔 | borgatta
埃斯梅尔 | 伊斯梅尔 | esmail
沃滕伯格 | 瓦滕伯格 | wattenberg
安图斯 | 安图尼斯 | antunes
阿迪内特 | 阿迪尼特 | adinet
邓科姆 | 邓库姆 | duncombe
吉尔克雷斯特 | 吉尔克里斯特 | gilchrest
迪克 | 迪克尔 | dicker
佩特金 | 彼得金 | peterkin
杰巴尔 | 格巴尔 | geballe
霍埃尔贝克 | 胡尔贝克 | houiellebecq
布希 | 布舍 | busche
卡梅尔福德 | 卡姆尔福德 | camelford
勒金比尔 | 卢金比尔 | lukingbeal
布吕恩 | 布鲁恩 | bruene
拜伊 | 布伊 | buie
马尔欣 | 马尔夏恩 | mulshine
米哈拉克 | 迈克拉克 | michalak
埃莱克拉 | 伊莱克特拉 | electra
查费茨 | 查菲茨 | chafetz
瑟米厄斯 | 瑟缪斯 | sermeus
安杰尔斯 | 安杰利斯 | angeles
伊卡恩 | 伊坎 | icahn
雷埃尔 | 鲁埃尔 | reuel
桑恩 | 图恩 | thun
泰瑟 | 特瑟 | tether
克利安德 | 克林德 | cleander
海森 | 希森 | hyson
吉诺尔 | 格瑙尔 | genauer
克莱夫 | 克拉夫 | clave
蒙东纳 | 蒙顿纳 | montonna
卡莎 | 卡沙 | kasha
利多姆 | 利德姆 | leedom
马拉布尔 | 梅拉伯 | malabre
苏里纳 | 苏雷纳 | surena
利希特瓦特 | 利希特瓦尔特 | lichtwardt
奥弗罗尔 | 奥费拉尔 | o'ferrall
马琴 | 梅琴 | machen
塔谢罗 | 塔什罗 | taschereau
埃廷杰 | 埃廷格 | ettinger
安纳尼 | 阿纳尼 | anany
查彭 | 沙蓬 | chapone
林迪 | 琳迪 | lynndie
多纳夫莫尔 | 多诺莫尔 | donoughmore
奇德尔 | 切德尔 | chedell
卡兰 | 卡莱恩 | carline
唐多夫 | 汤多夫 | tondorf
甘博阿 | 甘博亚 | gamboa
巴蒂泽尔 | 巴蒂扎尔 | bartizal
费耶 | 费尔 | fayer
康伯 | 库默 | comber
赫施 | 胡希 | husch
阿克利 | 埃克利 | akeley
尤泽 | 尤伊泽 | ueyser
奥拉 | 奥尔拉 | orla
卡丹 | 卡登 | kadane
图希 | 图伊 | tuohey
维拉亚博斯 | 比利亚洛沃斯 | villalobos
卢什 | 勒什 | lush
迪达姆 | 迪德姆 | deedham
纳尔 | 诺尔 | nall
斯特朗伯格 | 斯特龙伯格 | stromberg
格维茨 | 格威茨 | gurwitz
德梅特 | 德梅特尔 | demaitre
马加甘 | 马加芬 | magafan
哈特内特 | 哈特尼特 | hartnett
托姆林 | 汤姆林 | tomline
贝尔里 | 比尔里 | beary
达姆勒 | 杜姆勒 | dumler
海恩菲尔德 | 汉费尔德 | hainfeld
沃拉 | 瓦拉 | walla
伊尔德赫姆 | 埃尔德姆 | ealdhelm
斯托内克 | 斯托尔内克 | stalnecker
马杰里 | 马格丽 | margery
贝沃尔德 | 贝瓦尔德 | baerwald
盖伊 | 贾伊 | ghey
莱姆斯 | 里姆斯 | rheims
蒙卡姆 | 蒙特卡姆 | montcalm
费罗泽德 | 费罗祖德 | ferozud
普拉格 | 普拉奇 | plugge
基乔亚 | 凯乔 | kejoa
博斯顿 | 波士顿 | boston
费克特卡蒂 | 费克特库蒂 | feketekuty
杜布纳 | 达布纳 | dubner
赫芬 | 赫法恩 | huffine
门恰卡 | 门查卡 | menchaca
瑟希 | 塞希 | sershey
埃诺 | 伊诺 | eno
塞利格曼 | 塞利希曼 | seligmann
加韦德 | 加维德 | gaved
科奇尼希 | 科奇尼格 | kotschnig
斯特雷姆劳 | 斯特里姆劳 | stremlau
拜尔 | 贝耶尔 | beier
贝霍弗 | 贝克霍弗 | bechhofer
安斯蒂德 | 安斯特德 | anstead
瑟瓦克 | 瑟瓦奇 | serwach
埃斯林 | 阿斯林 | acelin
阿菲 | 埃菲 | afee
西德博特姆 | 赛德博特姆 | sidebotham
格德 | 格尔德 | gerd
埃克洛夫 | 埃克勒夫 | eklof
博奈 | 博尼 | boney
博格特 | 博格蒂尔 | boghatyr
芬格勒 | 芬勒 | fengler
豪恩谢尔 | 霍恩谢尔 | hounshell
伊因 | 约恩 | eoin
索 | 托 | thau
西德尼 | 西妮 | sydni
图里曼 | 图尔曼 | tureman
德西德拉塔 | 德西德蕾塔 | desiderata
乔埃特 | 朱厄特 | jouett
约克威廉斯 | 约克威廉 | yorkwilliams
弗拉利克 | 弗雷利克 | fralick
塞尔娜 | 塞尔纳 | serna
伦宁 | 伦南 | lennen
罗吉特 | 罗热 | roget
弗雷伊 | 弗雷 | frej
阿伯恩 | 阿本 | abern
伊登 | 艾登 | idden
杰瑟里克 | 杰塞里克 | jeserich
希格内特 | 希格尼特 | hignett
杜庞特 | 杜邦 | dupont
克利姆克 | 克利姆基 | klimcke
赫尔布尔 | 赫布尔 | helble
比尔布拉夫 | 比尔伯勒 | bilbrough
莫赫 | 莫克 | moch
特雷珀 | 特拉皮尔 | trapier
乌布赖特 | 昂布里特 | umbreit
布劳恩 | 布朗 | browne
凯高 | 凯加鲁 | caegarw
赫沃斯 | 休沃斯 | huvos
萨姆斯塔格 | 扎姆斯塔格 | samstag
麦克诺格 | 麦克诺尔 | mcnaugher
贾格斯 | 贾格尔斯 | jaggers
格伦巴克 | 格伦巴赫 | grumbach
凯斯 | 基斯 | keys
萨基纳 | 萨金娜 | sakinah
勒福 | 勒方 | lefaune
拉夫向 | 拉夫肖恩 | rafshoon
贝曼 | 比曼 | beman
休弗特 | 索伊弗特 | seufert
斯特里文斯 | 斯特雷文斯 | strevens
斯坦纳姆 | 斯塔纳姆 | stanham
帕特诺 | 佩特诺 | paterno
阿克申 | 埃克申 | action
迈因沙因 | 梅恩沙因 | maienschein
齐曼 | 齐梅曼 | zimmeman
桑兹 | 桑德斯 | sondes
班恩 | 班 | bang
穆普森 | 马普森 | mupson
埃尔利 | 埃尔勒 | ehrle
勒克赫斯特 | 卢克赫斯特 | luckhurst
卡罗尔 | 卡萝尔 | carole
埃丁杰 | 埃丁格 | edinger
德维尔 | 德韦尔 | deveulle
麦高兰 | 麦戈兰 | mcgauran
登帕赛 | 登帕西 | dempasay
福尔康布里奇 | 福尔肯布里奇 | falconbridge
朗伊诺 | 朗吉诺 | longino
马库斯 | 马克斯 | marcuss
格林斯特德 | 格林斯蒂德 | grinstead
赖德尼斯 | 莱因德尼斯 | rhindness
克纳夫 | 纳夫 | knaff
米多斯 | 梅多斯 | meadows
帕德西 | 帕齐 | pudsey
莱加特 | 莱格特 | legatt
尼科莱迪斯 | 尼古拉迪斯 | nikolaidis
贝特拉 | 伯特拉 | bertera
戈利特利 | 戈莱特利 | golightly
蒙尼克休森 | 芒尼克海森 | munnikhuysen
奇尔德 | 蔡尔德 | child
尤尔科威茨 | 尤尔科维茨 | jurkowitz
休 | 舍韦 | schewe
麦金金 | 麦克琼金 | mcjunkin
拉贝特 | 拉贝 | rabet
麦克法迪安 | 麦克法迪恩 | mcfadyean
卢内德 | 莉内德 | luned
科克兰 | 科克伦 | cochrane
布扎纳 | 布尔扎纳 | brzana
莫尔霍尔特 | 莫霍尔特 | molholt
法尔 | 费尔 | phaer
阿加西亚 | 阿加西娅 | agacia
克里茨 | 克赖茨 | crites
布雷恩特里 | 布伦特里 | braintree
钱伯林 | 钱伯辛 | chamberlsin
格青格 | 格青杰 | getsinger
欧维特 | 艾尔薇特 | irvette
霍尼斯 | 霍尔尼斯 | holness
艾舍伍德 | 伊舍伍德 | isherwood
德尼奥 | 迪奈欧 | denio
基尔 | 基利 | kille
奥滕内尔 | 奥塞内尔 | othenel
马尼奥利亚 | 马格诺利娅 | magnolia
埃莱斯米尔 | 埃尔斯米尔 | ellesmere
戴西 | 黛西 | daisy
沃西海姆 | 沃特海姆 | wertheim
克里斯特劳 | 克里斯戈 | christgau
奥科因 | 奥库安 | aucoin
帕尼思 | 帕内思 | paneth
彼得罗 | 佩特罗 | petro
诺科伊 | 诺基 | norquoy
马克厄姆 | 梅卡姆 | makeham
斯特罗布里奇 | 斯特劳布里奇 | strawbridge
斯米利 | 斯迈利 | smily
希肯洛珀 | 希肯卢珀 | hickenlooper
巴尔塔萨 | 巴尔塔泽 | baltassar
迪克 | 杜凯 | duque
海尔凯 | 海尔基 | heilkay
弗利金格 | 弗利金杰 | flickinger
泽比娜 | 泽拜纳 | zebina
麦坎嫩尼 | 麦卡内尼 | mcaneney
布拉夫 | 布劳 | blough
格拉斯戈 | 格拉斯哥 | glasgow
赫兴格 | 赫金杰 | hechinger
斯梅耶 | 斯梅奇 | smaje
奥利文特 | 奥利万特 | ollivant
戈洛琴科 | 戈洛夫琴科 | golovchenko
麦克莱莫尔 | 麦克勒莫尔 | mclemore
麦克费德兰 | 麦克费德伦 | macphedran
奥迪吉尔 | 奥迪吉耶 | audigier
赫蒙 | 哈蒙 | hummon
伯特胡德 | 伯绍德 | berthoud
奥尔卡德 | 阿尔卡德 | alcalde
帕克特 | 帕赫特 | pachter
比奥利 | 比利 | beoley
古比托希 | 古比托西 | gubitoshi
比塔 | 比塔尔 | bitar
姆莱卡 | 姆拉卡 | mlakar
耶登 | 伊登 | yeadon
麦克斯帕兰 | 麦克斯帕伦 | mcsparran
达尔维奇 | 达利奇 | dulwich
格罗塞斯特 | 格罗斯泰特 | grosseteste
洛基埃尔 | 洛希尔 | lochiel
弗雷埃尔 | 弗雷耶 | freyere
恩格尔道 | 恩格尔多 | engledow
斯康菲尔德 | 舍恩菲尔德 | schonfield
贾亚克 | 齐亚克 | dziak
斯托尔普曼 | 施托尔普曼 | stolpman
弗兰普欣 | 弗兰普申 | framption
博雷特 | 博里特 | borrett
迈克尔约翰 | 米克尔约翰 | meiklejohn
拉肯迈耶 | 拉肯米尔 | lackenmier
费彻姆 | 费克姆 | feachem
拉坎帕涅 | 拉康帕涅 | lacampagne
索维奇 | 索瓦热 | sauvage
埃尔丝 | 埃尔斯 | else
赫曼 | 赫尔曼 | herman
科帕德 | 科珀德 | coppard
盖曼 | 格曼 | gehman
埃尔齐 | 埃尔扎伊 | elzay
巴思 | 巴特 | barthe
埃斯科菲 | 伊斯科菲 | escoffey
吉利亚姆 | 吉列姆 | gilliam
皮雷 | 皮埃尔 | pierre
博施维茨 | 博希威茨 | boschwitz
哈德格里 | 哈迪格里 | hardegree
皮尔 | 珀尔 | pearl
伊格列维奇 | 伊格尔维奇 | iglewicz
洛西安 | 洛西恩 | lowthian
多姆安 | 多米扬 | domjan
阿巴斯蒂尼娅 | 阿巴斯蒂尼亚 | abastenia
艾利斯 | 阿莱斯 | allies
休伊泽 | 哈伊泽 | huyser
康梅杰 | 康马杰 | commager
卡拉佩安 | 卡拉佩琴 | carapetyan
布里宁 | 布赖宁 | bryning
麦克希恩 | 麦克钦 | mccheane
埃德尔 | 伊德尔 | eedle
切尔滕纳姆 | 切尔特纳姆 | cheltenham
克拉布布里 | 克拉布特里 | crabtree
特洛 | 特略 | tello
纽伯勒 | 纽伯格 | newburgh
威克斯蒂德 | 威克斯第德 | wicksteed
斯科格伦 | 斯科格隆 | skoglund
温塔尔 | 温特尔 | weintal
贾夫 | 贾菲 | jaffe
斯塔姆 | 施塔姆 | stamm
法扎 | 法扎尔 | fazar
马塞尔 | 玛塞勒 | marcelle
尤因斯 | 尤温斯 | uwins
塞赫尔斯基 | 切赫尔斯基 | cehelsky
尤莱维奇 | 乌莱维奇 | ulevich
达尔斯特龙 | 达尔斯特伦 | dahlstrom
勒肯 | 卢肯 | lukken
马顿 | 梅顿 | maton
希拉 | 夏伊拉 | shyla
比恩 | 比汉 | beehan
法尔肯海姆 | 福尔肯海姆 | falkenheim
斯劳斯 | 斯波斯 | spouse
洛恩 | 洛温 | lowen
乔翰尼 | 约翰尼 | johnny
德弗勒 | 德夫勒 | doerfler
贝默赛德 | 比默赛德 | bemersyde
米姆诺 | 明诺 | mimno
布平达 | 布平达尔 | bhupindar
罗明 | 罗梅因 | romeyn
布里克斯皮尔 | 布雷克斯皮尔 | breakspear
扬格斯本德 | 扬哈斯本 | younghusband
夏皮 | 沙比 | sharpey
莱塞奇 | 勒萨热 | lesage
巴布利斯 | 布勃利斯 | bublys
辛皮克 | 辛皮奇 | simpich
特德福德 | 塞德福德 | thedford
伯特霍尔夫 | 伯索夫 | bertholf
塞迪亚 | 切迪亚 | ceddia
戴文波特 | 达文波特 | davenport
舒特利夫 | 舒特莱夫 | shurtleff
斯波特德 | 斯波蒂德 | spotted
乔齐 | 乔茜 | jozy
黛安 | 戴安 | dian
赞布鲁姆 | 赞布勒姆 | zambrum
史迈西斯 | 斯迈西斯 | smythies
科尔特 | 库尔特 | coult
劳克哈夫 | 劳卡夫 | laukhuff
米尔希 | 米尔海 | milhy
卡德根 | 卡杜根 | cadwgan
博希尔 | 博舍尔 | boshier
博维 | 博韦 | bovee
赫克顿 | 赫克通 | hektoen
莱维 | 利瓦伊 | levi
乔尔万 | 朱尔万 | joulwan
卡佐克雷亚 | 库佐克雷亚 | cuzzocrea
阿德基森 | 阿基森 | adkisson
施莱 | 施利 | schlie
伊菲吉恩 | 伊菲吉妮 | iphigene
泰菲恩 | 泰维恩 | teifion
亚历克西斯 | 亚历克西丝 | alexys
戈尼娅 | 戈尼亚 | gonya
拉罗姆 | 拉勒姆 | larom
坎佩涅 | 坎佩恩 | campaigne
古茨怀勒 | 古茨维勒 | gutzwiller
马奎斯 | 马克斯 | marques
勒金 | 勒德金 | ludgin
阿尔皮娜 | 阿尔皮纳 | alpina
德拉弗斯 | 德雷弗斯 | dravers
韦里尔 | 沃雷尔 | werrell
福尔兹 | 福尔茨 | folz
德福德 | 德福特 | deford
齐尼基 | 齐尔尼基 | ziernicki
博比萨德 | 博比苏德 | bobisud
图勒 | 特尔 | tourle
图利特 | 塔利特 | tulett
斯塔克 | 斯图克 | stucke
尚伯格 | 舍恩伯格 | schonberger
兰贝利特 | 兰伯利特 | lambelet
吉 | 贾伊 | gye
利希滕斯坦 | 利克滕斯坦 | liechtenstein
安德鲁凯斯基 | 安德鲁斯克维奇 | andruskevich
布金 | 布尔金 | bourgin
比 | 布埃 | bue
埃维斯 | 阿维丝 | aveis
斯卡珀罗 | 斯卡佩罗 | scarpero
斯特兰格 | 斯特兰杰 | stranger
阿伦 | 阿龙 | aaron
马尔克斯 | 马尔库斯 | malkus
杜奇 | 杜格 | dhooge
齐恩 | 蔡恩 | zion
格尔巴赫 | 盖尔博 | gelbach
卢夫特 | 勒夫特 | luft
布雷克兰 | 布里克兰 | brekland
布巴拉 | 布阿哈拉 | buachalla
里丁斯 | 赖丁斯 | ridings
沃尔克 | 沃克 | walke
考特尼 | 考特妮 | kourtney
布洛姆伦 | 布洛姆格伦 | blomgren
奎尔 | 屈尔 | kuehl
比利尔 | 比埃 | billiere
埃尔杰 | 埃尔格 | elger
曼恩 | 曼 | mann
赫齐娜 | 赫齐纳 | herzina
施纳克 | 施努克 | schnuck
普钦斯基 | 普辛斯基 | pucinski
贾拉特 | 贾勒特 | jarratt
尼科利 | 尼古拉 | nicolay
梅尔森 | 默森 | merson
威尔茜 | 威尔西 | willsie
弗雷塔格 | 弗赖塔格 | freytag
撒尔肯 | 萨尔肯 | thalken
基米特 | 金米特 | kimmitt
乔登斯 | 乔丹斯 | jordans
利瑟特 | 利撒特 | leathart
赖津 | 里津 | ryzin
鲁勒 | 鲁伊勒 | rouiller
索利斯 | 索莱 | saulez
斯坦齐克 | 斯坦奇克 | stanczyk
布莱琴登 | 布莱钦登 | blechynden
巴索尔缪 | 巴托洛缪 | bartholemeu
西尔克 | 瑟克 | cirker
德文特 | 德温特 | derwent
恩德科特 | 恩迪科特 | endecott
阿尔文 | 阿尔温 | alwin
拉瑟姆 | 莱瑟姆 | lathom
霍塞尔 | 休塞尔 | heusel
莱弗勒 | 莱弗拉尔 | leflar
罗萨佩普 | 罗萨皮普 | rosapepe
亨宁堡 | 赫宁堡 | heningburg
巴萨德 | 巴萨德雷 | basadre
福伊尔泽格 | 福伊尔齐格 | feuerzeig
派约特 | 派奥特 | pyott
塞勒斯 | 塞拉斯 | sellars
梅卢普斯 | 梅拉普斯 | mellups
马拉赫 | 马拉克 | malach
巴尔西格 | 巴尔西杰 | balsiger
希拉伯 | 希莱伯 | shillaber
斯特费斯 | 斯特弗斯 | steffes
卡斯特尔伯里 | 卡斯尔伯里 | castelberry
吉尔鲍德 | 吉尔博 | guillebaud
贝切特 | 贝谢 | bechet
鲁马塞特 | 罗马塞特 | roumasset
克奇弗 | 克切弗 | kerchever
比阿特丽娅 | 比阿特丽西娅 | beatricia
福法尔 | 福法 | forfar
梅努因 | 梅纽因 | menuhin
舒雷 | 舒尔 | shure
凯格 | 基格 | keig
菲阿尔卡 | 菲亚尔卡 | fialka
伊萨科 | 伊萨科夫 | isakow
巴尔塔利尼 | 巴塔利尼 | battaglini
克伦西克 | 赫伦奇克 | chrencik
彭沃尔特 | 佩恩沃尔特 | pennwalt
库塞维茨基 | 科乌谢维茨基 | koussevitzky
米尼奥 | 米内奥 | mineo
伊尔塔德 | 伊尔蒂德 | illtud
弗罗泽 | 弗勒泽 | froese
阿什利 | 阿什莉 | ashleigh
谢纳里 | 切纳里 | chenery
弗拉赫蒂 | 弗莱厄蒂 | flaherty
诺克斯 | 努克斯 | nokes
恰鲁奇 | 基亚鲁奇 | chiarucci
舍格尔斯 | 舍加尔斯 | shergals
贝格鲁普 | 贝格特鲁普 | begtrup
安德卡 | 安贝德卡 | ambedkar
杜克诺伊 | 迪克努瓦 | duquenoy
柯彻 | 基尔舍 | kircher
斯托岑巴赫 | 斯托曾巴赫 | stolzenbach
柯蒂斯 | 柯蒂兹 | curtiz
马德里德 | 马德里 | madrid
多恩 | 唐 | donn
凯特尔比 | 基特尔比 | ketelbey
怀甘特 | 威甘特 | wygant
博弗里 | 博韦里 | boverie
阿莱格拉 | 阿利格拉 | allegra
阿姆斯威茨 | 阿姆谢维茨 | amshewitz
奥法雷尔 | 奥法雷 | o'farrell
卢宁 | 吕宁 | luening
特金 | 图尔金 | turkin
西里 | 蒂里 | thierry
乔西 | 约瑟 | josee
施赖伯 | 施里伯 | shriber
迈斯兰 | 迈斯拉恩 | meislahn
利昂内尔 | 莱昂内尔 | lionel
格尔纳 | 盖尔纳 | gellner
森塞尼克 | 森塞尼奇 | sensenich
塞克肖尔 | 塞克索尔 | sexauer
亨尼卡特 | 亨尼克特 | hunnicutt
本恩 | 贝恩 | benne
科斯 | 库斯 | coes
斯库斯 | 斯丘斯 | skuce
舍内曼 | 舍尼曼 | schoeneman
霍伊斯布罗克 | 哈维克斯布罗克 | hawixbrock
古希利 | 贡希利 | goonhilly
哈里尔 | 哈丽尔 | harriel
奎恩 | 奎因 | queen
塞塞尔 | 塞斯尔 | sessel
费尔马纳 | 费尔曼纳 | fairmaner
法尔斯 | 法伊尔斯 | fyles
阿尔西夫伦 | 阿尔西弗龙 | alciphron
达纳根 | 杜纳根 | dunagan
特雷西 | 特蕾西 | tracey
乔克 | 吉奥克 | giauque
埃尼德 | 伊妮德 | enid
萨金特 | 瑟金特 | searjeant
拉金 | 莱金 | laging
尚伯格 | 舍恩伯格 | schonberg
米特塞夫 | 米采夫 | mitseff
范格 | 范杰 | fanger
布兰肯 | 布兰昌 | blanchan
布拉斯塔德 | 布鲁斯塔德 | brustad
霍尔迪曼德 | 哈尔迪曼德 | haldimand
吉廉斯 | 吉利亚姆 | guilliams
多奇 | 道奇 | dodge
梅莉娅 | 米利亚 | melia
斯威恩 | 斯温 | sween
弗赖赖克 | 弗赖雷克 | freireich
戈梅什拉塔 | 戈梅斯普拉塔 | gomezplata
布乔伊斯 | 布儒瓦 | bourgeois
安东尼奥 | 安东尼乌 | antoniou
罗伊巴尔 | 罗伊鲍尔 | roybal
布什夫 | 布舒夫 | bushueff
萨吉塔里厄斯 | 萨吉泰里厄斯 | sagittarius
比克 | 贝克 | beek
特怀德尔 | 特威德尔 | twidell
伦诺尔德 | 伦瓦尔 | renouard
希拉斯 | 希勒斯 | heelas
卡尔德克勒 | 考尔德克拉夫 | caldcleugh
克拉格 | 克莱格 | clague
切希尔 | 切斯希尔 | chesshyre
布雷钦 | 布里金 | brechin
古德勒姆 | 古德哈姆 | gooderham
巴恩 | 鲍恩 | balne
霍普 | 霍伊普 | heup
富尔哈姆 | 富勒姆 | fulham
希曼娜 | 希曼纳 | sheemanna
施莱尔 | 施赖尔 | schreyer
阿查尼奇 | 阿德查尼克 | ardcharnich
贝迪利恩 | 贝迪利翁 | bedillion
斯迈思 | 史密斯 | smyth
赖道特 | 赖德奥特 | rideout
麦考斯兰 | 麦考斯伦 | mcauslan
尼思代尔 | 尼斯代尔 | nithsdale
皮阿罗斯 | 皮特罗斯 | peatross
布卢顿 | 布勒顿 | blurton
马蒂奥 | 马泰奥 | matteo
基文 | 凯文 | keven
多罗西 | 多萝西 | dorothy
斯塔宾 | 斯图宾 | stubbing
索罗茨 | 索尔特斯 | solotesz
坎普施罗 | 坎普施罗尔 | kampschror
布姆斯特德 | 巴姆斯特德 | bumstead
莱伦 | 莱恩 | len
德斯马托 | 德马尔托 | desmarteau
迪伯斯坦 | 杜伯斯坦 | duberstein
马吉雷尔 | 马圭雷尔 | maguirel
谢尔普 | 谢普 | shairp
格赖德 | 格雷德 | greider
普雷彻 | 普里彻 | preacher
索恩代克 | 桑代克 | thorndike
马沙姆 | 马香 | marsham
奥伯赫尔曼 | 奥伯黑尔曼 | oberhelman
多休 | 多尼休 | donehue
帕特里亚赫 | 佩特里亚克 | patriach
海内曼 | 海涅曼 | heinemann
里卡兹 | 理查兹 | richards
艾奇森 | 艾奇逊 | eytchison
布里恩特 | 布赖恩特 | briant
科尔菲亚托 | 科菲亚托 | corfiato
丹罗伊瑟 | 丹罗伊特 | dannreuther
巴恩比 | 巴恩贝 | barnebey
梅林达 | 梅琳达 | melinda
弗伦泽 | 弗伦策 | frenzer
康西尔 | 康斯尔 | council
沙因鲍姆 | 欣鲍姆 | sheinbaum
尚顿 | 桑顿 | szanton
克罗齐尔 | 克罗泽 | crozier
沃拉尼厄斯 | 瓦拉尼厄斯 | waranius
赫马尼克 | 赫马纽克 | hermaniuk
哈默特 | 赫默特 | hummert
拉曾 | 拉津 | razeen
埃尔万 | 埃尔温 | elwane
古夫 | 高夫 | gough
巴特格尔 | 巴塔杰尔 | battagel
埃瓦克 | 埃厄克 | earwaker
格林达尔 | 格林德尔 | grindal
西弗林豪斯 | 塞夫林豪斯 | sevringhaus
贾科泰特 | 贾科泰 | jacottet
布里尔利 | 布里厄利 | brealey
麦科申内格 | 麦科尚奈格 | maco'shannaig
麦克廷格 | 马赫廷格 | machtinger
梅贝 | 梅布 | mabe
柯尼格 | 凯尼格 | koernig
马米特 | 马梅特 | mamet
卡思尔 | 卡瑟尔 | cuthell
迪威斯 | 德威斯 | dewees
奥琳达 | 奥林达 | orinda
基茨哈伯 | 基察伯 | kitzhaber
布雷齐尔 | 布雷热 | brazier
斯米亚亚克 | 斯米亚利克 | smialek
芬尼 | 菲尼 | phinney
阿曼德斯 | 阿曼达斯 | amandus
赛纳 | 西纳尔 | synar
康科拉 | 康科勒 | concholar
迪莱奥 | 德利奥 | deleo
肖勒 | 朔伊勒 | scheuler
特鲁曼 | 杜鲁门 | truman
达奇 | 达基 | dachi
迪奥 | 德奥 | deo
拉思 | 雷思 | rathe
哈尔巴克 | 哈尔巴赫 | halbach
赫利 | 赫尔利 | hurleigh
斯通纳 | 斯托纳 | stoner
克里克顿 | 克赖顿 | crichton
格威内德 | 格威内思 | gwynedd
道伊 | 杜伊 | douie
凯利 | 基利 | kealy
波威尔斯 | 鲍威尔斯 | powels
罗雷姆 | 罗勒姆 | rorem
沃蒂埃 | 沃捷 | vautier
安德里欧 | 安德里厄 | andrieux
阿莱恩 | 阿林 | alleine
贝克 | 贝克尔 | becker
怀索基 | 维索茨基 | wysocki
杰萨普 | 杰瑟普 | jesup
比弗 | 贝弗 | bever
艾尔布雷希特 | 艾尔布拉赫特 | eilbracht
希尼 | 赫尼 | henie
诺伦 | 诺伦德 | norlund
萨里奇 | 瑟里奇 | surridge
杜 | 迪尤 | dew
唐西娅 | 唐西亚 | donsia
杜克罗 | 迪克罗 | ducrow
沃尔克 | 沃克 | walk
沃尔克 | 沃克 | walker
麦迪森 | 麦迪逊 | madison
麦科拉姆 | 麦科勒姆 | mccollam
德格雷赫特 | 德格拉赫特 | dergracht
迈尔堡 | 迈尔伯格 | myerburg
斯坦达洛夫特 | 斯坦德洛夫特 | standaloft
莱恩斯 | 莱昂斯 | lyons
德沃查克 | 德沃夏克 | dvorchak
布布里坎特 | 法布里坎特 | fabricant
科克伦 | 库格伦 | coughran
多克特 | 多克托 | docktor
菲莱恩 | 法林 | filene
斯科尔 | 肖勒 | scholle
菲内尔 | 芬内尔 | feennell
肖德尔 | 欣德尔 | schindell
塞门扎 | 西门扎 | semenza
哈森富斯 | 哈森弗斯 | hasenfus
加索夫 | 加特霍夫 | garthoff
彼得龙 | 佩特龙 | petrone
格里桑蒂 | 格里桑迪 | grisanti
布赖安娜 | 布里安娜 | bryanna
梅尔斯 | 马雷斯 | mares
庞滕尼 | 庞特尼 | pounteney
冈利 | 高恩利 | gownley
劳本盖尔 | 劳本盖耶 | laubengayer
阿图鲁斯 | 阿图罗斯 | arturous
布兰肯巴克 | 布兰肯贝克 | blankenbaker
拉拉比 | 拉勒比 | larabee
埃斯卡达里安 | 伊斯坎达里安 | eskandarian
科尔奎特 | 科尔基特 | colquitt
查宁 | 查嫩 | chanen
贝松 | 贝森 | bessone
塞科夫斯基 | 赛科夫斯基 | saikowski
塞格雷夫 | 西格雷夫 | segrave
苏代尔 | 舍代尔 | suirdale
哈莫尔 | 哈默 | hamor
普普 | 普珀 | puppe
施米德 | 施密德 | schmid
塔默格尔 | 塔穆格尔 | tarmugl
黑尔 | 海尔 | haire
哈克威尔 | 黑克威尔 | hakewill
冈扎雷斯 | 冈萨雷斯 | gonzalez
莫纳 | 莫娜 | mona
格雷恩 | 格兰妮 | grainne
布里霍尔特 | 布赖霍尔特 | bryholdt
亚里莫维奇 | 雅里莫维奇 | yarymovych
登尼斯顿 | 丹尼斯顿 | denniston
塞尼奥尔 | 西尼尔 | senior
哈特赛德 | 哈齐德 | hartsid
博伊兹拉贡 | 博勒根 | boisragon
梅特罗普利斯 | 梅特罗波利斯 | metropolis
索叙雷 | 索热尔 | saussure
科克森 | 考克森 | coxon
斯克鲁塔托 | 斯克鲁泰特 | scrutator
格里泽 | 格赖泽 | griser
黑泽利普 | 黑兹利普 | hazelip
贝拉尼娅 | 贝拉尼亚 | berania
戈尔德西蒙 | 戈德西蒙 | goldsymon
利宁 | 莱宁 | leining
许尔霍尔兹 | 许霍尔茨 | schuerholz
肖克尔 | 肖基尔 | showkeir
科尔赫普 | 科尔黑普 | kohlhepp
杰里什 | 格里什 | gerrish
鲁科 | 罗科 | ruocco
加诺尔 | 加诺 | ganor
巴尔迪施维勒 | 巴尔德施维勒 | baldeschwieler
斯洛尼姆 | 斯洛宁 | slonim
马撒 | 玛莎 | martha
珀塞克 | 佩塞克 | perseck
维伦 | 瓦伊伦 | viron
索尔茨 | 肖尔茨 | soults
奇瑟姆 | 奇塔姆 | cheatham
格罗尔德 | 杰罗尔德 | gerould
杰尔 | 耶格 | jaegher
赫里肖夫 | 赫雷斯霍夫 | herreshoff
柯兰 | 柯伦 | curran
瓦伦齐拉 | 巴伦苏埃拉 | valenzuela
肖尔斯 | 肖沃斯 | showers
阿格鲁 | 阿古 | agwu
弗卢克斯 | 弗勒克斯 | flux
索勒 | 索莱尔 | sohler
特劳布里奇 | 特鲁布里奇 | troubridge
卡汉 | 卡亨 | kahane
阿科尔斯基 | 阿特基尔斯基 | atkielski
林恩 | 林 | linn
德赖克 | 德里克 | driker
里查德 | 理查德 | richard
罗伯森 | 罗伯逊 | robertson
达肯 | 达坎 | dakan
吉查姆 | 吉彻姆 | gitsham
利韦亚克 | 莱夫奥克 | liveoak
普鲁斯曼 | 普拉斯曼 | prusman
基弗 | 凯弗 | keifer
吉恩 | 吉亨 | gehan
施纳肯 | 施努克内 | schnukne
梅杰 | 马杰 | mager
阿盖尔 | 阿高尔 | argall
温纳斯特拉姆 | 温纳斯特鲁姆 | wennerstrum
伦德尔 | 伦达尔 | lundahl
卡布尔 | 凯布尔 | cable
利德克 | 利迪克 | luedecke
乔德雷 | 乔德尔 | jordre
普卢内克 | 普伦尼克 | pluenneke
赫希特里特 | 赫什特里特 | hirschtritt
布卡茨施 | 布卡奇 | bukatzsch
贝拉德 | 贝拉尔 | berard
谢恩娜 | 谢娜 | shayna
马尔文农 | 马尔韦农 | mulvenon
皮珀 | 派珀 | piper
罗斯布拉夫 | 罗斯伯勒 | rosebrough
阿特尔西 | 阿特莱西 | attlesey
加格宾 | 加涅班 | gagnebin
霍 | 豪 | howe
布莱克施米特 | 布莱希施米特 | blechschmidt
赫维茨 | 赫威茨 | herwitz
梅恩斯 | 梅因斯 | mains
克兰德 | 克兰 | kland
布卢克 | 布劳克 | blouke
托舍斯 | 托希斯 | tosches
马马杜克 | 马默杜克 | marmaduke
普赖尔 | 普里尔 | preil
拜勒姆 | 比鲁姆 | biroum
科尼罗 | 科内罗 | corneiro
奎伦 | 奎林 | quillen
格鲁恩 | 格伦 | gruene
贝思 | 贝丝 | beth
约赫 | 约埃 | yohe
亚特龙 | 亚特隆 | yatron
斯凯姆 | 斯基姆 | skym
巴思利 | 布思莱 | buthlay
安杰莉娜 | 安杰利娜 | angelina
普伦蒂 | 普朗蒂 | prunty
韦西 | 维齐 | veysey
沃尔斯托尼夫特 | 沃斯通克拉夫特 | wollstonecraft
法夫罗特 | 法夫罗 | favrot
阿曼 | 阿尔曼 | arman
阿米欧 | 阿米奥特 | amiot
阿德尼 | 埃德尼 | adney
莫利瑙尔 | 莫勒瑙尔 | mollenauer
芬维西 | 芬韦西 | fenvessy
帕奇 | 帕克 | pach
贝尔基 | 贝尔克 | behlke
萨森 | 萨瑟恩 | southern
佩皮厄特 | 佩皮奥特 | pepiot
巴查尔 | 巴卡尔 | bachar
奥尔博 | 阿尔博 | allbaugh
加米特 | 加梅特 | gamet
德利乔吉斯 | 德利乔治斯 | deligiorgis
加雷尔 | 加勒尔 | garel
奥尔 | 奥利 | ole
巴德威恩 | 布德温 | budwine
迪奥 | 戴奥 | dio
布勒尔奇 | 布勒尔施 | broelsch
莱维 | 利维 | levie
格龙基 | 格朗茨基 | groncki
米德尔斯基 | 米德拉斯基 | midlarsky
沃米利 | 沃姆利 | wormeley
戴姆里奇 | 德姆里克 | daemmrich
肖尔德勒 | 斯科德勒 | scholderer
迪比 | 达比 | duby
贝尔比 | 比尔比 | beilby
纳尼梅克 | 努尼梅克 | nunemaker
阿尼斯 | 安妮斯 | anis
阿布林 | 埃布林 | ablin
班德 | 班德尔 | bander
罗萨尔 | 罗塞尔 | rossall
谢德 | 沙德 | shad
埃奇逊 | 艾奇逊 | etcheson
福塞特 | 福西特 | fawssett
奥莱夫 | 奥拉夫 | olave
阿加斯 | 阿加丝 | agase
阿蒂耶 | 阿提耶 | atiyeh
伦芬特 | 朗方 | lenfant
尤夫罗因 | 尤弗罗西尼 | euphrosyne
杰雷迈亚 | 杰里迈亚 | jeremiah
里奥赫 | 里奥克 | reoch
卡尔卡诺 | 卡尔卡尼奥 | calcagno
彼得里兹 | 佩特里迪斯 | petrides
科德尔 | 科德 | corder
戴文 | 达文 | davern
罗莎娜 | 罗珊 | rozanne
格林豪 | 格里诺 | greenhow
杜伊 | 杜韦 | duwe
布雷德 | 布里德 | breder
埃克斯特拉特 | 埃克斯特拉克特 | ekstract
麦加恩 | 麦加亨 | mcgahern
利本 | 莱班 | leban
穆拉尔特 | 缪拉尔持 | muralt
萨洛梅 | 萨洛米 | salome
利克曼 | 莱克曼 | likeman
玛丽萨 | 马里萨 | marisa
克里什 | 克鲁伊什 | kerruish
梅德瓦多斯基 | 梅德瓦多夫斯基 | medwadowski
希厄特 | 海厄特 | hieatt
惠奇利夫 | 惠特克利夫 | whitchliffe
怀森 | 威森 | wison
德谢尔特 | 德克特 | dechert
德夫尼 | 迪夫尼 | deveney
海姆思 | 海姆塞特 | heimsoth
塔利亚费罗 | 托利弗 | taliaferro
威廉德 | 威尔海德 | wilhide
埃博罗尔 | 埃博拉尔 | eborall
莱塞特 | 莱西特 | lycett
莱根 | 利根 | lygon
奥莱克肖 | 奥莱克休 | oleksiw
阿莱兹 | 阿莱 | allez
卡德瓦拉迪 | 卡德瓦拉德 | cadwaladyr
里达尔 | 里迪尔 | rideal
萨尔温 | 西尔温 | sulwen
法迪安 | 法迪恩 | fadyean
伯克隆 | 伯克伦 | berklund
德雷南 | 德雷宁 | drennen
德彻 | 德谢尔 | decher
特鲁齐 | 特拉齐 | truzzi
阿布迪安 | 阿布迪恩 | abdian
斯科尼耶斯 | 斯科尼尔斯 | sconyers
托里 | 托丽 | tori
卡里洛 | 卡里略 | carrillo
比比 | 毕比 | beeby
马西纳 | 马塞纳 | marthena
卡莉 | 卡利 | cali
