Huber	休伯
LaPadis	拉帕迪斯
Gonia	戈尼亚
Breckinridge	布雷肯里奇
Grafton	格拉夫顿
Elsdale	埃尔斯代尔
Melbye	梅尔比
Cedd	切德
Ingleby	英格尔比
Labaree	拉巴里
Haagensen	哈根森
Scouller	斯库勒
Coyle	科伊尔
Deholl	德霍尔
Garment	加门特
Lahr	拉尔
Maly	马利
Arciniega	阿西涅加
Farlane	法兰
Hansell	汉塞尔
Houpt	豪普特
Wollstadt	沃尔施塔特
Seaghan	西根
Strathearn	斯特拉森
Peipert	佩珀特
Pinay	皮奈
Meresman	米尔斯曼
Zampano	赞帕诺
Brang	布朗
Franzon	弗兰曾
Izbicky	伊兹比茨基
Vasal	瓦萨尔
Maddry	马德里
Echaveste	埃沙韦斯特
Margolyes	马戈利斯
Fairbairn	费尔贝恩
Muirhead	缪尔黑德
Shoupp	肖普
MacDowell	麦克道尔
Puhan	普汉
Maunsbach	蒙斯巴克
Wassell	瓦塞尔
Perryman	佩里曼
McCargar	麦卡格
Polymer	波利默
Grow	格罗
Seargent	萨金特
Heimbach	亨巴赫
Ferranti	费兰蒂
Hardon	哈登
Kuebler	库布勒
Nardi	纳迪
Lotton	洛顿
Carter	卡特
Kugeler	库格勒
Jemima	杰迈玛
Barnhart	巴恩哈特
Hie	希
Mauduit	莫德维
Whitacre	惠特克
Eyet	艾厄特
Yeardley	亚德利
Groebli	格罗布利
MacCammon	麦卡蒙
Hinchcliffe	欣奇克利夫
Dassori	达索里
Wolfson	沃尔夫森
Larkin	拉金
McCook	麦库克
Staff	斯塔夫
Ascoli	阿斯科利
Wimble	温布尔
Bobbie	鲍比
Harberen	哈布伦
Dupes	杜普斯
Celler	塞勒
MacIlvenna	麦基尔温纳
Wieser	威泽
Raggio	拉乔
Kammen	卡门
Agee	阿吉
Zuk	朱克
Rines	赖恩斯
Carragher	卡拉格
McPherren	麦克弗伦
Edelhoch	埃德尔霍克
Romine	罗明
Tirozzi	蒂罗齐
Botsal	博索尔
Coleraine	科尔雷因
Cockrum	科克勒姆
Gilbertson	吉尔伯森
Wagne	韦恩
Reignald	赖格纳德
Whitby	惠特比
Ditmas	迪特马斯
Deutermann	多伊特曼
Upton	厄普顿
Schwetz	施韦茨
Tingey	廷吉
Mish	米什
Reece	里斯
Sampson	桑普森
Erdman	厄尔德曼
Attebery	阿特伯里
Golembiewski	戈伦别夫斯基
Brorein	布罗林
Boak	博克
Ciardi	恰尔迪
Resta	雷斯塔
Gregoire	格雷瓜尔
Micajah	迈凯亚
Frasch	弗拉施
Funke	芬克
Cantril	坎特里尔
Riecken	里肯
Sorg	索格
Laidlaw	莱德劳
Komesaroff	科梅萨罗夫
Raewyn	雷温
Raemakers	拉马克斯
MacCormac	麦科马克
Beilenson	贝伦森
Piccaver	皮卡弗
Subrin	萨布林
McCurdy	麦柯迪
Fortunado	福图纳多
Rupard	鲁帕德
Read	里德
Scrutton	斯克鲁顿
Gilstad	吉尔斯塔德
Brigden	布里格登
Hazlitt	黑兹利特
Tandler	坦德勒
Fairburn	费尔伯恩
Zinnen	津宁
Faden	法登
Bourgaize	布尔盖兹
Jolland	乔兰
Daisey	戴西
Colnaghi	科尔纳吉
Pelletier	佩尔蒂埃
Brophy	布罗菲
Raynesford	雷恩斯福德
Troit	特罗伊特
Parcel	帕斯尔
King	金
Alderman	奥尔德曼
Honori	霍诺丽
Imesch	伊梅施
Eltonhead	埃尔顿黑德
Arvidson	阿维森
Comben	康本
Kipping	基平
Witworth	威特沃思
Symington	赛明顿
Weiland	韦兰
Lygo	莱戈
Throop	思鲁普
Wolfrom	沃尔弗罗姆
Bronheim	布朗海姆
Caliban	卡利班
Mahault	玛奥
Venal	维纳尔
Sitting	西廷
Fike	菲克
Audus	奥杜斯
Baylord	贝洛德
Gabbour	加伯
Holland	霍兰
Rozas	罗扎斯
Cioffi	乔菲
Doby	多比
Gansfort	甘斯福特
Woytych	沃伊蒂奇
Groner	格罗纳
Wachtel	瓦赫特尔
Valee	瓦利
Munnoch	芒诺克
Forschler	福施勒
Tagliaferro	塔利亚费罗
Shugg	沙格
Maccalmont	麦卡尔蒙特
Shivell	希维尔
Makinen	马基嫩
Carman	卡曼
Rosewater	罗斯沃特
O'Connell	奥康奈尔
Lachaise	拉雪兹
Daron	达龙
Godson	戈德森
McConaughy	麦康瑙希
Gehrkens	格尔肯斯
D'Avigdor	达维多尔
Fournie	福尼
Carlsberg	卡尔斯伯格
Galef	加利夫
Metts	梅茨
Magi	马吉
Clee	克利
Darwen	达温
Hubbard	哈伯德
Casgrain	卡斯格兰
Wikner	威克纳
Mullowney	马洛尼
Godel	戈德尔
Mannaway	马纳韦
Meighen	米恩
Killea	基利亚
Boernstein	伯恩斯坦
Verdisco	弗迪斯科
Hemsing	赫姆辛
Gagliano	加利亚诺
Turbayne	特贝恩
Debley	德布利
Izod	伊佐德
Teuma	托伊马
Ough	奥
Spahr	斯帕尔
Gieger	吉格
Affourtit	阿富尔蒂特
Misael	米赛尔
Hemmerich	亨默里克
Heawood	希伍德
Eddleman	埃德尔曼
Jenyns	杰宁斯
Friedhoff	弗里德霍夫
Buckholts	巴克霍尔茨
Stames	斯泰姆斯
Menhall	门霍尔
Bohac	博哈克
Barksdale	巴克斯代尔
Glimm	格利姆
Savill	萨维尔
Kennerney	肯纳尼
Baranik	巴拉尼克
Savannah	萨万娜
Ravenswarth	雷文斯沃思
Tarrance	塔兰斯
Chenoweth	切诺韦思
Ring	林
Punshon	庞申
Venn	维恩
Anvaripour	安瓦里普尔
Liburn	利伯恩
Timbie	廷比
Marbeck	马贝克
Donaty	多纳蒂
Adaskin	阿达斯金
Cunniffe	坎尼夫
Beebe	毕比
Keisler	基斯勒
Bulmer	布尔默
Caldell	考德尔
Oughton	奥顿
Borchardt	博哈特
Gulino	古利诺
Carmine	卡迈恩
Brantly	布兰特利
Bartram	巴特拉姆
Peile	皮尔
Typermass	泰珀马斯
Mccon	麦肯
Schuckburgh	舒克伯勒
Tambakis	坦巴基斯
McCarey	麦凯里
Lyndon	林登
Broecker	布勒克
Crayon	克雷恩
Amelio	阿梅利奥
Carkner	卡克纳
Ruble	鲁布尔
Fidandis	菲丹迪斯
Gollobin	戈洛宾
Gillispie	吉利斯皮
Herriot	赫里奥特
Calio	卡利奥
Mohler	莫勒
Infant	因方特
Galpern	加尔珀恩
Brodl	布罗德尔
Drewes	德鲁斯
Karrh	卡尔
Gerall	杰拉尔
Hennekens	亨尼肯斯
Giaever	贾埃弗
Kerrey	克里
Jamie	杰米
Tedder	特德
Futey	富蒂
Ballhorn	巴尔霍恩
Edelmann	埃德尔曼
Stinchfield	斯廷奇菲尔德
Bursma	伯斯马
Algoma	阿尔戈马
Hermanson	赫曼森
Sturges	斯特奇斯
Broadus	布罗德斯
Stamer	斯塔默
Moxam	莫克塞姆
Wicklow	威克洛
Pace	佩斯
Middlebush	米德尔布什
Boller	博勒
Ahlem	阿勒姆
Gayles	盖尔斯
Daw	道
Gregson	格雷格森
Wagner	瓦格纳
Ashdown	阿什当
Culme	卡尔姆
Bickham	比卡姆
Cleaver	克利弗
Shireman	沙伊尔曼
Meszoly	梅索伊
Geld	盖尔德
Rody	罗迪
Corrowr	科罗尔
Gressman	格雷斯曼
Feuchtwanger	福伊希特万格
Krieger	克里格
Elsner	埃尔斯纳
Ghugrad	古格拉德
Straiton	斯特雷顿
Essence	埃森丝
Gwathmey	格瓦思米
Barbirolli	巴尔比罗利
Symms	西姆斯
Luebbe	利比
Hazell	黑兹尔
Ashlyn	阿什琳
Audion	奥迪翁
Tip	蒂普
Stiening	斯蒂宁
McGaney	麦加尼
Cork	科克
Clernon	克勒农
Kindred	金德里德
Milliken	米利肯
Bova	博瓦
Druiff	德鲁伊夫
Nuthall	纳托尔
Zorza	佐尔扎
Fulker	富尔克
Daigh	戴伊
Forni	福尼
Meisner	迈斯纳
Bockhop	博克霍普
Blethen	布莱森
Carless	卡利斯
Etain	埃泰恩
Learoyd	利罗伊德
DelRiego	德尔列戈
Batzer	巴策尔
Eiszner	艾斯纳
Bergles	伯格尔斯
Lythcott	利思科特
Jeffry	杰弗里
Tinkon	廷康
Jessopp	杰索普
Defrates	迪弗雷特斯
Alvingham	阿尔文厄姆
Ulam	乌拉姆
Underdahl	昂德达尔
Darraugh	达罗
Drowley	德劳利
Meredith	梅雷迪思
McRary	麦克拉里
Robathan	罗巴森
Waters	沃特斯
Sellors	塞勒斯
Schadeberg	谢德伯格
Dedow	德多
Bywater	拜沃特
Mearns	默恩斯
Westin	韦斯廷
Byerrum	拜勒姆
Tiley	泰利
Macwhirter	麦克沃特
Grobe	格罗比
Gail	盖尔
Tartaglino	塔尔塔利诺
Gaulton	高尔顿
Brackney	布拉克尼
Turrill	特里尔
Kanlian	坎利安
Eastwick	伊斯特威克
Migeon	米金
D'Alexander	达历山大
Balderston	鲍尔德斯顿
Grinnell	格林内尔
Lambe	拉姆
Sneed	斯尼德
Seddik	塞迪克
Caldwell	考德威尔
Liddall	利德尔
Kallsen	卡尔森
Zemina	泽米纳
Helie	赫利
Canterbury	坎特伯雷
Progin	普罗金
Glockler	格洛克勒
Fromme	弗罗姆
Stirk	斯特克
Simco	西姆科
Tacon	泰肯
Strong	斯特朗
Kirsch	基尔希
Rollin	罗林
Faison	费森
Brenan	布雷南
Wern	沃恩
Gutermuth	古特穆思
Ferson	费尔森
Torpey	托毕
Deese	迪斯
Marjolin	马乔林
Courim	库里姆
Lodowicke	洛多威克
Melanie	梅拉妮
Teichmann	泰克曼
Prudhomme	普鲁多姆
Clingman	克林曼
Scherr	谢尔
Kistnasamy	基斯特纳萨米
Zeug	佐格
Cumbey	坎贝
Hermle	赫姆利
Okyle	奥基尔
Artie	阿蒂
Fromanteel	弗罗曼蒂尔
Thomasson	托马森
Mongon	蒙贡
Tytell	泰特尔
Mussehl	马塞尔
Hempel	亨普尔
Ayrault	艾罗尔特
Rytina	赖蒂纳
Frazer	弗雷泽
Rea	雷
Fugate	富盖特
Mercorella	默科雷拉
Cooling	库林
Blain	布莱恩
Breidenthal	布赖登塔尔
Ecky	埃基
Carlander	卡兰德
Rollinger	罗林杰
Deluigi	德路易吉
Cocheres	科克里斯
McAdoo	麦卡杜
Hesser	赫瑟
Darracott	达拉科特
MacFee	麦克菲
Bamfield	班菲尔德
Marcks	马克斯
Horsburgh	霍斯伯勒
Ritch	里奇
Belth	贝尔思
Ruadh	鲁阿兹
Klaber	克莱伯
Sonde	桑德
Lackersteen	拉克斯廷
Greathead	格雷特黑德
McAveety	麦卡维蒂
Baskette	巴斯克特
Maltby	莫尔特比
Langworthy	兰沃西
Ethelreda	埃塞丽达
Alpin	阿尔平
Merchiston	默奇斯顿
Finkelstein	芬克尔斯坦
Giuliani	朱利亚尼
Hurford	赫福德
Rubra	鲁布拉
Batewell	贝特韦尔
Bowman	鲍曼
Mouland	穆兰
Barans	巴兰斯
Coil	科伊尔
Dienna	迪恩纳
Boreel	博雷尔
Mowrey	莫里
Chesterman	切斯特曼
Brehon	布里恩
Clemens	克莱门斯
Sillers	西勒斯
Guire	圭尔
Yurchuck	尤尔丘克
Tennican	滕尼肯
Copestick	科普斯蒂克
McIntire	麦金太尔
Rorey	罗里
Deering	迪林
Garrette	加雷特
Lonnie	朗尼
Kendra	肯德拉
Levene	莱文
Krutter	克鲁特
Lafitte	拉菲特
Clares	克拉雷斯
Dzurinko	祖林科
Vaton	瓦顿
Linlithgow	林利思戈
Beaver	比弗
Cieplinski	西普林斯基
Sojourner	索杰纳
Pier	皮尔
Woodside	伍德赛德
Bruchhausen	布鲁克豪森
Knubel	努贝尔
Carnochan	卡诺坎
Giheno	吉赫诺
Stam	斯塔姆
Weist	韦斯特
Joicey	乔伊西
Roxinne	罗克西娜
Plimmer	普利默
Rensselaer	伦塞勒
Sagnip	萨格尼普
Edens	埃登斯
Jameson	詹姆森
Gunilla	古尼拉
Beharriell	贝哈里尔
Longchamp	朗香
Bednarski	贝德纳尔斯基
Cutrufello	卡特鲁费洛
Schulkind	舒尔坎德
Burrard	伯拉德
Hellawell	赫拉韦尔
Murakami	穆拉卡米
Byerly	拜尔利
Mirabelli	米拉贝利
Vivas	维瓦斯
Peche	佩什
Willhite	威尔海特
Combie	康比
Lykins	莱金斯
Wurdemann	沃德曼
Holbrook	霍尔布鲁克
Lorenz	洛伦茨
Looft	卢夫特
Launius	劳尼厄斯
Bean	比恩
Reamon	里蒙
Twisleton	特威斯尔顿
Tepoel	蒂普尔
Pucknell	帕克内尔
Swantak	斯旺塔克
Giaimo	贾伊莫
Mucklow	马克洛
Hains	海恩斯
Kuljian	库尔金
Abingdon	阿宾登
Essoyan	埃索扬
Crookshank	克鲁克香克
Gressak	格雷萨克
Griffey	格里菲
Guillet	吉利特
Hamilyon	哈米里恩
Mangle	曼格尔
Leanne	利安娜
Genge	金奇
Graber	格雷伯
Frankum	弗兰克姆
Ewry	尤里
Breibart	布赖巴特
Kilcoursie	基尔科西
Turbett	特贝特
Bowler	鲍勒
Gureck	古雷克
Newbranch	纽布兰奇
Mateer	马蒂尔
Reasonover	里曾诺弗
Merivale	梅里韦尔
Chacon	查康
Callis	卡利斯
Mcduffey	麦克达菲
McCordock	麦科多克
Rebsamen	里布萨门
Hornyold	霍尼奥尔德
Crawhall	克劳霍尔
Torphichen	托菲肯
Blickensderfer	布利肯斯德弗
Sculpt	斯卡尔普特
Flanders	弗兰德斯
Dittenhafer	迪滕哈弗
Cormie	科米
Halkett	霍尔基特
Connard	康纳德
Cozens	科曾斯
Harrup	哈勒普
Meggison	梅吉森
Wagstaffe	瓦格斯塔夫
Goethals	戈瑟尔斯
Ferris	费里斯
Ballentine	巴伦坦
Schenkel	申克尔
Hatem	哈特姆
Horrax	霍拉克斯
McMicking	麦克米金
Gualtieri	瓜尔蒂耶里
Edginton	埃金顿
Cosmas	科斯马斯
Secker	塞克
Cowie	考伊
Zeran	齐伦
Biebel	比布尔
Betten	贝滕
Wofsy	沃夫西
Oldstyle	奥尔德斯泰尔
Siemens	西门子
Tepsic	特普西克
Garlington	加林顿
Gent	金特
Plybon	普利邦
Payeff	帕耶夫
Digby	迪格比
Swensrud	斯温斯拉德
Scahill	斯卡希尔
Beichner	比克纳
Ison	艾森
Engholm	恩格霍姆
Sydenham	西德纳姆
Whytlaw	怀特洛
Schotte	肖特
Dewas	德瓦斯
Jacqueline	杰奎琳
Greene	格林
Ranneberger	兰恩伯格
MacAusland	麦考斯兰
Mestel	梅斯特尔
Sandwick	桑威克
Wyeth	韦思
Schweichild	施韦柴尔德
Lindberg	林德伯格
Sappenfield	萨彭菲尔德
Aloys	阿洛伊斯
Stanhope	斯坦诺普
Ingvoldstad	英沃斯塔德
Westwater	韦斯特沃特
Senghor	桑戈尔
Brighouse	布里格豪斯
Jismond	吉斯蒙德
Stewart	斯图尔特
Riches	里奇斯
Lamble	兰布尔
Krumbhaar	克伦巴尔
Boshoff	博肖夫
Fieldgate	菲尔德盖特
MacNab	麦克纳布
Cauldren	考尔德伦
Filmer	菲尔默
Spenser	斯潘塞
Maechler	梅克勒
Biber	比伯
Heasley	希斯利
Morar	莫勒
Kadleigh	卡德利
Walske	沃尔斯克
Anglemire	安格尔迈尔
Glenarthur	格莱纳瑟
Louisy	路易西
Friley	弗赖利
O'Neal	奥尼尔
Rylance	赖伦斯
Gildersleeve	吉尔德斯利夫
Fauriol	福里奥尔
Heslep	赫斯利普
Rhodes	罗兹
Gaudry	高德里
Carlowe	卡洛
Boutall	鲍塔尔
Goodhue	古德休
Spayin	斯佩因
Sloyan	斯洛扬
Teem	蒂姆
Bond	邦德
Oldberg	奥尔德伯格
Beards	比尔兹
Harral	哈拉尔
Fitzroy	菲茨罗伊
Clampitt	克兰皮特
Ervin	欧文
Kessel	凯塞尔
Rapp	拉普
Hazard	哈泽德
Topp	托普
Hickling	希克林
Dameshek	达梅谢克
Mushet	马希特
Greenhead	格林黑德
Dutchess	达切斯
Muellner	米尔纳
Firkins	弗金斯
Giarrizzo	贾里佐
Brumley	布伦利
Hyer	海尔
Daves	戴夫斯
Perfect	珀费克特
Birt	伯特
Gies	吉斯
Fickinger	菲金格
Min	米恩
Slotki	斯洛特基
Figures	菲格斯
Egmont	埃格蒙特
Wetherell	韦瑟雷尔
Eggar	埃加
Tecumseh	特库姆塞
Shabazz	沙巴兹
Titman	蒂特曼
Dallain	达兰
Bono	博诺
Evangelista	埃万杰利斯塔
Webley	韦伯利
Iacobellis	亚科贝利斯
Kluger	克卢格
Vinton	文顿
Fahs	法斯
Parmentier	帕尔芒捷
Deangelis	迪安杰利斯
Theakstone	西克斯通
Hanlan	汉兰
Fairhust	费尔赫斯特
Bartell	巴特尔
Greenawalt	格里纳沃尔特
Macglasrich	麦格拉斯里克
Owsley	奥斯利
Mileski	米莱斯基
Thornton	桑顿
Marven	马文
Gasta	加斯塔
Baab	巴布
Blinn	布林
Worrilow	沃里洛
Spens	斯彭斯
Balloch	巴洛赫
McQueen	麦奎因
Chernesky	切尔涅斯基
Al	阿尔
Kron	克朗
Bellevue	贝尔维
Seaborn	西伯恩
Keyshawn	基肖恩
Whitbeck	惠特贝克
Riseberg	赖斯伯格
Delchamps	德尔尚
Berke	伯克
Kazen	卡曾
Braun	布朗
Aust	奥斯特
Washburne	沃什伯恩
Measham	米沙姆
Rudderham	拉德勒姆
Landen	兰登
Hrechanyk	赫雷查尼克
Balassa	巴拉萨
Menifee	梅尼菲
Scotti	斯科蒂
Hauf	豪夫
Magman	马格曼
Treleaven	特里莱文
Avent	埃文特
Grossmith	格罗史密斯
Basler	巴斯勒
Chetkovich	切特科维奇
Shovelton	肖维尔顿
Shilts	希尔茨
Dimick	迪米克
Foxworthy	福克斯沃西
Cornett	科尼特
Grendler	格伦德勒
Buesnel	比尤内尔
Bettis	贝蒂斯
Adye	埃迪
McCasland	麦卡斯兰
Wyckoff	威科夫
Annzella	安泽拉
Hagemeyer	哈格迈尔
Gauvin	高文
Katia	凯蒂娅
Heer	希尔
Allamong	阿拉芒
Blatz	布拉茨
Mcbroom	麦克布鲁姆
Amand	阿曼德
Poter	波特
Verkaik	弗凯克
Rainwater	雷恩沃特
Mengert	门格特
Siemien	西明
Hirshman	赫什曼
Kilfedder	基尔费德
Dran	德兰
Berndt	伯恩特
Rowand	罗安德
Blizzard	布利泽德
Osric	奥斯里克
Prial	普赖尔
Armand	阿曼德
Blisac	布利萨茨
Browett	布劳伊特
Sallot	萨洛特
Maness	马内斯
Abboud	阿布德
Bidez	比德兹
Rhame	雷姆
Coombs	库姆斯
Irwil	厄维尔
Wilmett	薇尔梅特
Heiser	海泽
Krassel	克拉塞尔
Kentwell	肯特韦尔
Atterholt	阿特霍尔特
Beale	比尔
Neddy	内迪
Muster	马斯特
McKeith	麦基思
Homet	霍梅特
Canetti	卡内蒂
Berzak	伯扎克
McGushin	麦古欣
Gorden	戈登
Latourette	拉图雷特
Spears	斯皮尔斯
Poynter	波因特
Denman	登曼
Naranjo	纳兰霍
Breland	布里兰
Armanazi	阿马纳齐
Macartair	麦卡泰尔
Auchindachie	奥金达基
Allaire	阿莱尔
Kanet	卡内特
Karle	卡利
Klufeld	克卢菲尔德
Works	沃克斯
Hinman	欣曼
Halderman	霍尔德曼
Vear	维尔
Roelker	罗尔克
Hardill	哈迪尔
Adelina	阿德利娜
Stelter	斯泰尔特
Meanwell	米恩韦尔
Bushrod	布什罗德
Grotterod	格罗特罗德
Shuckburgh	沙克伯勒
Deevers	迪弗斯
Hanway	汉韦
Broom	布鲁姆
Redd	雷德
Harahan	哈拉汉
Trefusis	特里富西斯
Alexanderson	亚历山德森
Cockran	科克兰
Paus	波斯
Guare	瓜尔
Daligan	达利根
Jupiter	丘辟特
MacNicol	麦克尼科尔
Petersen	彼得森
Conland	康兰
Leuver	勒弗
Hallsworth	霍尔斯沃思
Glitch	格利奇
Brott	布罗特
Deutrich	多伊特里希
Towery	托尔里
Madlin	马德琳
Wischer	维舍
Kalil	卡利尔
Shontz	肖恩茨
Collmer	科尔默
Furlaud	弗劳德
Greenbie	格林比
Dygard	迪格
Broadwin	布罗德温
Cadwell	卡德韦尔
Woreester	沃里斯特
Balich	巴利奇
Kimelman	基梅尔曼
Cubitt	丘比特
Allitt	阿利特
Foldessy	福尔德西
Secrest	西克里斯特
Spanner	斯潘纳
Tuteur	图特
Sisario	西萨里奥
Coors	库尔斯
Comarmond	科马蒙德
Lazar	拉扎尔
Scadding	斯卡丁
Tyriq	泰里克
Fremlin	弗雷姆林
Klinghoffer	克林霍弗
Macgoun	麦古恩
Petes	皮特斯
Pearkes	皮尔克斯
Worst	沃斯特
Peirens	佩伦斯
Theen	西恩
Ryde	赖德
Fairhaven	费尔黑文
Countryman	康特里曼
Zaslove	扎斯洛夫
Thornburgh	索恩伯勒
Tredegar	特里迪加
Dunmore	邓莫尔
Pelot	佩洛特
Acer	阿瑟
Alli	阿利
Pennypacker	彭尼帕克
Rowley	罗利
Attygalle	阿蒂格尔
Caplin	卡普林
Montgomerie	蒙哥马利
Lisney	利斯尼
Mathea	玛西娅
Kaim	凯姆
McGrath	麦格拉思
Bonham	博纳姆
Fabler	法布勒
Berkin	伯金
Gleed	格利德
Petruska	彼特鲁斯卡
Verne	维恩
Murck	默克
Scharlieb	沙利布
Iudicello	尤迪塞洛
Blandford	布兰福德
Waim	瓦伊姆
Herrn	赫恩
Ruellan	鲁伦
Lachter	拉克特
Rahab	雷哈布
MacInerney	麦基纳尼
Egan	伊根
Wreatham	里瑟姆
Schloss	施洛斯
Stigler	施蒂格勒
Twining	特文宁
Zetterling	泽特林
Ulph	厄尔夫
Sidarouss	西达劳斯
McIlwain	麦基尔韦恩
Flowerdew	弗劳尔迪
Gellan	格兰
Leighton	莱顿
Type	泰普
Jimenez	希门尼斯
Pullar	普拉
Agrest	阿格雷斯特
Wilshin	威尔欣
Bleha	布莱哈
Slick	斯利克
Woellner	沃尔纳
Dewint	德温特
Corpazzi	科帕齐
Critchell	克里切尔
Walts	沃尔茨
Letter	莱特
Sweatman	斯韦特曼
Lakey	莱基
Sutlieff	萨特利夫
Vanfossan	范福森
Gerst	格斯特
Ellick	埃利克
Schick	希克
Garmezy	加梅齐
Bradlaugh	布拉德洛
Kniskern	尼斯肯
Bruyn	布勒因
Walstrom	沃尔斯特龙
Tamihere	塔米希尔
Courau	库罗
Silcock	西尔科克
Dimeo	迪梅奥
Megargel	梅加格尔
Mittino	米蒂诺
Benedicus	贝内迪克斯
Bianco	比安科
Lafleche	拉弗莱什
Macgreuther	麦格鲁瑟
Mesirov	梅西罗夫
Solyman	索利曼
Curtenius	柯特纽斯
Curthoys	柯托伊斯
Asquith	阿斯奎思
Tyndall	廷德尔
Aadahi	阿达希
Easterbrooke	伊斯特布鲁克
Helina	赫莉娜
Putzel	普策尔
Itteilag	伊泰拉格
Albosta	阿尔博斯塔
Stronge	斯特朗
Shrieves	施里夫斯
Evoy	伊沃伊
Bossing	博辛
Cherne	彻恩
Cross	克罗斯
Dyhrenfurth	迪伦弗思
Trend	特伦德
Trussel	特拉塞尔
MacEnulty	麦克纳尔蒂
Garrigus	加里格斯
Tanguay	坦圭
Benkert	本克特
Selmon	塞尔蒙
Brinig	布里尼格
Schulten	舒尔滕
Matkin	马特金
Rusbridger	拉斯布里杰
Pook	普克
Morani	莫拉尼
Wathes	沃西斯
McLafferty	麦克拉弗蒂
Selim	塞利姆
Muehleisen	米莱森
Dubras	杜布拉
Rozier	罗齐尔
Alwyne	阿尔文
Yazmin	亚斯明
Crasner	克拉斯纳
Lauderdale	劳德戴尔
Aldwin	阿尔德温
Russum	拉萨姆
Charren	查伦
Burbage	伯比奇
Multon	马尔顿
Ebeling	埃贝林
Dangan	丹根
Silverstone	西尔弗斯通
Batdorf	巴特多夫
Peirse	皮尔斯
Haslup	哈斯勒普
Zaehner	策纳
Collnette	科尔内特
Chistolini	奇斯托利尼
Poulos	普洛斯
Brewitt	布鲁伊特
Lewando	柳安多
Challenor	查利诺
Greenlee	格林利
Cyriax	西里亚克斯
Telly	特利
Baume	鲍姆
Dosland	多斯兰
Henderson	亨德森
Clyne	克莱因
Goggin	戈金
Macvarnish	麦克瓦尼什
Hue	休
Vedeler	维德勒
Hulings	赫林斯
Berrey	贝里
Stille	斯蒂尔
Tims	蒂姆斯
Schneiter	施奈特
Meldrim	梅尔德里姆
Kinkaid	金凯德
Fritzen	弗里曾
Deekes	迪克斯
Guertin	格廷
Tepaika	特佩卡
McMichael	麦克迈克尔
Browkaw	布劳考
Crispian	克里斯皮安
Binaggio	比纳乔
Bailhe	贝尔赫
Scowcroft	斯考克罗夫特
Gensert	金瑟特
Pattillo	帕蒂略
Mackal	麦考尔
Allemang	阿利芒
Saich	赛什
Warnke	沃恩克
Piotrowski	彼得罗夫斯基
McElhaney	麦克尔哈尼
Jahn	扬
Congalton	康高尔顿
Marxer	马克瑟
Ulmer	厄尔默
Borthwick	博思威克
Whittredge	惠特里奇
Duax	杜阿克斯
Stears	斯蒂尔斯
Deisenhofer	戴森霍弗
Dubrin	杜布林
Coffrin	科弗林
Schattenkerk	沙滕柯克
Gaertner	盖特纳
Jannik	詹尼克
Doi	多伊
Kuldell	库尔德尔
Greenhut	格林赫特
Falloon	法伦
Seeligson	西利格森
Tremayne	特里梅因
Clyburn	克莱伯恩
Oswiu	奥斯威尤
Leet	利特
Landwirthy	兰德沃西
Krentz	克伦茨
Venner	文纳
Brockmeier	布罗克迈耶
Formanek	福马内克
Baggs	巴格斯
Morrice	莫里斯
Southee	索西
Millon	米伦
Thurtle	瑟特尔
Eily	艾莉
Ekern	伊肯
Wakeling	韦克林
Abramowitz	阿布拉莫维茨
Filion	菲利翁
Spink	斯平克
Zampiello	赞皮耶洛
Zelazny	泽拉兹尼
Leapman	利普曼
Shooshan	舒尚
Moppes	莫皮斯
Fitzimons	菲齐蒙斯
Alevey	阿利维
Greenspun	格林斯庞
Parcell	帕斯尔
Tybalt	蒂博尔特
Soul	苏尔
Dreves	德雷夫斯
Lure	卢尔
Butt	巴特
Udona	尤多纳
Dimmock	迪莫克
Mennen	门嫩
DeDeo	戴德奥
Theda	西达
Battershell	巴特谢尔
Galindo	加林多
MacKereth	麦克勒思
Bullough	布洛
Bonyhadi	博尼哈迪
Heren	赫伦
Orser	奥泽
Papley	帕普利
Shovell	肖维尔
Papermaster	佩珀马斯特
Bomgardner	博姆加德纳
Berendes	贝伦兹
Scarlet	斯卡利特
Doubleday	道布尔迪
Erazim	伊拉齐姆
Schrade	施拉德
Appleman	阿普尔曼
Chiste	奇斯特
Angel	安杰尔
Corten	科滕
Bassham	巴沙姆
Coffield	科菲尔德
Amies	埃米斯
Birck	比尔克
Grout	格劳特
Dizzy	迪齐
Spungin	斯庞金
Caulkins	考尔金斯
Peaslee	皮斯利
Bartholdson	巴托尔松
Alliott	阿利奥特
Lant	兰特
Macsporran	麦克斯波伦
Dozier	多齐尔
Yingling	英林
Weiss	韦斯
Jeffrey	杰弗里
Cuprill	卡普里尔
Riddick	里迪克
Porteus	波蒂厄斯
Ruttledge	拉特利奇
Heeg	希格
Shulz	舒尔茨
Chanutin	查纽廷
Esek	伊塞克
Worthington	沃辛顿
Blades	布莱兹
Maierhofer	迈尔霍费尔
Angarola	安加罗拉
Fusaro	富萨罗
Ailsa	艾尔萨
MacFie	麦克菲
Derploog	德普卢格
Donlavey	唐拉维
Klopman	克洛普曼
Heising	海辛
Freiheit	弗赖海特
Malempre	马伦普雷
Fillman	菲尔曼
Sapsworth	萨普斯沃思
Fuelling	菲林
Strahl	斯特拉尔
Slack	斯莱克
Posen	波森
Doetsch	德奇
Arreton	阿里顿
Morfee	莫菲
Topol	托波尔
Beha	贝亚
Firebrance	法尔布兰斯
Estes	埃斯蒂斯
Hixson	希克森
Annenberg	安嫩伯格
Fullom	富勒姆
Eyers	艾尔斯
Cenni	森尼
Willert	威勒特
Bordeaux	波尔多
Desiderius	德西迪里厄斯
Malenbaum	马伦鲍姆
Ginnes	金尼斯
Thalgott	索尔戈特
Northmore	诺思莫尔
Eustis	尤斯蒂斯
Zalta	扎尔塔
Curt	柯特
Breaks	布雷克斯
Cherkezian	彻克齐安
Schoenbach	舍恩巴赫
Magnier	马尼耶
Sokoloff	索科洛夫
Altrincham	奥特林厄姆
Naparstek	纳帕斯特克
Aernum	埃努姆
Farnaby	法纳比
Gollub	戈勒布
Fehnel	费内尔
Airington	艾林顿
Lavan	拉文
Macilrevie	麦基雷维
Dyal	戴尔
Merttins	默廷斯
Eichengreen	艾肯格林
Poxon	波克森
Geiman	盖曼
Leffler	莱弗勒
Tally	塔利
Corkum	科克姆
Nutson	纳特森
Garaufis	加劳菲斯
Raven	雷文
Zigrosser	齐格罗瑟
Havenner	哈文纳
Doelz	德尔兹
Gwychardus	格威查德斯
Avids	阿维兹
Herspring	赫斯普林
Mobsby	莫布兹比
Bonz	邦兹
Nundy	农迪
Binkert	宾克特
Cyres	西尔斯
Loomer	卢默
Seegal	西格尔
Tave	塔夫
Maffey	马菲
Gutman	古特曼
Norstad	诺斯塔德
Cipollone	西波隆
Cullen	卡伦
Wolkie	沃尔基
Aquayo	阿夸约
Merbecke	默贝克
Straus	斯特劳斯
Garrenton	加伦顿
Issari	伊萨里
Balls	鲍尔斯
Ledlie	莱德利
Jevons	杰文斯
Frizell	弗里泽尔
Withrow	威思罗
Sise	赛斯
Palmolive	帕尔莫利夫
Frelinghuysen	弗里林海森
Hessler	赫斯勒
Homme	霍姆
McLellan	麦克莱伦
Mccrudden	麦克拉登
Pargellis	帕盖利斯
LePoer	勒普尔
Longway	朗韦
Alstadt	阿尔斯塔特
Girdwood	格德伍德
Luckner	勒克纳
Breslawsky	布雷斯拉夫斯基
Hudd	赫德
Bonifacius	博尼费修斯
McGougan	麦高根
Daphne	达夫妮
Endrenyi	恩德雷尼
Etherington	埃瑟林顿
Rodrigo	罗德里戈
Macsimon	麦克西蒙
Vine	瓦因
Skyler	斯凯勒
Wikeley	威克利
Regalia	雷加利亚
Siems	西姆斯
Cafky	卡夫基
McClave	麦克拉夫
Gutsch	古奇
Kirland	柯兰
Stiles	斯泰尔斯
Platz	普拉茨
Wetzler	韦茨勒
Rozentals	罗森塔尔斯
Fairholme	费尔霍姆
Tanberg	坦伯格
Vansandt	范桑特
Cleskey	克莱斯基
Bundy	邦迪
Macconchy	麦康希
Freudenberger	弗罗伊登伯格
Sandham	桑达姆
Coberman	科伯曼
Prosser	普罗瑟
Lieb	利布
Borell	博雷尔
MacCarran	麦卡伦
Rimouski	里莫斯基
Spinden	斯平登
Wollaston	沃拉斯顿
Endrict	恩德里克特
Sood	苏德
Maning	曼宁
Blachut	布拉胡特
Hemming	亨明
Tirvengadum	蒂文加杜姆
Carlsmith	卡尔史密斯
Mohrman	莫尔曼
Mami	玛米
Genero	吉尼罗
Fitelson	菲特尔森
Duroni	杜罗尼
Buist	比伊斯特
Hitchings	希钦斯
Rowntree	朗特里
Laramore	拉腊莫尔
Alanson	阿兰森
Eltringham	埃尔特林厄姆
Drynan	德赖南
Faulwell	福尔韦尔
Hake	黑克
Dot	多特
Shepherd	谢泼德
Hashagen	哈舍根
Gerwick	格威克
Ryalls	赖亚尔斯
Tremain	特里曼
Merron	默龙
Tatlow	塔特洛
Vanderkleed	范德克利德
Goad	戈德
Ancrum	安克拉姆
Hunsberger	亨斯伯格
Stovall	斯托瓦尔
Thicknesse	西克尼斯
Bakey	巴基
Groucott	格劳科特
Dimakis	迪马基斯
Gibbie	吉比
Ruez	吕埃
Leeke	利克
Wiman	威曼
Ladbroke	拉德布鲁克
Luistig	卢斯蒂格
Giri	吉里
Oenslager	奥恩斯莱格
Sohn	索恩
Hargadine	哈格丁
Leikhim	利克希姆
Wirtschafter	沃特沙夫特
Imus	伊穆斯
Toch	托克
Dewenter	德温特
Peterfield	彼得菲尔德
Foti	福蒂
Gawalt	加沃尔特
Harrel	哈勒尔
Spuhler	施普勒
Behrends	贝伦兹
Sirica	西里卡
Charies	查里斯
Krehbiel	克雷比尔
Fake	费克
Marnoch	马诺克
Armani	阿尔马尼
Flebbe	弗莱比
Abbigail	阿比盖尔
Wimmer	威默
Tombs	图姆斯
Duflon	杜弗隆
Garrahy	加拉希
Meirovitch	迈罗维奇
Sherek	谢雷克
Thye	赛伊
Fetterman	费特曼
Grigsby	格里格斯比
Seznec	塞兹内克
Hana	哈娜
Mastin	马斯廷
Mospan	莫斯潘
Zepul	泽普尔
Crismanich	克里斯马尼奇
Hilings	希林斯
Benn	本
McColvin	麦科尔文
Paunack	波纳克
Melvyn	梅尔文
Asaph	阿萨夫
Pelovitz	佩洛维茨
Moiseiwitsch	莫伊塞维奇
Manopoli	马诺波利
Menaham	梅纳汉
Witty	威蒂
Millham	米勒姆
Cansler	坎斯勒
Elwaine	埃尔韦恩
Fates	费茨
Mackillican	麦基利坎
Dorrie	多丽
Diffen	迪芬
Faneuf	法纳夫
Rawle	罗尔
Torell	托雷尔
Bruccoli	布鲁科利
Robertston	罗伯茨顿
Solon	索伦
Werkmeister	沃克迈斯特
Tubia	图比亚
Radesk	拉德斯克
Culling	卡林
Jose	乔斯
Colclaser	科尔克拉泽
Roch	罗奇
Royall	罗亚尔
Baumberger	邦伯格
Olitsky	奥利茨基
Lowenkron	洛温克伦
Kelchner	凯尔克纳
Dorough	多拉夫
Fehr	费尔
Balniel	巴尼尔
Kensinger	肯辛格
Kincrid	金克里德
Tuffnell	塔夫内尔
Firing	法尔林
Klemme	克莱米
Kiddle	基德尔
Geal	吉尔
DuHart	杜哈特
Bodecker	博德克
Lorwin	洛温
Rockwell	罗克韦尔
Robbie	罗比
Zahrn	扎恩
Volk	沃尔克
Helsinger	赫尔辛格
Ferre	费雷
Bradburd	布拉德伯德
MacNamara	麦克纳马拉
Fischetti	菲谢蒂
Annabelle	安娜贝勒
Conniff	康尼夫
Boivin	博伊文
Lardner	拉德纳
Citron	西特伦
Feusi	福西
Zumberg	宗伯格
Mederos	梅德罗斯
Sagar	塞格尔
England	英格兰
Colonghi	科隆吉
Newt	纽特
Irene	艾琳
Krolis	克罗利斯
Camilletti	卡米莱蒂
Jutton	贾顿
Renk	伦克
Lyng	林
Liverseidge	利弗西奇
Tallman	托尔曼
Rabbatts	拉巴茨
Amore	阿莫尔
Cilawson	西劳森
Eidsmoe	艾兹莫
Abbe	阿贝
Boisfontaine	博伊斯方丹
McCahearty	麦克哈蒂
Worlock	沃洛克
McMunn	麦克蒙
Heidt	海特
Engelberger	恩格尔伯格
Gremlins	格雷姆林斯
Lauther	劳瑟
Aongus	安格斯
Colvig	科尔维格
Allard	阿拉德
Crossen	克罗森
Savery	萨弗里
Clanton	克兰顿
Breitenfeld	布赖滕费尔德
Duport	杜波特
Hilroy	希尔罗伊
Torrance	托兰斯
Westmoreland	威斯特摩兰
Burghard	伯格哈特
Earp	厄普
Brittigan	布里蒂根
Greville	格雷维尔
Halow	哈洛
Elst	埃尔斯特
Mondor	蒙多
Dabbs	达布斯
Foxman	福克斯曼
Brenton	布伦顿
Gelzer	盖尔泽
Ellison	埃利森
Shriner	施里纳
Murns	默恩斯
Cutlip	卡特利普
Swinfen	斯温芬
Stubblefield	斯塔布菲尔德
Canny	坎尼
Rumbold	朗博尔德
Kevitt	凯维特
Rivas	里瓦斯
Richburg	里奇伯格
Rousseau	鲁索
Verpilleux	韦皮勒
Cawley	考利
Mossbauer	莫斯鲍尔
Morby	莫比
Broekert	布勒克特
Diament	迪亚门特
Townend	汤恩德
Klose	克洛斯
Belgrave	贝尔格雷夫
Inez	伊内兹
Jepoen	杰波恩
Hammerly	哈默利
Mackeng	麦肯
Pinkstone	平克斯通
Saulter	索尔特
Fretz	弗雷茨
Birkenholtz	伯肯霍尔兹
Challis	查利斯
Niblett	尼布利特
Erricker	埃里克
Keithley	基思利
Mertes	默特斯
Luckett	勒基特
Spurr	斯珀尔
Gousha	古沙
Eader	伊德尔
Lessiter	莱西特
Ivetts	艾维茨
Forbes	福布斯
Westermore	韦斯特莫尔
Vinograd	维诺格勒
Denny	丹尼
Willette	威利特
Annaghmore	安纳克莫尔
Westerfield	韦斯特菲尔德
Studeman	斯蒂德曼
Lelean	勒林
Bridson	布赖森
Bruhn	布鲁恩
Tillinghast	蒂林哈斯特
Mischke	米施克
Zuckley	朱克利
Poebel	波贝尔
Bardwell	巴德韦尔
Wristen	里斯滕
Sum	萨姆
Dareff	达雷夫
Pearistine	皮里斯坦
Winner	温纳
Narmi	纳米
Grice	格赖斯
Raschen	拉申
Ackland	阿克兰
Crookenden	克鲁肯登
Grable	格拉布尔
Mhadavikh	马达维赫
Bumpass	邦帕斯
Golub	戈卢布
Ellett	埃利特
Lorimer	洛里默
Ilgenfritz	伊尔根弗里茨
Tindell	廷德尔
Dullach	杜拉奇
Beekman	比克曼
Ansdell	安斯德尔
Atwell	阿特韦尔
Gollob	戈洛布
Lennep	伦内普
Szold	索尔德
Dinwiddie	丁威迪
Bedell	比德尔
Engoren	恩戈伦
Dupcak	杜普恰克
Bradon	布拉顿
Proctor	普罗克特
Seibel	塞贝尔
Beyto	贝托
Tilt	蒂尔特
Orczy	奥齐
Bame	巴姆
Leisy	利西
Plymale	普莱梅尔
Bromet	布罗米特
Blamey	布莱米
Piechowiak	皮乔维亚克
Aston	阿斯顿
Woerner	沃纳
Mosler	莫斯勒
Mallier	马利尔
Lumbard	伦巴德
Cartland	卡特兰
Orescan	奥雷斯坎
Furth	弗思
Summersell	萨默塞尔
Shove	肖夫
Manza	曼扎
Quiggle	奎格尔
Pauk	波克
Stebbing	斯特宾
Emission	埃米申
Archabal	阿查巴尔
Thurloe	瑟洛
Groberg	格罗伯格
Whitburgh	惠特伯勒
Daitch	戴奇
Bullins	布林斯
Bethell	贝瑟尔
Mullen	马伦
Briccetti	布里切蒂
Gren	格伦
Sebire	塞比尔
Cottrell	科特雷尔
Pettypool	佩蒂普尔
Wayman	韦曼
Pfeiler	法伊勒
Duberman	杜伯曼
Fiechter	菲克特
Schulte	舒尔特
Hustead	赫斯特德
Homolka	霍穆尔卡
Still	斯蒂尔
Crisoogone	克丽苏贡
Trover	特罗弗
Heisborg	海斯堡
MacGoohan	麦古恩
Feldbrill	费德布里尔
Langson	兰森
Gernon	热农
Soteros	索特罗斯
Stunt	斯坦特
Fabrizio	法布里齐奥
Pendely	彭德利
Gilkey	吉尔基
Ihle	伊尔
Elyse	埃莉丝
Holliman	霍利曼
Lungley	伦利
Joly	乔利
Tysoe	泰索
Miskimins	米斯基明斯
Kroehler	克雷勒
Cheminint	切米宁特
Goose	古斯
Matas	马塔斯
Deben	德本
Alman	奥尔曼
Kryza	克里扎
Cromey	克罗米
Sender	森德
Wahlin	瓦林
Gotaas	戈塔斯
Jorris	乔里斯
Fasnacht	法斯纳克特
Adlin	阿德林
Harper	哈珀
Helmholdt	赫尔姆霍尔特
Bugan	巴根
Pechey	皮奇
Seltzer	塞尔策
Pollster	波尔斯特
MacNalty	麦克纳尔蒂
Mugford	马格福德
Mokma	莫克马
Streele	斯特里尔
Eckmann	埃克曼
Schwamb	施万布
Galand	加兰
Schiffmann	希夫曼
McLendon	麦克伦登
Kinder	金德
Jeppson	杰普森
MacMichael	麦克迈克尔
Ory	奥赖
Aelfric	阿尔弗里克
Eylgar	艾尔格
Gitterman	吉特曼
Yee	伊
Stepney	斯特普尼
Hoadley	霍德利
Mostel	莫斯特尔
Berwin	伯温
Heyningen	海宁根
Hazan	哈赞
Wellby	韦尔比
Sonnemann	索恩曼
Blystone	布莱斯通
Flessati	弗莱萨蒂
Ozanne	奥赞
Maray	马雷
Sharpless	沙普利斯
Dehaan	德哈恩
Stenseth	斯滕塞思
Raynor	雷纳
Fercival	费西瓦尔
Beckhard	贝克哈德
Sontag	桑塔格
Kaberry	卡伯里
McElhanon	麦克尔哈农
Mazan	马赞
Manio	马尼奥
Casto	卡斯托
Cartney	卡特尼
Waldegrave	沃尔德格雷夫
Tuckman	塔克曼
Arvelo	阿韦洛
Tullio	图利奥
Michaels	迈克尔斯
Sowle	索尔
Harriman	哈里曼
Gallion	加利恩
Kaylee	凯莉
Emanuel	伊曼纽尔
Harben	哈本
Lerwill	勒威尔
Barkes	巴克斯
Cruz	克鲁兹
Foisie	福伊西
Macon	梅肯
Lattin	拉廷
Groth	格罗思
Troller	特罗勒
Greenaway	格里纳韦
Lampson	兰普森
Theodora	西奥多拉
Esmond	埃斯蒙德
Delafons	德拉方斯
Murtry	默特里
Herfurt	赫弗特
Tibby	蒂比
Tropp	特罗普
Aller	阿勒
Guedry	格德里
Kristofer	克里斯托弗
Kinnis	金尼斯
Davee	达维
Gohey	戈伊
Duffin	达芬
Claver	克拉弗
Lyal	莱尔
Adare	阿代尔
McMenemey	麦克梅尼米
Carrigan	卡里根
Sansum	桑森
Giggey	吉盖
Dacombe	戴科姆
Hullin	赫林
Bontein	邦坦
Doben	多宾
Germuth	格穆思
Prinstein	普林斯坦
Arfken	阿夫肯
McEneaney	麦克尼尼
Tainsh	坦什
Crespigny	克雷皮尼
Humelsine	休梅尔辛
Blaxland	布拉克斯兰
Amoni	阿莫尼
Pigsley	皮格斯利
Wail	韦尔
Derry	德里
Maquarie	麦夸里
Buerki	伯基
Digges	迪格斯
Elliman	埃利曼
Loe	洛
Blitch	布利奇
Swadesh	斯沃德什
Nahn	纳恩
Fermoy	弗莫伊
Besecker	贝塞克
Comeau	科莫
Normanby	诺曼比
Babell	贝布尔
Damiano	达米亚诺
Fierce	菲尔斯
Clarida	克拉里达
Bordwine	博德瓦恩
Brountas	布龙塔斯
Crosman	克罗斯曼
Inman	英曼
Herriford	赫里福德
Mayerson	迈耶森
McCombe	麦库姆
Deloria	德洛里亚
Cordrey	科德里
Drevorguilla	德沃尔吉拉
Soth	索思
Easteal	伊斯蒂尔
Sande	桑德
Ayton	艾顿
Kirtland	柯特兰
Cranwill	克兰威尔
Maccansh	麦坎什
O'Flahertie	奥弗莱厄蒂
Sevey	西维
Mitty	米蒂
Bouwer	鲍尔
Crahan	克拉汉
Boker	博克
Baimbridge	班布里奇
McEnroe	麦肯罗
Scent	森特
Greagen	格里根
Morissy	莫里西
Borah	博拉
McKirahan	麦基拉汉
Eshoo	埃舒
Yandle	扬德尔
Deibel	戴贝尔
Marcinkus	马辛克斯
Perez	佩雷斯
Eller	埃勒
Vizor	维佐尔
Setaro	塞塔罗
Castrey	卡斯特里
Tillie	蒂莉
Riger	里格
Dowd	多德
Wieseman	威斯曼
Hamber	汉伯
Alyson	艾莉森
Varian	瓦里安
Turley	特利
Gillicudy	吉利卡迪
Doak	多克
Footler	富特勒
Harg	哈格
Dropsie	德罗普西
Tromley	特罗姆利
Dressel	德雷斯尔
Julie	朱莉
Herty	赫蒂
Fingerhut	芬格赫特
Edgley	埃奇利
Danyon	达尼恩
Shirk	舍克
Mosely	莫斯利
Herlie	赫利
Willford	威尔福德
Ananian	阿纳尼安
Menzer	门泽
Lapwood	拉普伍德
Collens	科伦斯
Mahuran	马胡兰
Krebs	克雷布斯
Vayne	韦恩
Peyer	派尔
Eckstein	埃克斯坦
Poulain	普兰
Dogin	多金
Collado	科拉多
Czeh	切赫
Silvanus	西尔维纳斯
Barden	巴登
Carleston	卡尔斯顿
Pimper	平珀
Exstance	埃克斯滕斯
Hankins	汉金斯
Aines	安斯
Larken	拉肯
Glascoff	格拉斯科夫
Pincoffs	平科夫斯
Pusateri	普萨泰里
Wetering	韦特林
Coggin	科金
Giulianti	朱利安蒂
Nyhen	奈恩
Sellery	塞勒里
Wardwell	沃德韦尔
Horatius	霍雷修斯
Hoddy	霍迪
Phodges	福奇斯
Joll	乔尔
Terbell	特贝尔
Munsat	芒萨特
Demille	德米尔
Packy	帕基
Cleather	克莱瑟
Emyr	埃米尔
Aradius	阿拉迪厄斯
Wackett	瓦克特
Winick	威尼克
Robartes	罗巴茨
Agnello	阿涅洛
Graziadio	格拉齐亚迪奥
Widzer	威泽
Ilay	艾莱
Nathiew	纳休
Crackel	克拉克尔
Hudak	赫达克
Waylon	韦伦
Kaila	凯拉
Macelfrish	麦克尔弗里什
Stiglitz	施蒂格利茨
Bechtol	贝克托尔
Beynon	贝农
Cecilius	塞西莉厄斯
Kayser	凯泽
Hensher	亨舍
Wonnacott	旺纳科特
Fracker	弗拉克
Yoe	约
Newcomb	纽科姆
Nanson	南森
Beckert	贝克特
Grossi	格罗西
Burkitt	伯基特
Naden	内登
Hammes	黑姆斯
Bleir	布莱尔
Sizer	赛泽
Rebel	里贝尔
Chagles	查格利斯
Abbotson	阿博森
MacEachen	麦凯琴
Woledge	沃利奇
Griebenow	格里布诺
Rodnight	罗德奈特
Murino	穆里诺
Locki	洛基
McLintock	麦克林托克
Schauer	肖尔
Ganangiyan	加南吉扬
Ferguson	弗格森
Esdaile	埃斯代尔
Tynte	廷特
Whittingstall	惠廷斯托尔
Eggers	埃格斯
Goulard	戈拉德
Altmann	奥尔特曼
Deiters	戴特斯
Slighton	斯莱顿
Cowart	科沃特
Grogger	格罗格
Brise	布赖斯
Lorinda	洛琳达
Novick	诺维克
Shutler	舒特勒
Whiteleather	怀特莱瑟
Schott	肖特
Effler	埃弗勒
Grennan	格伦南
Ricker	里克
Blaikley	布莱克利
Cragg	克拉格
Harshfeld	哈什菲尔德
Royale	罗亚尔
Whitsett	惠特西特
Donal	多纳尔
Hutchinson	哈钦森
Kurlantzick	库兰齐克
Prattis	普拉蒂斯
Minturn	明特恩
Elmslie	埃尔姆斯利
Hedke	赫德基
Merdinger	默丁杰
Teitell	泰特尔
Wasmer	沃斯默
Gard	加德
Leckrone	莱克龙
Comras	科姆拉斯
Weinland	温兰
Bresnahan	布雷斯纳汉
Pow	鲍
Wraxhall	拉克斯尔
Godefroy	戈德弗罗伊
Porten	波滕
Parrent	帕伦特
Manlius	曼利厄斯
Grinell	格里内尔
Pain	佩因
Swantz	斯旺茨
Baughman	鲍曼
Brimacombe	布里马科姆
LeTocq	勒托克
Rows	罗斯
Shelagh	希拉
Negel	尼格尔
Rethers	雷瑟斯
Smail	斯梅尔
Syrus	赛勒斯
Nolan	诺兰
Shelley	谢利
Opp	奥普
Colish	科利什
Huffam	赫法姆
Galliver	加利弗
Sherer	谢勒
Bardgett	巴杰特
Brauff	布劳夫
Byrer	拜勒
Tallichet	塔利切特
Joffrion	乔夫里翁
Devenport	德文波特
Derpool	德普尔
Egelton	埃格尔顿
Rockett	罗基特
Boehne	贝尼
Clure	克卢尔
Grouer	格劳尔
Dvorak	德沃夏克
Bueno	比诺
Benavides	贝纳维兹
Gorger	戈杰
Majors	梅杰斯
Darland	达兰
Feuerwerker	福伊尔沃克
Taggy	塔姬
McCoch	麦科奇
Timewell	泰姆韦尔
Bonosaro	博诺萨罗
Bachner	巴赫纳
Yulish	尤利什
Corlett	科利特
Tudhoe	塔杜
Truefitt	特鲁菲特
Bunge	邦奇
Gorr	戈尔
Tigrett	泰格雷特
Eking	伊金
Honass	霍纳斯
Cadieux	卡迪厄
Kapenstein	卡彭斯坦
Tollestrup	托尔斯特拉普
Luxton	勒克斯顿
Dascher	达舍
Gordin	戈丁
Knutti	克努蒂
Kainen	凯南
Caverly	卡弗利
Polkinghorne	波尔金霍恩
Klaussen	克劳森
Prebensen	普雷本森
Deptuck	德普塔克
Dieter	迪特尔
Lannon	兰农
Ley	利
Knuthsen	克努森
Gehl	吉尔
Duesterberg	杜斯特伯格
Gergen	格根
Guymon	盖蒙
Fulwyler	富尔怀勒
Kuhla	库拉
Grolier	格罗利尔
Alibrando	阿利布兰多
Shiel	希尔
Donham	多纳姆
Cozan	科赞
Wieck	威克
Alness	阿尔尼斯
Cablinger	卡布林格
Kretchmar	克雷奇马尔
Conning	康宁
Brody	布罗迪
Botty	博蒂
Waldie	沃尔迪
Benkard	本卡德
Parris	帕里斯
Lydford	利德福德
Hitchell	希切尔
Beilke	贝尔克
Merklein	默克莱因
Feane	费恩
Maury	莫里
Conein	科奈恩
Bras	布拉斯
Lomoe	洛莫
Hambright	汉布赖特
Dunlap	邓拉普
Barno	巴诺
Faulds	福尔兹
Broxon	布罗克森
Farer	法勒
Helbert	赫尔伯特
Folkers	福克斯
Falkner	福克纳
Grebow	格里博
Frece	弗雷斯
Longhlein	朗莱恩
Camacho	卡马乔
Deklinski	德克林斯基
Dahlberg	达尔伯格
Bozarth	博扎思
Elles	埃利斯
Desbarats	德巴拉茨
Bankston	班克斯顿
Wallack	沃勒克
Hickes	希克斯
Houdini	霍迪尼
Raynes	雷恩斯
Cabell	卡贝尔
Crandall	克兰德尔
Tiego	蒂戈
Iolo	约洛
Tirana	蒂拉纳
Dieckmann	迪克曼
Christanson	克里斯坦森
Aydelotte	艾德洛特
Carnearney	卡奈尔尼
Weakley	威克利
Tennenbaum	特南鲍姆
Hodgan	霍根
Berney	伯尼
Siepert	西珀特
Cachia	卡夏
Cestrone	塞斯特龙
Gransden	格兰斯登
Kolodin	科洛丁
Sarett	萨雷特
Wald	沃尔德
Castles	卡斯尔斯
Lords	洛兹
Morsan	莫桑
Argeris	阿吉里斯
Minnette	明妮特
Stunkard	斯顿卡德
Forga	福加
Nevinson	内文森
Rehal	雷哈尔
Conerty	科纳蒂
Anspacher	安斯帕赫尔
Jasinowski	贾西诺斯基
Lucking	勒金
Stockman	斯托克曼
Crever	克里弗
Frock	弗罗克
Waltheof	瓦尔塞奥夫
Rapuano	拉普阿诺
Torbett	托贝特
Talbert	塔尔伯特
Tyrell	蒂雷尔
Pad	帕德
Nobel	诺贝尔
Sambles	桑布尔斯
Goulart	古拉特
Rofe	罗夫
Brooman	布鲁曼
Chavers	查弗斯
Andress	安德烈斯
Cargo	卡戈
Elspie	伊丽莎白
Gage	盖奇
Leider	莱德
Weathers	韦瑟斯
Hagan	黑根
Vytlacil	维特拉西尔
Leshy	莱希
Fowle	福尔
Almon	阿尔蒙
Maccurrach	麦柯拉克
Worker	沃克
Oddy	奥迪
Carlucci	卡卢奇
Newstone	纽斯通
Gompers	冈珀斯
Katrinsak	卡特林萨克
Comini	科米尼
Topple	托佩尔
Slade	斯莱德
Rochlin	罗克林
Thames	泰晤士
Butchart	布查特
Svec	斯韦克
Happ	哈普
Greenblatt	格林布拉特
Baynard	贝纳德
Morrick	莫里克
Stanbrough	斯坦伯勒
Tim	蒂姆
Gebhart	格布哈特
Kennaird	肯奈德
Starks	斯塔克斯
LeCras	勒克拉
Andelin	安德林
Vosburg	沃斯伯格
Spreyer	斯普雷耶
Eichner	艾希纳
Winspear	温斯皮尔
Ferrao	费劳
Durey	杜里
Manzano	曼扎诺
O'Flaherty	奥弗莱厄蒂
Fetrow	费特罗
Weldon	韦尔登
Stephon	斯蒂芬
Bonesteel	博恩斯蒂尔
Grob	格罗布
Crean	克林
Samaroo	萨马鲁
Soper	索珀
Vinita	维尼塔
Jenkin	詹金
Kachert	卡彻特
Butowsky	布托夫斯基
Sherick	谢里克
Ruediger	鲁迪格
Muessig	米西格
Osmundus	奥斯蒙德斯
Hotchkiss	霍奇基斯
Hoegh	霍格
Gest	格斯特
Turnbaugh	特恩博
Aspland	阿斯普兰
Mackaye	麦凯
Waltman	沃尔特曼
Bergevin	伯格文
Carp	卡普
Bohannon	博安农
Mulville	马尔维尔
Starret	斯塔雷特
Pyrke	珀基
Orme	奥姆
Emblin	恩布琳
Woodham	伍德姆
Baughan	鲍恩
Minvielle	明维尔
Ausak	奥萨克
Calthorpe	考尔索普
Sherwood	舍伍德
Valeotis	瓦莱奥蒂斯
Fell	费尔
Anker	安克
Rovetta	罗韦塔
Thesen	特森
Purdon	珀登
Cawdrey	考德里
Bankoff	班科夫
Deecken	迪肯
Guildhaume	吉尔多姆
Hecker	赫克
Evjue	埃维尤
Weidenfeld	韦登菲尔德
Mannock	曼诺克
Picknell	皮克内尔
Jaspar	贾斯帕
Coale	科尔
Wilkowski	维尔科夫斯基
Olivas	奥利瓦斯
Oberfell	奥伯费尔
Faneuil	法纳尔
Rheta	里塔
Goldich	戈尔迪奇
Garr	加尔
Poo	普
Burnett	伯内特
Richart	理查特
Runnegar	朗内加
Balakian	巴拉基安
Quayle	奎尔
Authen	奥森
Ahntholz	安索尔兹
Fuson	富森
Manning	曼宁
Insko	英斯科
Cartha	卡撒
McClean	麦克林
Newson	纽森
Mancusi	曼库西
Becchetti	贝凯蒂
Younger	扬格
Dolger	德尔格
Shearsmith	希尔史密斯
Herbestreit	赫布斯特雷特
Hellstern	赫尔斯特恩
Glicken	格利肯
Shanken	尚肯
Norweb	诺韦布
Eilperin	艾尔珀林
Bingle	宾格尔
Ambarose	安巴罗斯
Moffat	莫法特
Cooch	库奇
Schuck	舒克
Rozelle	罗泽尔
Krumm	克鲁姆
Fishburg	菲什伯格
Berkley	伯克利
Raffan	拉芬
Fazekas	法泽卡斯
Puleston	普利斯顿
Egerman	埃格曼
Bardack	巴达克
Poling	波林
Sigrist	西格里斯特
Probst	普罗布斯特
Woolfolk	伍尔福克
Allgaier	奥尔盖耶
Runner	朗纳
Coke	科克
Keren	克伦
Timken	蒂姆肯
Gilgenbach	吉尔根巴赫
Baudkin	鲍德金
Grundmann	格伦德曼
Costar	科斯塔
Deerlin	迪尔林
Cothern	科瑟恩
Rakers	雷克斯
Elwes	埃尔威斯
Kroll	克罗尔
Tavor	塔沃尔
Quintana	昆塔纳
Weiher	韦伊尔
Goadby	戈德比
Cogswell	科格斯韦尔
Doiman	多伊曼
Worde	沃德
Vetter	维特尔
Colmer	科尔默
Chatwin	查特温
Hermione	赫米奥娜
Svewar	斯维沃
Johnson	约翰逊
Honderich	杭德里克
Fussler	富斯勒
Laughlin	劳克林
Libertine	利伯蒂娜
Dallepezze	达莱佩泽
Hooft	胡夫特
Bonavia	博纳维亚
Meilstrup	迈尔斯特勒普
Launceletus	朗斯利特斯
Kleberg	克莱伯格
Ederle	埃德尔
Wolter	沃尔特
Woldman	沃尔德曼
Addeo	阿德奥
Midgley	米奇利
Whayne	惠恩
Brandon	布兰登
Praxel	普拉克塞尔
Holyfield	霍利菲尔德
Hattersley	哈特斯利
Tobin	托宾
Bombeck	邦贝克
Buffey	巴菲
Rieke	里克
Komoniarek	科莫尼亚雷克
Delarue	德拉鲁
Gernsback	根斯巴克
Marzluf	马兹卢夫
Calderon	考尔德伦
Teetor	蒂特
Berta	伯塔
Vaitukaitis	韦图凯蒂斯
Glenister	格莱尼斯特
Birr	伯尔
Wain	韦恩
Kemmerer	凯默勒
Duncanson	邓肯森
Codel	科德尔
Brussock	布鲁索克
Gladieux	格拉迪厄
Gaudian	高迪恩
Maude	莫德
Smark	斯马克
Diel	代尔
Kynge	金奇
Coates	科茨
Shaylee	谢莉
Fitzwarren	菲茨沃伦
Vidor	维多
Bottomley	博顿利
Lightfoot	莱特富特
Diethrich	迪特里希
Dehay	德海
Heitner	海特纳
Kristine	克里斯廷
Twist	特威斯特
Blamires	布拉迈尔斯
Melchers	梅尔彻斯
Meislich	迈斯利奇
Actto	阿克托
Muscatine	马斯卡廷
Keliper	凯利珀
Dauntsey	当齐
Wasow	瓦索
Howarth	豪沃思
Leontiev	列昂季耶夫
Hinnant	欣南特
Marland	马兰
Casswell	卡斯韦尔
Bunke	邦克
Hedden	赫登
Ghiardi	吉亚尔迪
Allam	奥勒姆
Callen	卡伦
Bodycombe	博迪库姆
Schwelb	施韦布
Chernish	彻尼什
Eyre	艾尔
Jadyn	杰丁
Izenour	艾泽努尔
Buhre	布雷
Lentz	伦茨
Youngberg	扬伯格
Sivard	西瓦德
Boyden	博伊登
Hendry	亨德里
Jacobstein	雅各布斯坦
Guild	吉尔德
Gow	高
Craxton	克拉克斯顿
Ranulph	雷纳夫
Floherty	弗洛赫蒂
Tallackson	塔拉克森
Mowder	莫德
Trerise	特里赖斯
Panet	帕内特
Ronne	龙尼
Smock	斯莫克
Pinchot	平肖
Fanget	范格特
Stew	斯图
Kemmer	凯默
Playford	普莱福德
Ilg	伊尔克
Goodings	古丁斯
Chasen	蔡森
Esposito	埃斯波西托
Coppela	科皮拉
Chelberg	切尔伯格
Joorabchian	朱拉布奇安
Stombaugh	斯通博
Slattery	斯莱特里
Freckleton	弗雷克尔顿
Tauro	陶罗
Angelis	安杰利斯
Cool	库尔
Earmarth	厄马思
Shillaker	希莱克
Karlin	卡林
Weisner	韦斯纳
Haugan	豪根
Crelin	克雷林
Morthland	莫思兰
Potamos	波塔莫斯
Rosenback	罗森巴克
Kopman	科普曼
Bolduc	博尔达克
Rigdon	里格登
Condra	康德拉
Shrigley	施里格利
Packe	帕克
Manderson	曼德森
Begelman	比格尔曼
Knause	克瑙斯
Hugghins	哈金斯
Treml	特雷姆尔
Mayo	梅奥
Tebby	特比
Antevil	安特维尔
Rising	赖辛
Winstead	温斯特德
Dunavant	杜纳万特
Baumker	鲍姆克
Kuipers	凯珀斯
Maindonald	梅因唐纳德
McAlery	麦卡利里
Farradane	法拉丹
Hazeltine	黑兹尔坦
Slutz	斯卢茨
Eucharista	尤卡里斯塔
Behrstock	贝尔斯托克
Mighill	迈伊尔
Heman	希曼
Ensrud	恩斯鲁德
Brother	布拉泽
Kinsolving	金索尔文
Thynne	锡恩
Poynton	波因顿
Hamm	哈姆
Freas	弗里亚斯
Piney	派尼
Conaton	科纳顿
Brian	布赖恩
Dam	达姆
Runice	鲁尼斯
Hartop	哈托普
Keezer	基泽
Dockwra	多克拉
LeTendre	勒滕德
MacGill	麦吉尔
Lightbourne	莱特伯恩
Esbensen	埃斯本森
Jesse	杰西
Stobie	斯托比
Heinte	海因特
Gwynfor	格温弗
Monington	莫宁顿
Barchfeld	巴奇菲尔德
Levesque	莱韦斯克
Audrey	奥德丽
Yovanovitch	约万诺维奇
Bredin	布雷丁
Piyush	皮尤什
Otte	奥特
Andriole	安德里奥尔
Toulmin	图尔明
Hoar	霍尔
Rusling	拉斯林
Giloane	吉洛恩
Daniero	达尼罗
Monsell	蒙塞尔
Smaby	斯梅比
Dryburgh	德赖伯勒
Karp	卡普
Inchiquin	英奇昆
Raclin	拉克林
LePennec	勒佩内克
Zimbardo	津巴多
Side	赛德
Donenfeld	多宁费尔德
Nanos	纳诺斯
Waldrep	沃尔德里普
Penzer	彭泽
Demascio	德马肖
McGavern	麦加文
Mukowski	穆科斯基
Gaulke	高尔克
Koteen	科廷
Zechella	泽克拉
Kallie	凯莉
Skate	斯卡特
Macgillvoor	麦吉尔伍尔
Bougourd	布古尔
Kallas	卡拉斯
Ashmole	阿什莫尔
Sevin	西文
Kail	凯尔
Egner	埃格纳
Jarrod	贾罗德
Nemzek	内姆泽克
Umansky	乌曼斯基
Treston	特雷斯顿
Vicent	维森特
Stecko	斯特科
Headley	黑德利
Claudine	克劳丁
Walden	沃尔登
Shinn	希恩
Satter	萨特
Blankenberg	布兰肯伯格
Courant	库兰特
Ponnamperuma	庞南佩鲁马
Mizen	迈曾
Zubkoff	朱布科夫
Tufte	塔夫特
Lommel	隆梅尔
Glynne	格林
Murane	穆兰
Caffyn	卡芬
Much	马奇
Gennifer	珍妮弗
Chassagnes	沙萨涅
Coddry	科德里
Devons	德文斯
Matloff	马特洛夫
Kohler	科勒
Earley	厄利
Nowlan	诺兰
Aiuto	阿尤托
Jock	乔克
Boughrood	鲍赫鲁德
MacDermot	麦克德莫特
Gillon	吉伦
Fedi	费迪
Graeme	格雷姆
Mahady	马哈迪
Doward	道尔德
Benioff	贝尼奥夫
Linnell	林内尔
Feigenbaum	费根鲍姆
Barnhardt	巴恩哈特
Braddon	布拉登
Kearey	基里
Hass	哈斯
Wacker	瓦克尔
Louizou	路易祖
Franz	弗朗兹
Darter	达特
Branch	布兰奇
Trifonidis	特里福尼迪斯
Mizelle	米泽勒
Torres	托里斯
Patten	帕滕
Istock	伊斯托克
Stirland	斯特兰
Breck	布雷克
Wohlleben	沃莱本
Pfaltzgraff	法尔茨格拉夫
Brauer	布劳尔
Maryon	马里恩
Hellier	赫利尔
Washenko	瓦申科
Kropatkin	克罗帕特金
Finklestein	芬克尔斯坦
Gellatley	格拉特利
Bonett	博内特
Davol	达沃尔
Bodenberg	博登伯格
Truninger	特鲁宁格
Ilett	艾利特
Biddington	比丁顿
Droste	德罗斯特
Deuschl	多伊施尔
Boydon	博伊登
Benge	本奇
Mcmurrough	麦克默罗
Maxvill	马克斯维尔
Marcuse	马库塞
Lubin	卢宾
Irminger	艾尔明格
Fertel	费特尔
Yeabsley	耶布斯利
Allen	艾伦
Brimble	布林布尔
Bujake	布亚克
Carvatta	卡瓦塔
Dalis	达利斯
Isambard	伊桑巴德
Wark	沃克
Nies	尼斯
Stent	斯滕特
Oehlert	奥勒特
Cherberg	彻伯格
Nibls	尼布尔斯
Jotham	乔撒姆
Laderman	拉德曼
Kessing	凯辛
Garnaut	加诺特
Dice	戴斯
Stanlake	斯坦莱克
Winchelsea	温切尔西
Kasner	卡斯纳
Modica	莫迪卡
Ezzell	埃泽尔
Maur	莫尔
Freers	弗里尔斯
Smaill	斯梅尔
Hesky	赫斯基
Guokas	古奥卡斯
Cossutta	科苏塔
Dittert	迪泰特
Phaten	法滕
Kiana	基安娜
Durfee	德菲
Hondelink	杭德林克
Crivelli	克里韦利
Buntline	邦特兰
Fitzailwyn	菲茨艾尔温
Eddison	埃迪森
Skora	斯科拉
Oakley	奥克利
Garret	加勒特
Demarce	德马斯
Higinbotham	希金博特姆
Groce	格罗斯
Cleage	克利奇
Denning	丹宁
Sweeris	斯威里斯
Rutter	拉特
Fortner	福特纳
Sayres	塞尔斯
Bilyeu	比利厄
McAndless	麦坎德利斯
Maule	莫尔
Strook	斯特鲁克
Marj	马季
Capsalis	卡普萨利斯
Hannum	汉纳姆
Steventon	史蒂文顿
Bugas	巴加斯
Gundersen	冈德森
Dietel	迪特尔
Brengle	布伦格尔
Edgedal	埃奇代尔
Scarff	斯卡夫
Hefner	赫夫纳
Lecky	莱基
Key	基
Lindsten	林斯滕
Brodsky	布罗德斯基
Tarbell	塔贝尔
Bennete	贝内特
Decroock	德克鲁克
Bettelheim	贝特尔海姆
Berall	伯罗尔
Cosker	科斯克
Schwimmer	施维默
Turekian	图雷基安
Catron	卡特伦
Switkay	斯威凯
Marlitt	马利特
Brillhart	布里尔哈特
Whitton	惠顿
Daubenspeck	多本斯佩克
Carson	卡森
Sobeloff	索贝洛夫
Zbarskiy	兹巴尔斯基
Keithen	基森
Dirksen	德克森
McKusick	麦库西克
Stephens	斯蒂芬斯
Beighle	贝尔
Cotchett	科切特
Maio	梅约
Morrisette	莫里塞特
McAliksey	麦卡利克西
Peasgood	皮斯古德
Kartun	卡顿
Jeffcock	杰夫科克
Trudel	特鲁德尔
Spaul	斯波尔
Mole	莫尔
Schauffler	肖夫勒
Crawford	克劳福德
Lashbrook	拉什布鲁克
Thuillier	特威利尔
Diamant	迪亚曼特
Freda	弗雷达
McNear	麦克尼尔
Francisco	弗朗西斯科
Farragut	法拉格特
Coard	科尔德
Dergarabedian	德加拉贝迪安
Gottgetereu	戈特格特鲁
Acklin	阿克林
Northampton	诺桑普顿
Sapir	萨皮尔
Stack	斯塔克
Anthis	安西斯
Popp	波普
Broas	布罗斯
Kidd	基德
Marash	马拉什
Neddie	内迪
Schlamm	施拉姆
Hellenbrand	海伦布兰德
Gumbley	冈布利
Erb	厄尔布
Ogley	奥格利
Pollit	波利特
Ortenberg	奥滕伯格
Starley	斯塔利
Geddry	格德里
Hohfeld	霍菲尔德
Tweed	特威德
McKeehan	麦基恩
Winterburn	温特伯恩
Gwatkin	格沃特金
Ike	艾克
Yellowley	耶洛利
Baldanzi	巴尔丹齐
Genee	吉尼
Thomsen	汤姆森
Cissie	锡西
Lelland	利兰
Streeb	斯特里布
Fredrica	弗雷德里卡
Chivatero	奇瓦特罗
Wenzel	温策尔
Dooge	杜奇
Ratinon	拉蒂农
Horr	霍尔
Bamont	贝蒙特
Galiardo	加利亚尔多
Potok	波托克
Aldhizer	奥尔迪泽
Kindopp	金多普
Maclinmont	麦克林蒙特
Calogero	卡洛杰罗
Lovering	洛夫林
Filbert	菲尔伯特
Hadlow	哈德洛
Nagean	纳金
Marten	马滕
Clench	克伦奇
Mlinarchik	姆利纳奇克
Farndale	法恩代尔
Begel	比格尔
Dowdeswell	多德斯韦尔
Durr	杜尔
Canby	坎比
Thorning	索宁
Berrie	贝里
Shope	肖普
Meazey	梅齐
Herklots	赫克洛茨
Lom	洛姆
Uthe	尤思
Groucho	格劳乔
Killingsworth	基林斯沃思
Welliver	韦利弗
Stiner	斯蒂纳
Pickart	皮卡特
Prahin	普拉欣
Nuttall	纳托尔
Dhyrenfurth	迪伦弗思
Laffeaty	拉菲蒂
Zalmay	扎尔梅
Globus	格洛伯斯
Yankwich	扬克维奇
Randles	兰德尔斯
Sigel	西格尔
Raynham	雷纳姆
Sageman	塞奇曼
Cudahy	卡达希
Kercheville	克切维尔
Schwetid	施韦蒂德
Desiree	德西蕾
Place	普莱斯
Eiland	艾兰
Kewley	丘利
Ubaldi	乌巴尔迪
Dyde	戴德
Douza	杜扎
Josselyn	乔斯林
Cuadra	夸德拉
Chipp	奇普
Huish	休伊什
Depommier	德波米耶
Bion	拜昂
Gahagen	加黑根
McInturff	麦金塔夫
Morfudd	莫维兹
Sankley	尚克利
Offut	奥法特
Tross	特罗斯
Reeser	里泽
Butterworth	巴特沃思
Romaine	罗曼
Camy	卡米
Saemala	赛马拉
Wystan	威斯坦
Felsher	费尔舍
Wobber	沃伯
Gilhuly	吉尔胡利
McConkey	麦康基
Bodwine	鲍德温
Rudowsky	鲁多夫斯基
Devino	德维诺
Brouse	布劳斯
Genova	吉诺瓦
Bella	贝拉
Fortas	福塔斯
Luss	卢斯
Clason	克拉森
Horbaly	霍巴利
Knipmeyer	尼普迈耶
Kinnane	金南
Brown	布朗
MacCoy	麦科伊
Pitney	皮特尼
Shortley	肖特利
Haury	豪里
Owns	奥恩斯
Haulsee	豪尔西
Eversmann	埃弗斯曼
Bawcombe	鲍库姆
Lines	莱恩斯
Kauper	考珀
LeSurf	勒瑟夫
Colebatch	科尔巴奇
Doncaster	唐卡斯特
Challenger	查林杰
Fearnley	费恩利
Maida	梅达
Froom	弗鲁姆
Cage	凯奇
Pigott	皮戈特
Lovato	洛瓦托
Thaete	撒特
Lehman	莱曼
Zackrison	扎克里森
Yochelson	约克尔森
Sih	西赫
Jayne	杰恩
Arbogast	阿博加斯特
Francia	弗朗西亚
Mackinning	麦金宁
Fitzharris	菲茨哈里斯
Bronwyn	布朗温
Huntress	亨特里斯
Tiusanen	蒂乌萨宁
Pennyman	彭尼曼
Waite	韦特
Hulshizer	赫尔希泽
Seaford	西福德
Wister	威斯特
Seybold	西博尔德
Tribe	特赖布
Mildvan	米尔德文
Rovensky	罗文斯基
Ligget	利格特
Kincairney	金凯尼
Mielke	米尔克
Mckalip	麦卡利普
Aneny	阿内尼
Larke	拉克
Kadoorie	卡杜里
Arrowsmith	阿罗史密斯
Mussman	穆斯曼
Chafee	查菲
Endres	恩德雷斯
Cromb	克罗姆
Northam	诺瑟姆
Ormsby	奥姆斯比
Walrond	沃尔龙德
Montavon	蒙塔冯
Bartlo	巴特洛
Alwell	奥尔韦尔
Satge	萨特杰
Seele	西尔
Tysser	泰瑟
Mitten	米滕
Gearon	吉伦
Janisse	贾尼西
Bicket	比克特
Bandera	班德拉
Snedeker	斯内德克
Rod	罗德
Hammill	哈米尔
Yeni	耶尼
Duthie	达西
Lemlet	莱姆利特
Gahan	加恩
Shaon	肖恩
Ketner	凯特纳
Heesom	希瑟姆
Drapeau	德拉珀
Jasparks	贾斯帕克斯
Melsheimer	梅尔斯海默
Barwick	巴威克
Crespin	克雷斯平
Duley	杜利
Hodgart	霍贾特
Rogin	罗金
Saundby	桑德比
Llewellin	卢埃林
Gruner	格鲁纳
Scolaro	斯科拉罗
Grenoble	格雷诺布尔
Tebet	特贝特
Desbois	德布瓦
Grossnickle	格罗斯尼克尔
Cousland	库斯兰
Swaebe	斯韦比
Grabar	格拉巴
Fruit	弗鲁特
Illearn	伊尔伦
Ablom	阿布隆
Borgatta	博加塔
Athelston	阿瑟尔斯顿
Kiran	基兰
Esmail	伊斯梅尔
Jimmie	吉米
Ingersoll	英格索尔
Wattenberg	瓦滕伯格
Valek	瓦莱克
Lunney	伦尼
Chastka	查斯特卡
Aulicino	奥利西诺
Macconnach	麦康纳克
Rohlff	罗尔夫
Granwell	格兰韦尔
Antunes	安图尼斯
Engardio	恩加迪奥
Adinet	阿迪尼特
Jay	杰伊
Duncombe	邓库姆
Gilchrest	吉尔克里斯特
Truesdale	特鲁斯代尔
Crivaro	克里瓦罗
Dicker	迪克尔
Peterkin	彼得金
Desser	德瑟
Geballe	格巴尔
Hampden	汉普登
Houiellebecq	胡尔贝克
Mahood	马胡德
Boster	博斯特
Waterfield	沃特菲尔德
Ekers	埃克斯
Busche	布舍
Camelford	卡姆尔福德
Capo	卡波
Lukingbeal	卢金比尔
Meditch	梅迪奇
Bruene	布鲁恩
Redmer	雷德默
Buie	布伊
Cutter	卡特
Hilpert	希尔珀特
Raitt	雷特
Hembra	亨布拉
Robarts	罗巴茨
Fedochik	费多奇克
Esterhai	埃斯特海
Stanwood	斯坦伍德
Matzke	马茨克
Mulshine	马尔夏恩
Tarplin	塔普林
Sacklyn	萨克林
Michalak	迈克拉克
Electra	伊莱克特拉
Farenthold	法伦索尔德
Elofson	埃洛夫森
Doepel	德佩尔
Macaulay	麦考利
Kirgis	柯吉斯
Harraden	哈拉登
Chafetz	查菲茨
Sermeus	瑟缪斯
Boady	博迪
Degandt	德甘特
Anderes	安德雷斯
Ixer	伊克瑟
Angeles	安杰利斯
Fairlie	费尔利
Shellyn	谢林
Forseth	福塞思
Waight	韦特
Gayler	盖勒
Schults	舒尔茨
Yeamans	伊曼斯
Icahn	伊坎
Bela	贝拉
Reuel	鲁埃尔
Thun	图恩
Leaning	利宁
Buckstein	巴克斯坦
Berghorn	伯格霍恩
Grote	格罗特
Tether	特瑟
Lonsbury	朗斯伯里
Tschappat	查帕特
Gorsline	戈斯兰
Cleander	克林德
Hyson	希森
Nusbaumer	努斯鲍默
Bronson	布朗森
Moorehead	穆尔黑德
Wormsor	沃姆泽
Genauer	格瑙尔
Chaveg	查维格
Murie	缪里
Clave	克拉夫
Montonna	蒙顿纳
Ankenbrandt	安肯布兰特
Kasha	卡沙
Karnes	卡恩斯
Chantler	钱特勒
Leedom	利德姆
Malabre	梅拉伯
Arnison	阿尼森
Sarah	萨拉
Truslow	特拉斯洛
Maconochie	麦科诺基
Bocock	博科克
Holts	霍尔茨
Knighton	奈顿
Kirsteen	柯尔斯廷
Wasserstein	沃瑟斯坦
Surena	苏雷纳
Fink	芬克
Annora	安诺拉
Redenius	雷德尼厄斯
Alfers	阿尔弗斯
Deasy	迪西
Clusky	克拉斯基
Durkee	德基
Mabie	梅比
Esra	埃斯拉
Melfi	梅尔菲
Nico	尼科
Tolchin	托尔钦
Lichtwardt	利希特瓦尔特
Garnons	加农斯
O'Ferrall	奥费拉尔
Pearce	皮尔斯
Porritt	波里特
Tansil	坦西尔
Machen	梅琴
Godunov	戈杜诺夫
Dibdin	迪布丁
Headon	黑登
Wolmer	沃尔默
Jordyn	乔丁
Taschereau	塔什罗
Ettinger	埃廷格
Anany	阿纳尼
Clews	克卢斯
Fendrick	芬德里克
Collison	科利森
Brasfield	布拉斯菲尔德
Pisani	皮萨尼
Mixter	米克斯特
Falvey	法尔维
Durrad	达拉德
Lommen	洛门
Chapone	沙蓬
Logue	洛格
Huddleson	赫德尔森
Crispinian	克里斯皮尼安
Gooch	古奇
Horder	霍德
Bittman	比特曼
Northall	诺索尔
Curfman	柯夫曼
Chesmore	切斯莫尔
Therasia	特拉西娅
Harrow	哈罗
Lynndie	琳迪
Malakis	马拉基斯
Donoughmore	多诺莫尔
Chedell	切德尔
Carline	卡莱恩
Tondorf	汤多夫
Airlie	艾尔利
Pardoll	帕多尔
Coltrane	科尔特兰
Gamboa	甘博亚
Bartizal	巴蒂扎尔
Babson	巴布森
Fayer	费尔
Comber	库默
Tilling	蒂林
Hellers	赫勒斯
Neish	尼什
Houlden	霍尔登
Husch	胡希
Akeley	埃克利
Comroe	科姆罗
Old	奥尔德
Anslinger	安斯林格
Bengston	本斯顿
Ueyser	尤伊泽
Orla	奥尔拉
Blondin	布隆丁
McNab	麦克纳布
Heilbron	海尔布伦
Millspaugh	米尔斯波
Zysman	齐斯曼
Marrs	马尔斯
Thyra	赛拉
Addabbo	阿达博
Kadane	卡登
Kinglake	金莱克
Strohsahl	斯特罗萨尔
Ansley	安斯利
Avebury	埃夫伯里
Tuohey	图伊
Pettingill	佩廷吉尔
Vidi	维迪
Barnitz	巴尼茨
Villalobos	比利亚洛沃斯
Frenke	弗伦克
Rawlin	罗林
Cockriel	科克里尔
Scheidel	沙伊德尔
Hoser	霍泽
Maxton	马克斯顿
Lush	勒什
Cunnyngham	坎宁安
Maston	马斯顿
Deedham	迪德姆
Nall	诺尔
Hathorn	哈索恩
Gutwirth	格特沃思
Dukeminier	杜克米尼尔
Frantzen	弗兰岑
Stromberg	斯特龙伯格
Abrey	阿布里
Coyner	科伊纳
Crilly	克里利
Domvile	多姆维尔
Gurwitz	格威茨
Benke	本克
Habart	哈巴特
DeMaitre	德梅特尔
Batzel	巴策尔
Fredric	弗雷德里克
Imler	伊姆勒
Magafan	马加芬
Bradman	布拉德曼
Hartnett	哈特尼特
Chenevert	切尼弗特
Tomline	汤姆林
Beary	比尔里
Charlesworth	查尔斯沃思
Collow	科洛
Fogleman	福格尔曼
Swaythling	斯韦思林
Boise	博伊斯
Kopf	科普夫
Anido	阿尼多
Kid	基德
Seguin	塞金
Dumler	杜姆勒
Leonidas	利奥尼达斯
Hainfeld	汉费尔德
Garraty	加拉蒂
Walla	瓦拉
Greely	格里利
Rowledge	罗利奇
Asbell	阿斯贝尔
Ealdhelm	埃尔德姆
Lozier	洛齐尔
Blandau	布兰多
Stalnecker	斯托尔内克
Saller	萨勒
Whelton	惠尔顿
Colman	科尔曼
Perrott	佩罗特
Margery	马格丽
Everhard	埃弗哈德
Delves	德尔夫斯
Havinden	哈文登
Baerwald	贝瓦尔德
Hausler	豪斯勒
Ghey	贾伊
Pepler	佩普勒
Rheims	里姆斯
Akoka	阿科卡
Brous	布劳斯
Montcalm	蒙特卡姆
Ferozud	费罗祖德
Plugge	普拉奇
Kejoa	凯乔
Guttery	格特里
Rivlin	里夫林
Moskos	莫斯科斯
Boston	波士顿
Reedman	里德曼
Dresher	德雷舍
Feketekuty	费克特库蒂
Kolmer	科尔默
Brockholes	布罗克霍尔斯
Dubner	达布纳
Huffine	赫法恩
Mereweather	梅里韦瑟
Curtin	柯廷
Menchaca	门查卡
Wetherbee	韦瑟比
Millers	米勒斯
Sershey	塞希
Laxfrith	拉克斯弗里思
Cronyn	克罗宁
Hepper	赫珀
Maxen	马克森
Eno	伊诺
Seligmann	塞利希曼
Agrippa	阿格里帕
Sleeper	斯利珀
Barrass	巴拉斯
Loso	洛索
Caine	凯恩
Tingay	廷盖
Landrigan	兰德里根
Deikel	戴克尔
Gaved	加维德
Berkey	伯基
Kotschnig	科奇尼格
McNeely	麦克尼利
McGarvey	麦加维
Stremlau	斯特里姆劳
Peloubet	佩卢贝特
Dromgoole	德罗姆古尔
Blank	布兰克
Gellman	格尔曼
Beier	贝耶尔
Hulst	赫尔斯特
Spryer	斯普赖尔
Gaull	高尔
Rabideau	拉比多
Towns	汤斯
Nevison	内维森
Marchalonis	马查洛尼斯
Bechhofer	贝克霍弗
Anstead	安斯特德
Shorty	肖蒂
Serwach	瑟瓦奇
Acelin	阿斯林
Hendl	亨德尔
Foulkes	福克斯
Stump	斯顿普
Gottesman	戈特斯曼
Arenowitz	阿雷诺维茨
Sudbay	萨德贝
Enloe	恩洛
Dowley	道利
Gerckens	格肯斯
Nethery	内瑟里
Kovner	科夫纳
Afee	埃菲
Riverdale	里弗代尔
Dyers	戴尔斯
Sidebotham	赛德博特姆
Gerd	格尔德
Eklof	埃克勒夫
Nee	尼
Duffey	达菲
Boney	博尼
Linford	林福德
Virgil	弗吉尔
Boghatyr	博格蒂尔
Fengler	芬勒
Alleynian	阿莱尼安
Heil	海尔
Orick	奥里克
Nocks	诺克斯
Sindlinger	辛德林格
Meiling	迈林
Beachcroft	比奇克罗夫特
Philps	菲尔普斯
Hounshell	霍恩谢尔
Antonella	安东内拉
Gropp	格罗普
Worthy	沃西
Eadfrid	埃德弗里德
Eoin	约恩
Otes	奥茨
Thau	托
Marriott	马里奥特
Allridge	奥尔里奇
Zerbe	泽布
Fleming	弗莱明
Sydni	西妮
Tureman	图尔曼
Baza	巴扎
Factor	法克特
Herbold	赫博尔德
Reinecket	赖内克特
Desiderata	德西德蕾塔
Jouett	朱厄特
Archy	阿奇
Bronk	布朗克
Baynton	贝恩顿
Dagwell	达格韦尔
Jezek	杰泽克
Galli	加利
Seigel	西格尔
Kreplin	克雷普林
Lefebvre	勒费布尔
Kendrew	肯德鲁
Voigt	沃伊特
Yorkwilliams	约克威廉
Kiehl	基尔
Mosser	莫瑟
Haugen	豪根
Lipson	利普森
Fairley	费尔利
Rackley	拉克利
Aylesworth	艾尔斯沃思
Wohlstetter	沃尔斯泰特
Fralick	弗雷利克
Vechten	维克滕
Serna	塞尔纳
Lennen	伦南
Roget	罗热
Diggins	迪金斯
Kogan	科根
Aldonas	奥尔多纳斯
Daub	多布
Klein	克莱因
Frej	弗雷
Rota	罗塔
Fellin	费林
Abern	阿本
Drakos	德拉科斯
Idden	艾登
Nold	诺尔德
Emmeline	埃米琳
Dianis	迪亚尼斯
Hayland	海兰
Hammel	哈梅尔
Remsberg	雷姆斯伯格
Jeserich	杰塞里克
Hignett	希格尼特
Gorell	戈雷尔
Carameros	卡拉梅罗斯
Shaftesbury	沙夫茨伯里
Lent	伦特
McCormack	麦科马克
Dupont	杜邦
Klimcke	克利姆基
Carlson	卡尔森
Hulston	赫尔斯顿
Helble	赫布尔
Bilbrough	比尔伯勒
Moch	莫克
Swintor	斯温特
Soble	索布尔
Barnathan	巴纳森
Trapier	特拉皮尔
Galaty	加拉蒂
Rendfrow	伦德弗罗
Kingsley	金斯利
Brisben	布里斯本
Umbreit	昂布里特
Browne	布朗
Caegarw	凯加鲁
Launt	朗特
Huvos	休沃斯
Leasure	利热
Samstag	扎姆斯塔格
Kapla	卡普拉
Stoffer	斯托弗
McNaugher	麦克诺尔
Callies	卡利斯
Opitz	奥皮茨
Debaca	德巴卡
Blos	布洛斯
Grabske	格拉布斯克
Callick	卡利克
Higginson	希金森
Jaggers	贾格尔斯
Lanny	兰尼
Mirengoff	米伦戈夫
Merriam	梅里亚姆
Borzell	博泽尔
Grumbach	格伦巴赫
Bendig	本迪格
Brinkmann	布林克曼
Cyker	西克
Benfey	本菲
Keys	基斯
Brim	布里姆
Hegyi	赫吉
Millenson	米伦森
Sakinah	萨金娜
Fultz	富尔茨
Lefaune	勒方
Molzen	莫尔曾
Rafshoon	拉夫肖恩
Barnhouse	巴恩豪斯
Haggitt	哈吉特
Shuman	舒曼
Locke	洛克
Risner	里斯纳
Banwell	班韦尔
Beman	比曼
Seufert	索伊弗特
Mondavi	蒙达维
Strevens	斯特雷文斯
Ferrers	费勒斯
Mohrmann	莫尔曼
Stanham	斯塔纳姆
Malmin	马尔明
Mcvadon	麦克瓦登
Paterno	佩特诺
Hessing	赫辛
Action	埃克申
Wieland	威兰
Maienschein	梅恩沙因
Gasque	加斯克
Zimmeman	齐梅曼
Astley	阿斯特利
Sondes	桑德斯
Hankinson	汉金森
Davey	戴维
McGalliard	麦加利亚德
Merten	默滕
Bang	班
Fudge	富奇
Mupson	马普森
Auchincloss	奥金克洛斯
Albee	阿尔比
Ehrle	埃尔勒
Fitzell	菲策尔
Luckhurst	卢克赫斯特
Gramley	格拉姆利
Vandivier	范迪维尔
Heater	希特
Morden	莫登
Garmat	加马特
Noll	诺尔
Nabors	内伯斯
Carole	卡萝尔
Edinger	埃丁格
Deveulle	德韦尔
Gross	格罗斯
Cloud	克劳德
Mcgauran	麦戈兰
Dempasay	登帕西
Kimmons	基蒙斯
Grutt	格鲁特
Baldanza	巴尔丹扎
Denyer	德尼尔
Magnay	马格内
Falconbridge	福尔肯布里奇
Longino	朗吉诺
Marcuss	马克斯
Muan	穆安
Grinstead	格林斯蒂德
Nacheman	纳奇曼
Allvine	奥尔文
Trutter	特拉特
Rhindness	莱因德尼斯
Knaff	纳夫
Adelwin	阿德尔温
Hoeven	霍文
Hedly	赫德利
Combich	康比奇
Berrios	贝里奥斯
Meadows	梅多斯
Pudsey	帕齐
Rolufs	罗卢夫斯
Handwerger	汉德沃格
Cernovitch	切尔诺维奇
Cathryn	凯瑟琳
Jaquetta	雅克塔
Knisely	尼斯利
Legatt	莱格特
Nikolaidis	尼古拉迪斯
Bertera	伯特拉
Golightly	戈莱特利
Hynds	海因兹
Benthin	本辛
Form	福姆
Munnikhuysen	芒尼克海森
Child	蔡尔德
Scharrer	沙勒
Bookholt	布克霍尔特
Corigliano	科里利亚诺
Jurkowitz	尤尔科维茨
Rubenstein	鲁本斯坦
Rosenheim	罗森海姆
Fingerson	芬格森
Schewe	舍韦
Todaro	托达罗
Simonitsch	西莫尼奇
Semper	森珀
McJunkin	麦克琼金
Worsley	沃斯利
Redwald	雷德沃尔德
Gauthier	高蒂尔
Puckle	帕克尔
Craiz	克雷兹
Darley	达利
Imbrie	英布里
Gup	格普
Rabet	拉贝
Goffio	戈菲奥
Morelli	莫雷利
Venning	文宁
Giguere	吉格尔
Punter	庞特
McFadyean	麦克法迪恩
Margita	玛吉塔
Luned	莉内德
Cumin	卡明
Waln	沃恩
Chomeau	肖莫
Corace	科雷斯
Cochrane	科克伦
Winsborough	温斯伯勒
Brzana	布尔扎纳
Molholt	莫霍尔特
Kulick	库利克
Phaer	费尔
Ernie	厄尼
Agacia	阿加西娅
Mapel	马佩尔
Sikes	赛克斯
Rickett	里基特
Sermon	瑟蒙
Morant	莫兰特
Brodowski	布罗多夫斯基
Rambert	兰伯特
Crites	克赖茨
Altherton	奥尔瑟顿
Braintree	布伦特里
Metzenbaum	梅岑鲍姆
Chamberlsin	钱伯辛
Splitt	斯普利特
Pellicoro	佩利科罗
Coad	科德
MacKinlay	麦金利
Getsinger	格青杰
Roffey	罗菲
Booker	布克
Ingilby	英吉尔比
Wayson	韦森
Irvette	艾尔薇特
Holness	霍尔尼斯
Purtill	珀蒂尔
Isherwood	伊舍伍德
Marshman	马什曼
Spitzer	斯皮策
Barras	巴拉斯
Wyn	温
Denio	迪奈欧
Franko	弗兰科
Huffcut	赫夫克特
Fadden	法登
Sanche	桑奇
Enney	恩尼
Karenna	卡伦娜
Philbert	菲尔伯特
Eads	伊兹
Rigsby	里格斯比
Cullingworth	卡林沃思
Kille	基利
Othenel	奥塞内尔
Tandien	坦丁
Durbin	德宾
Baklanoff	巴克拉诺夫
Fooks	富克斯
Salter	索尔特
Magnolia	马格诺利娅
Southerden	萨瑟登
Ellesmere	埃尔斯米尔
Baloyra	巴洛伊拉
Daisy	黛西
Cascorbi	卡斯科比
Tisdale	蒂斯代尔
Glenway	格伦韦
Heacock	希科克
Casberg	卡斯伯格
Breech	布里奇
Wiswall	威斯沃尔
Ararie	阿拉里
Godefe	戈德夫
Arrantash	阿兰塔什
Branom	布拉诺姆
Wertheim	沃特海姆
Straten	斯特拉滕
Monteiro	蒙蒂罗
Channon	钱农
Darrow	达罗
Baylis	贝利斯
Christgau	克里斯戈
Aucoin	奥库安
Paneth	帕内思
Huerta	许尔塔
Morriss	莫里斯
Petro	佩特罗
Hunsaker	亨塞克
Norquoy	诺基
Willey	威利
Mudd	马德
Caravias	卡拉维亚斯
Mikva	米克瓦
Makeham	梅卡姆
Coorsh	库尔什
Zemmer	泽默
Gomillion	戈米利恩
Northwood	诺思伍德
Moro	莫罗
Ormsbee	奥姆斯比
Biagi	比亚吉
McKinbbin	麦金宾
Runyon	鲁尼恩
Rappoport	拉波波特
Stolzberg	斯托尔兹伯格
Dunster	邓斯特
Broomidge	布鲁米奇
Strawbridge	斯特劳布里奇
Wolstan	沃尔斯坦
Bernulf	伯纳夫
Donielson	多尼尔森
Smily	斯迈利
Hickenlooper	希肯卢珀
Yehudi	耶胡迪
Baltassar	巴尔塔泽
Duque	杜凯
Asner	阿斯纳
Devers	德弗斯
Amfrid	安弗里德
Heilkay	海尔基
Flickinger	弗利金杰
Zebina	泽拜纳
McAneney	麦卡内尼
Muss	马斯
Repton	雷普顿
Arner	阿纳
Alderfer	奥尔德弗
Brad	布拉德
Blough	布劳
Ginzler	金兹勒
Glasgow	格拉斯哥
Herbert	赫伯特
Hechinger	赫金杰
Harnedy	哈内迪
Brasnett	布拉斯尼特
Goyan	戈扬
Turnquist	特恩奎斯特
Smaje	斯梅奇
Blenkinsop	布伦金索普
Koblitz	科布利茨
Bilderoy	比尔德罗伊
Camoys	卡莫伊斯
Reeverts	里弗茨
Scargill	斯卡吉尔
Ollivant	奥利万特
Costoff	科斯托夫
Bridburg	布里德伯格
LeBoutillier	勒布蒂耶
McGuffy	麦古菲
Golovchenko	戈洛夫琴科
Hirshen	赫申
Blickenstaff	布利肯斯塔夫
McLemore	麦克勒莫尔
Lasker	拉斯克
Debruler	德布鲁勒
Macphedran	麦克费德伦
Gymer	盖默
Audigier	奥迪吉耶
Hummon	哈蒙
Berthoud	伯绍德
Alcalde	阿尔卡德
Propert	普罗珀特
Pachter	帕赫特
Beoley	比利
Din	丁
Killham	基勒姆
Gubitoshi	古比托西
Aylward	艾尔沃德
Klippen	克利彭
Derow	德罗
Falatko	法拉特科
Bitar	比塔尔
Loew	洛
Goepp	戈普
Mechling	梅克林
Mlakar	姆拉卡
Flamm	弗拉姆
Ching	钦
Seaman	西曼
Grio	格里奥
Wingrove	温格罗夫
Yeadon	伊登
McSparran	麦克斯帕伦
Dulwich	达利奇
Creelman	克里尔曼
McAskie	麦卡斯基
Howes	豪斯
Soffen	索芬
Rainey	雷尼
Diluchio	迪卢乔
Goeffrrey	戈弗里
Grosseteste	格罗斯泰特
Stiebeling	斯蒂贝林
Lochiel	洛希尔
Bullis	布利斯
Freyere	弗雷耶
Dunkling	邓克林
Raub	劳布
Wegman	韦格曼
Chandlee	钱德利
Engledow	恩格尔多
Battey	巴蒂
Hensly	亨斯利
Smallwood	斯莫尔伍德
Quickswood	奎克斯伍德
Schonfield	舍恩菲尔德
Fowlie	福利
Dziak	齐亚克
Stolpman	施托尔普曼
Medin	梅丁
Framption	弗兰普申
Osa	奥萨
Borrett	博里特
Meiklejohn	米克尔约翰
Frankhouser	弗兰克豪泽
Butterick	巴特里克
Lackenmier	拉肯米尔
Tramble	特兰布尔
Schul	舒尔
Feachem	费克姆
LaCampagne	拉康帕涅
Sauvage	索瓦热
Proudfoot	普劳德富特
Kudlow	库德洛
Else	埃尔斯
Herman	赫尔曼
Knight	奈特
Stratmon	斯特拉特蒙
Zeff	泽夫
Gubelmann	古贝尔曼
Coppard	科珀德
Gehman	格曼
Stares	斯泰尔斯
Picket	皮克特
Elzay	埃尔扎伊
Vegso	维格索
Cradock	克拉多克
Sauerwein	索尔温
Barthe	巴特
Aikens	艾肯斯
Clyde	克莱德
Escoffey	伊斯科菲
Birnbaum	伯恩鲍姆
Barfoot	巴富特
Albin	阿尔宾
Gilliam	吉列姆
Bartman	巴特曼
Fredette	弗雷德特
Pierre	皮埃尔
Zogbaum	佐格鲍姆
Sulick	苏利克
Boschwitz	博希威茨
Hardegree	哈迪格里
Flitcraft	弗利特克拉夫特
Derrian	德里安
Hambro	汉布罗
Pearl	珀尔
Brashier	布拉希尔
Alfonso	阿方索
Villarreal	维拉里尔
Clarity	克拉里蒂
Tubb	塔布
Hickernell	希克内尔
Byford	拜福德
Weinberg	温伯格
Peddle	佩德尔
Iglewicz	伊格尔维奇
Bagwell	巴格韦尔
Lowthian	洛西恩
Domjan	多米扬
Abastenia	阿巴斯蒂尼亚
Bowens	鲍恩斯
Bolado	博拉多
Allies	阿莱斯
Gillison	吉利森
Huyser	哈伊泽
Burland	伯兰
Shaen	谢恩
Weckerling	韦克林
Chambas	钱巴斯
Martyl	马蒂尔
Hibdon	希布登
Gantt	甘特
Commager	康马杰
Carapetyan	卡拉佩琴
Fairfoull	费尔福尔
Kish	基什
Markley	马克利
Bryning	布赖宁
Bobel	博贝尔
Gleadall	格利德尔
McCheane	麦克钦
Boorda	布尔达
Haddad	哈达德
Eedle	伊德尔
Deneys	德尼斯
Weirman	韦尔曼
Shenker	申克
Haydock	海多克
Imman	伊曼
Amadas	阿马达斯
Cheltenham	切尔特纳姆
Jolly	乔利
Broadbent	布罗德本特
Crabtree	克拉布特里
Hatchison	哈奇森
Richbourg	里奇伯格
Griem	格里姆
Ehret	埃雷特
Tello	特略
Messinbrink	梅辛布林克
Newburgh	纽伯格
Pallidino	帕利迪诺
Woolbert	伍尔伯特
Tait	泰特
Botset	博塞特
Tallmadge	塔尔梅奇
Pillow	皮洛
Enberg	恩伯格
Wirtz	沃茨
Wicksteed	威克斯第德
Carper	卡珀
Visclosky	维斯克洛斯基
Gergis	格吉斯
Skoglund	斯科格隆
MacVean	麦克韦恩
Hilds	希尔兹
Fullmer	富尔默
Lassar	拉萨
Barbanel	巴巴内尔
Vannoy	范诺伊
Weintal	温特尔
Harting	哈廷
Ochterlony	奥克特洛尼
Massey	马西
Jaffe	贾菲
Stamm	施塔姆
Pfrang	弗朗
Connely	康奈利
Linde	林德
Fazar	法扎尔
Aderhold	阿德霍尔德
Wennberg	温伯格
Doune	杜恩
Tilbrook	蒂尔布鲁克
Rattray	拉特雷
Prather	普拉瑟
Cardell	卡德尔
Rickard	里卡德
Sassienie	萨西尼
Marcelle	玛塞勒
Hezlet	赫兹利特
Touster	图斯特
Baughn	鲍恩
Colborn	科尔伯恩
Uwins	尤温斯
Christakos	克里斯塔科斯
Cehelsky	切赫尔斯基
Hiley	希利
Tamiris	塔米里斯
Tollemache	托尔马什
Camras	卡姆拉斯
Emerson	埃默森
Ulevich	乌莱维奇
Scoon	斯库恩
Foxen	福克森
Dahlstrom	达尔斯特伦
Conneally	康奈利
Lukken	卢肯
Dehayes	德海斯
Escritt	埃斯克里特
Funderburk	芬德伯克
Maton	梅顿
Molinari	莫利纳里
Shyla	夏伊拉
Beehan	比汉
Dianna	黛安娜
Britain	布里顿
Agosin	阿戈辛
Rostow	罗斯托
Jellison	杰利森
Groppi	格罗皮
Critzer	克里策
Kenrie	肯里
Brandli	布兰德利
Cannell	坎内尔
Hull	赫尔
Falkenheim	福尔肯海姆
Brettell	布雷特尔
Lissimore	利西莫尔
Fouts	福茨
Serrin	塞林
Reginald	雷金纳德
Deanes	迪恩斯
Spottiswoode	斯波蒂斯伍德
Hanushek	哈努谢克
Bonsteel	邦斯蒂尔
Batres	巴特雷斯
Eielson	艾尔森
Bedard	贝达德
Lambright	兰布赖特
Seyferth	赛弗思
Kasimir	卡西米尔
Welbert	韦尔伯特
Josiah	乔赛亚
Dragstedt	德拉格施泰特
Dimond	戴蒙德
Chodes	乔兹
Harkin	哈金
Spouse	斯波斯
Upschulte	厄普舒尔特
Popkin	波普金
Lowen	洛温
Johnny	约翰尼
Warham	沃勒姆
Doerfler	德夫勒
Chinigo	奇尼戈
Hobday	霍布迪
Porte	波特
Alagappa	阿拉加帕
Shrontz	施龙茨
Menzler	门兹勒
Tscherny	彻尼
Illig	伊利格
Bemersyde	比默赛德
Mimno	明诺
Bhupindar	布平达尔
Romeyn	罗梅因
Breakspear	布雷克斯皮尔
Glomset	格洛姆塞特
Shipler	希普勒
Stason	斯塔森
Goin	戈因
O'Bryan	奥布赖恩
Engebretson	恩格布雷森
Cuttle	卡特尔
Chesnoff	切斯诺夫
Tarbox	塔博克斯
Younghusband	扬哈斯本
Wainwright	温赖特
Sharpey	沙比
Arlington	阿林顿
McGaffigan	麦加菲根
Ellingford	埃林福德
LeSage	勒萨热
Bardsley	巴兹利
Witkowski	维特科夫斯基
Jeptha	杰普撒
Exton	埃克斯顿
Bublys	布勃利斯
Orleans	奥林斯
Buehring	比林
Turville	特维尔
McCully	麦卡利
Simpich	辛皮奇
Bratt	布拉特
Thedford	塞德福德
Bertholf	伯索夫
Anzalone	安扎隆
Elders	埃尔德斯
Ceddia	切迪亚
Davenport	达文波特
MacKenzie	麦肯齐
Zaugg	佐格
Coser	科泽
Hokin	霍金
Shurtleff	舒特莱夫
Spotted	斯波蒂德
Jozy	乔茜
Laybourne	莱伯恩
Andson	安德森
Savrin	萨夫林
Dian	戴安
Zambrum	赞布勒姆
Mahone	马洪
Rushford	拉什福德
Lazear	拉齐尔
Channier	钱尼尔
Smythies	斯迈西斯
Coult	库尔特
Laukhuff	劳卡夫
Delaquis	德拉奎斯
Milhy	米尔海
Cadwgan	卡杜根
Klass	克拉斯
Boshier	博舍尔
Tosi	托西
Schuppe	舒普
Jabber	贾伯
Toyne	托因
Scriber	斯克赖伯
Meacher	米彻
Musolino	穆索利诺
Bovee	博韦
Darlington	达林顿
Hillier	希利尔
Hektoen	赫克通
Schmeltzer	施梅尔策
Levi	利瓦伊
Chayes	蔡斯
Gallahue	加拉休
Nathanael	纳撒内尔
Crea	克雷
Gerber	格伯
Joulwan	朱尔万
Cuzzocrea	库佐克雷亚
Borders	博德斯
Hudson	赫德森
Wedgwood	韦奇伍德
Brans	布兰斯
Harland	哈兰
Clutz	克卢茨
Simister	西米斯特
Proskauer	普罗斯考尔
Adkisson	阿基森
Hartridge	哈特里奇
Schlie	施利
Iphigene	伊菲吉妮
Seckinger	塞金杰
Stanfield	斯坦菲尔德
Debicki	德比茨基
Lotterby	洛特比
Zeffirelli	泽菲雷利
Torley	托利
Teifion	泰维恩
Allo	阿洛
Nesfield	内斯菲尔德
Sinatra	西纳特拉
Gutche	古奇
Skog	斯科格
Griffel	格里费尔
Conville	康维尔
Pinckney	平克尼
Atty	阿蒂
Hegland	赫格兰
Alexys	亚历克西丝
Benjamin	本杰明
Gonya	戈尼亚
Fischelis	菲谢利斯
Larom	拉勒姆
Campaigne	坎佩恩
Fallis	法利斯
McKnew	麦克纽
Gutzwiller	古茨维勒
Marques	马克斯
Stankovic	斯坦科维奇
Walner	沃尔纳
Steffens	斯蒂芬斯
Ludgin	勒德金
Rhae	雷
Alpina	阿尔皮纳
Arni	阿尼
Draffin	德拉芬
McManaway	麦克马纳韦
Dravers	德雷弗斯
Kirelo	基雷洛
Frieda	弗里达
Werrell	沃雷尔
Weckler	韦克勒
Folz	福尔茨
Roby	罗比
DeFord	德福特
Raggi	拉吉
Ziernicki	齐尔尼基
Bobisud	博比苏德
Timinski	蒂明斯基
Trafton	特拉夫顿
Bruinsma	布鲁因斯马
Feer	菲尔
Tourle	特尔
Tulett	塔利特
Marceau	马索
Wennbery	温伯里
Mordey	莫迪
Klopp	克洛普
Stucke	斯图克
Schonberger	舍恩伯格
Feigen	费根
Baril	巴里尔
Plissner	普利斯纳
Lambelet	兰伯利特
Mussell	马塞尔
Trestman	特雷斯特曼
Konschnik	康施尼克
Gye	贾伊
Blanchett	布兰切特
Blumefield	布卢姆菲尔德
Liechtenstein	利克滕斯坦
Zizzo	齐佐
Greco	格雷科
Daring	达林
Anglin	安格林
Andruskevich	安德鲁斯克维奇
Moras	莫拉斯
Turano	图拉诺
Todreas	托德雷亚斯
Tayloe	泰洛
Bourgin	布尔金
Faupl	福普尔
Wisner	威斯纳
Tyringham	蒂林厄姆
Maitland	梅特兰
O'Gmole	奥格莫尔
Teates	蒂茨
Langmaid	兰梅德
Mosher	莫舍
Glasby	格拉斯比
Whittle	惠特尔
Giggs	吉格斯
Bue	布埃
Slacks	斯莱克斯
Alchin	阿尔钦
Aveis	阿维丝
Haigis	海吉斯
Kuiper	凯珀
Scarpero	斯卡佩罗
Zekman	泽克曼
Stranger	斯特兰杰
Aaron	阿龙
Neall	尼尔
Hurney	赫尼
Malkus	马尔库斯
Dhooge	杜格
Zion	蔡恩
Totten	托滕
Jobson	乔布森
Sence	森斯
Bastedo	巴斯特多
Merkel	默克尔
Gelbach	盖尔博
Libassi	利巴西
Luft	勒夫特
Brekland	布里克兰
Bette	贝特
Buachalla	布阿哈拉
Runkle	朗克尔
Ridings	赖丁斯
Mease	米斯
Walke	沃克
McCallin	麦卡林
Kourtney	考特妮
Gayford	盖福德
Mulberly	马尔伯利
Beckley	贝克利
Blomgren	布洛姆格伦
Kuehl	屈尔
Humfrye	汉弗莱
Partington	帕廷顿
McCrady	麦克拉迪
Newsum	纽瑟姆
Billiere	比埃
Mashenhole	马申霍尔
Metsger	梅茨格
Elger	埃尔格
Mann	曼
Kulig	库利格
Dancik	丹西克
Monaco	莫纳科
Lieberman	利伯曼
Ullrich	乌尔里克
Elkan	埃尔肯
Herzina	赫齐纳
Schnuck	施努克
Pucinski	普辛斯基
McGonagall	麦戈纳格尔
Frooks	弗鲁克斯
Pagin	帕金
Sich	西奇
Crabb	克拉布
Symondson	西蒙森
Mavalarp	马瓦拉普
Jarratt	贾勒特
Pares	佩尔斯
Towe	托
Nicolay	尼古拉
Tatooles	塔图尔斯
Randy	兰迪
Merson	默森
Pettis	佩蒂斯
Serrills	塞里尔斯
Willsie	威尔西
Freytag	弗赖塔格
Thalken	萨尔肯
Kimmitt	金米特
Holdridge	霍尔德里奇
Croasmun	克罗斯蒙
Jordans	乔丹斯
Rabida	拉比达
Ayla	艾拉
Silsley	西尔斯利
Leathart	利撒特
Ryzin	里津
Bromfield	布罗姆菲尔德
Wiemeyer	威迈耶
Couldwell	库尔德韦尔
Namath	纳马思
Syvertsen	赛弗森
Rouiller	鲁伊勒
Figgie	菲吉
Dentler	登特勒
Berna	伯纳
Beloof	贝卢夫
Murtrey	默特里
Saulez	索莱
Hayhurst	海赫斯特
Faull	福尔
Miklowitz	米克洛维茨
Stanczyk	斯坦奇克
Paulin	波林
Attridge	阿特里奇
Krowe	克罗
Asensio	阿森西奥
Gartland	加特兰
Pritzker	普里茨克
Frankell	弗兰克尔
Blechynden	布莱钦登
Woolpert	伍尔珀特
Mundy	芒迪
Elkin	埃尔金
Mullinax	马利纳克斯
Medawar	梅达沃
Kallick	卡利克
Bartholemeu	巴托洛缪
Andrina	安德里娜
Betsy	贝齐
Mottl	莫特尔
Daley	戴利
Coade	科德
Dwiggins	德威金斯
Quinten	昆滕
Tania	塔妮娅
Cirker	瑟克
Newmann	纽曼
Folds	福尔兹
Derwent	德温特
Nicolle	尼科尔
Endecott	恩迪科特
Shartle	沙特尔
Harbor	哈伯
Alwin	阿尔温
Lathom	莱瑟姆
Wherry	惠里
Pluta	普卢塔
Merck	默克
Houcke	霍克
Andary	安达里
Dubia	杜比亚
Epps	埃普斯
Heusel	休塞尔
Yasinski	亚辛斯基
Leflar	莱弗拉尔
Cava	卡瓦
Rosapepe	罗萨皮普
Heningburg	赫宁堡
Schoenstein	舍恩斯坦
Gaisser	盖瑟
Canney	坎尼
Basadre	巴萨德雷
Feuerzeig	福伊尔齐格
Mustoe	马斯托
Marston	马斯顿
Tuan	图安
Chintaman	钦塔曼
Christopher	克里斯托弗
Pyott	派奥特
Gilbart	吉尔巴特
Conall	科纳尔
Sellars	塞拉斯
Nivison	尼维森
McCausland	麦考斯兰
Clute	克卢特
Landy	兰迪
Sweitzer	斯韦策
Mellups	梅拉普斯
Hipwell	希普韦尔
Hackes	哈克斯
Beam	比姆
Malach	马拉克
Donchian	唐奇安
Delessio	德莱西奥
Cipriani	西普里亚尼
Sancton	桑克顿
Balsiger	巴尔西杰
Tampesi	坦佩西
Shillaber	希莱伯
Brandfas	布兰德法斯
Merrifield	梅里菲尔德
Sculpsit	斯卡尔普西特
Demetz	德梅茨
Humason	赫马森
Steffes	斯特弗斯
Castelberry	卡斯尔伯里
Guillebaud	吉尔博
Bechet	贝谢
Kenswood	肯斯伍德
Melior	梅莉奥尔
Weffries	韦弗里斯
Kleindinst	克兰丁斯特
Whiteman	怀特曼
Rein	赖因
Skip	斯基普
Bowyer	鲍耶
Langhorne	兰霍恩
Roumasset	罗马塞特
Gintz	金茨
Benington	贝宁顿
Ollier	奥利尔
Wolsey	沃尔西
Fork	福克
Boult	博尔特
Kerchever	克切弗
Cardinale	卡迪纳尔
Mowle	莫尔
Beatricia	比阿特丽西娅
Lansell	兰塞尔
Moltz	莫尔茨
Forfar	福法
Menuhin	梅纽因
Mosey	莫西
Willmot	威尔莫特
Shure	舒尔
Brownstein	布朗斯坦
Keig	基格
Fialka	菲亚尔卡
Domike	多米克
Macconscher	麦康舍
Pentin	彭廷
Hemmes	赫姆斯
Isakow	伊萨科夫
Phear	菲尔
Eglof	埃格洛夫
Battaglini	巴塔利尼
Odem	奥德姆
Zwar	兹瓦尔
Chrencik	赫伦奇克
Brooks	布鲁克斯
Rollo	罗洛
Neysa	尼萨
Pennwalt	佩恩沃尔特
Milius	米利厄斯
Priddle	普里德尔
Brombley	布朗布利
Tassie	塔西
Sowrey	索里
Koussevitzky	科乌谢维茨基
Mineo	米内奥
Fillios	菲利奥斯
Broening	布罗宁
Reignolde	赖格诺尔德
Charman	查曼
Poulter	波尔特
Illtud	伊尔蒂德
Lanting	兰廷
McMillan	麦克米伦
Froese	弗勒泽
Ryle	赖尔
Ashleigh	阿什莉
Stoorza	斯图尔扎
Bruny	布鲁尼
Rolfe	罗尔夫
Chenery	切纳里
Niff	尼夫
Flaherty	弗莱厄蒂
Gotwals	戈特沃尔斯
Nokes	努克斯
Sassman	萨斯曼
Damadian	达马迪安
Youngwood	扬伍德
Chiarucci	基亚鲁奇
Hawksley	霍克斯利
Askanas	阿斯卡纳斯
Ottley	奥特利
Craigie	克雷吉
Wodell	沃德尔
Thuermer	瑟默
Delakas	德拉卡斯
Sidders	西德斯
Hange	汉格
Shergals	舍加尔斯
Begtrup	贝格特鲁普
Ulick	尤利克
Ambedkar	安贝德卡
Fokine	福金
Duquenoy	迪克努瓦
Hartshorne	哈茨霍恩
Pesch	佩施
Stosy	斯托西
Schultz	舒尔茨
Horst	霍斯特
Marjoribanks	马乔里班克斯
Drosdoff	德罗斯多夫
Portnoid	波特诺伊德
Torrijos	托里霍斯
Kircher	基尔舍
Stolzenbach	斯托曾巴赫
Curtiz	柯蒂兹
Jeger	杰格
Duberg	杜伯格
Parloff	帕洛夫
Madrid	马德里
Donn	唐
Criswell	克里斯韦尔
Dalinka	达林卡
Hollinshead	霍林斯黑德
Ketelbey	基特尔比
Gulliksen	格利克森
Wygant	威甘特
Boverie	博韦里
Everetts	埃弗里茨
Autin	奥廷
Rocke	罗克
Behle	贝利
Dillworth	迪尔沃思
Lorenzen	洛伦岑
Shapp	沙普
Dunglas	邓格拉斯
Dandi	丹迪
Dilhorne	迪尔霍恩
Allegra	阿利格拉
Wolk	沃尔克
Rottman	罗特曼
Nutt	纳特
Amshewitz	阿姆谢维茨
Rykwert	里克沃特
O'Farrell	奥法雷
Catubo	卡图博
Luening	吕宁
Turkin	图尔金
Newrick	纽里克
Thierry	蒂里
Gaultney	高尔特尼
Barlas	巴拉斯
Ebby	埃比
Intosh	英托什
Robinett	罗比内特
Aspden	阿斯普登
Josee	约瑟
Worsnip	沃斯尼普
Eiberger	艾伯格
Bloss	布洛斯
Shriber	施里伯
Camil	卡米尔
Meislahn	迈斯拉恩
Gunnarsson	冈纳森
Ballantyne	巴兰坦
Derbyl	德比尔
Lionel	莱昂内尔
Gellner	盖尔纳
Doliver	多利弗
Bakes	贝克斯
Maximillian	马克西米利安
Sensenich	森塞尼奇
Hahnert	哈纳特
Biberman	比伯曼
Sexauer	塞克索尔
Bisplinghoff	比斯普林霍夫
Garlock	加洛克
Gowing	高英
Trusela	特鲁塞拉
Ceto	塞托
Speltz	斯佩尔茨
Longman	朗曼
Hunnicutt	亨尼克特
Benne	贝恩
Coes	库斯
Skuce	斯丘斯
Schoeneman	舍尼曼
Foulke	福克
Veness	维内斯
Muse	缪斯
Raskob	拉斯科布
DiRita	迪里塔
Marshall	马歇尔
Hawixbrock	哈维克斯布罗克
Goonhilly	贡希利
Yarburgh	亚伯勒
Haltiwanger	霍尔蒂万格
Saxbe	萨克斯比
Harriel	哈丽尔
Parran	帕伦
Tischler	蒂施勒
Hakola	哈科拉
Hershberg	赫什伯格
Isai	伊赛
Queen	奎因
Sessel	塞斯尔
Nionakis	尼奥纳基斯
McCash	麦卡什
Sewall	休厄尔
Leverich	莱弗里奇
Fairmaner	费尔曼纳
Hambidge	汉比奇
Hodgkinson	霍奇金森
Codd	科德
Cleland	克莱兰
Rocio	罗西奥
Bilder	比尔德
Core	科尔
Fourney	福尼
Tomalia	托马利亚
Riddiford	里迪福德
McCadden	麦卡登
Fyles	法伊尔斯
Charry	查里
Edholm	埃德霍尔姆
Bourdeau	布尔多
Merlo	默洛
Greenwood	格林伍德
Lackland	拉克兰
Alciphron	阿尔西弗龙
Turberville	特伯维尔
Bankes	班克斯
Dunagan	杜纳根
Tracey	特蕾西
Texeira	特谢拉
Giauque	吉奥克
Greenstock	格林斯托克
Kurtis	柯蒂斯
Oursler	奥斯勒
Enid	伊妮德
Searjeant	瑟金特
Laging	莱金
Guerrero	格雷罗
Arens	阿伦斯
Monell	莫内尔
Hogland	霍格兰
Lees	利斯
Chrisman	克里斯曼
Roose	鲁斯
Schonberg	舍恩伯格
Morrissey	莫里西
Mitseff	米采夫
Yeaple	耶普尔
Fanger	范杰
Jeshua	杰舒亚
Blanchan	布兰昌
Brustad	布鲁斯塔德
Ripple	里普尔
Haldimand	哈尔迪曼德
Guilliams	吉利亚姆
Busler	巴斯勒
Dodge	道奇
Macneilage	麦克尼利奇
Melia	米利亚
Dobbin	多宾
Sween	斯温
Freireich	弗赖雷克
Raeder	雷德
Ziering	齐林
Hesba	赫斯巴
Karney	卡尼
Feake	费克
Rominger	罗明杰
Gomezplata	戈梅斯普拉塔
Mannino	曼尼诺
Ham	哈姆
Bourgeois	布儒瓦
Kielty	基尔蒂
Haberlie	哈伯利
Eikenberry	艾肯伯里
Zora	佐拉
Antoniou	安东尼乌
Olivarez	奥利瓦雷斯
Roybal	罗伊鲍尔
Bushueff	布舒夫
Giesking	吉斯金
Sagittarius	萨吉泰里厄斯
Meyerhof	迈耶霍夫
Beek	贝克
Fuoss	富斯
Twidell	特威德尔
Genta	金塔
Katz	卡茨
Baigent	贝金特
Wilmot	威尔莫特
Buckmaster	巴克马斯特
Renouard	伦瓦尔
Heelas	希勒斯
Caldcleugh	考尔德克拉夫
Botwright	博特赖特
Clague	克莱格
Dickler	迪克勒
Jacyna	杰西纳
Guidry	吉德里
Heindel	海因德尔
Purse	珀斯
Chesshyre	切斯希尔
Mosso	莫索
Kozak	科扎克
Caridakis	卡里达基斯
Bobroff	博布罗夫
Lounsburg	劳恩斯伯格
Reiter	赖特
Brechin	布里金
Greiman	格雷曼
Gooderham	古德哈姆
Horrabin	霍拉宾
Yager	耶格尔
Balne	鲍恩
Herge	赫奇
Sundborg	森德伯格
Heup	霍伊普
Dickstein	迪克斯坦
Fulham	富勒姆
Grusinde	格鲁辛德
Borsook	博苏克
Sheemanna	希曼纳
MacNeil	麦克尼尔
Schreyer	施赖尔
Hetty	赫蒂
Zischke	齐施克
Engelhardt	恩格尔哈特
Vokov	沃科夫
Dardis	达迪斯
Ardcharnich	阿德查尼克
Spittel	斯皮特尔
Bedillion	贝迪利翁
Smyth	史密斯
Rideout	赖德奥特
Mcauslan	麦考斯伦
Nithsdale	尼斯代尔
Peatross	皮特罗斯
Gerow	杰罗
Zatkoff	扎特科夫
McKarness	麦卡尼斯
Currie	柯里
Bernardo	伯纳多
Blurton	布勒顿
Matteo	马泰奥
Sjogren	肖格伦
Keven	凯文
Jopling	乔普林
Megaro	梅加罗
Crosse	克罗斯
Whiston	惠斯顿
Nelvis	内尔维斯
Lindsay	林赛
Dorothy	多萝西
Staub	斯托布
Stubbing	斯图宾
Alverson	阿尔弗森
Dullforce	达尔福斯
Fibiger	菲比格
Bulbrook	布尔布鲁克
Embree	恩布里
Condit	康迪特
Solotesz	索尔特斯
Kampschror	坎普施罗尔
Bumstead	巴姆斯特德
Nacht	纳赫特
Templar	坦普勒
Len	莱恩
Desmarteau	德马尔托
Gravatt	格拉瓦特
Grogan	格罗根
Horn	霍恩
Federico	费德里科
Duberstein	杜伯斯坦
Maguirel	马圭雷尔
Hosie	霍西
Davids	戴维兹
McCarther	麦卡瑟
Trethaway	特雷撒韦
Easlick	伊斯利克
Shairp	谢普
Greider	格雷德
Birdsell	伯塞尔
More	莫尔
Kolodner	科洛德纳
Deval	德瓦尔
Cullwick	卡尔威克
Macquarrie	麦夸里
Hardgrave	哈德格雷夫
Denfield	登菲尔德
Mellor	梅勒
Pinchback	平奇巴克
Preacher	普里彻
Thorndike	桑代克
Marsham	马香
Chelnek	切尔内克
Bullitt	布利特
Oberhelman	奥伯黑尔曼
Donehue	多尼休
Hubert	休伯特
Brusca	布鲁斯卡
Hennelly	亨内利
Patriach	佩特里亚克
Bardo	巴多
Leisz	莱什
Heinemann	海涅曼
Chenies	切尼斯
Richards	理查兹
Eytchison	艾奇逊
Heddleston	赫德尔斯顿
Briant	布赖恩特
Zobell	佐贝尔
Corfiato	科菲亚托
Madocus	马多克斯
Bruns	布伦斯
Kohak	科哈克
Dannreuther	丹罗伊特
Fascell	法塞尔
Barnebey	巴恩贝
Marin	马林
Melinda	梅琳达
Frenzer	弗伦策
Titland	蒂特兰
Ayers	艾尔斯
Philpott	菲尔波特
Council	康斯尔
Sheinbaum	欣鲍姆
Tyree	泰里
Szanton	桑顿
Fabrick	法布里克
Wynter	温特
Frorer	弗罗勒
Kinnicutt	金尼卡特
Trioleau	特里奥洛
Goldborough	戈德伯勒
Ohlson	奥尔森
Crozier	克罗泽
Waranius	瓦拉尼厄斯
Hermaniuk	赫马纽克
Drucker	德鲁克
Makous	马库斯
Hummert	赫默特
Vaeth	韦思
Modarelli	莫达雷利
Marblestone	马布尔斯通
Meysey	梅西
Razeen	拉津
Hicky	希基
Camila	卡米拉
Cresson	克雷森
Elwane	埃尔温
Gough	高夫
Mulkey	马尔基
Fitzsimons	菲茨西蒙斯
Battagel	巴塔杰尔
Earwaker	埃厄克
Coca	科卡
Grindal	格林德尔
Chesnut	切斯纳特
MacLysaght	麦克莱萨特
Beckstedt	贝克施泰特
Burman	伯曼
Bonnyman	邦尼曼
Koroscil	科罗西尔
Sevringhaus	塞夫林豪斯
Jacottet	贾科泰
Linthwaite	林思韦特
Armigil	阿米吉尔
Fuccillo	富奇洛
Borek	博雷克
Wottle	沃特尔
Ormonde	奥蒙德
Pyddoke	皮多克
Brealey	布里厄利
Maco'Shannaig	麦科尚奈格
Edelsack	埃德尔萨克
Fasick	法西克
Meers	米尔斯
Rabinowitz	拉比诺维茨
Tomblings	汤布林斯
Machtinger	马赫廷格
Tristrem	特里斯特雷姆
Ippolito	伊波利托
Nenneman	南尼曼
Hebald	赫博尔德
Greenbacker	格林巴克
Carnock	卡诺克
Mabe	梅布
Conger	康格
Gillenwater	吉伦沃特
Arbell	阿贝尔
Koernig	凯尼格
Ismael	伊斯梅尔
Ogden	奥格登
Mamet	马梅特
Cuthell	卡瑟尔
Bohmont	博蒙特
Noam	诺姆
Dewees	德威斯
Latvala	拉特瓦拉
Sandum	桑德姆
Orinda	奥林达
Heshel	赫谢尔
Gershenson	格申森
Stalling	斯托林
Kitzhaber	基察伯
Eddey	埃迪
Beltman	贝尔特曼
Brazier	布雷热
Smialek	斯米亚利克
Anastasius	阿纳斯塔修斯
Minton	明顿
Phinney	菲尼
Rivet	里韦特
Tell	特尔
Brockhouse	布罗克豪斯
Parsley	帕斯利
Alday	阿尔迪
Dring	德林
Amandus	阿曼达斯
McTarnahan	麦克塔纳汉
Halloran	哈洛伦
Kiebler	基布勒
Synar	西纳尔
Creese	克里斯
Newens	纽恩斯
Concholar	康科勒
Copson	科普森
Luna	卢纳
Dunalley	达纳利
Beyers	拜尔斯
Schram	施拉姆
Morehart	莫尔哈特
Antipa	安蒂帕
Pertinax	珀蒂纳克斯
Peterson	彼得森
Mertzke	默茨克
Muckerman	马克曼
Gerhardi	格哈迪
Deleo	德利奥
Serfaty	瑟法蒂
Hessels	赫塞尔斯
Scheuler	朔伊勒
Truman	杜鲁门
Whelan	惠兰
Riscassi	里斯卡西
Jerrod	杰罗德
Dachi	达基
Marianne	玛丽安娜
Gorder	戈德
Sedgwick	塞奇威克
Sponholz	斯庞霍尔兹
Deo	德奥
Kitchener	基奇纳
Dunfey	邓菲
Elbin	埃尔宾
Dews	迪尤斯
Rathe	雷思
Kabler	卡布勒
Halbach	哈尔巴赫
Goldwyn	戈尔德温
Galil	加利尔
Rurt	鲁尔特
Higbee	希格比
Hurleigh	赫尔利
Gabbitas	加比塔斯
Fenning	芬宁
Stoner	斯托纳
McMath	麦克马思
Mortimer	莫蒂默
Kronenberg	克罗嫩伯格
Ouston	奥斯顿
Rendall	伦德尔
Fogerty	福格蒂
Hadleman	哈德尔曼
Crichton	克赖顿
Mofsky	莫夫斯基
Gwynedd	格威内思
Clem	克莱姆
Trottier	特罗蒂尔
Brodkin	布罗德金
Douie	杜伊
Polis	波利斯
Whyte	怀特
Nechols	尼科尔斯
Kealy	基利
Cawte	考特
Natal	纳塔尔
Rennie	伦尼
Womeldorph	沃梅尔多夫
Gant	甘特
Cuyler	凯勒
Bouchey	布谢
Powels	鲍威尔斯
Grinling	格林林
Tanenhaus	塔嫩豪斯
Rorem	罗勒姆
Muncey	芒西
DeNiro	德尼罗
Vautier	沃捷
Isaacs	艾萨克斯
Figi	菲吉
Andrieux	安德里厄
Alleine	阿林
Becker	贝克尔
Beckham	贝克姆
Nachmanoff	纳赫马诺夫
Ashlock	阿什洛克
Wysocki	维索茨基
Cony	科尼
Sterndale	斯滕代尔
Jesup	杰瑟普
Duecker	迪克
Swartz	斯沃茨
Ehrig	埃里格
Bever	贝弗
Wollman	沃尔曼
Halliburton	哈利伯顿
Zachmann	扎克曼
Eilbracht	艾尔布拉赫特
Hyslop	希斯洛普
Smallpeice	斯莫尔皮斯
Henie	赫尼
Gicovate	吉科瓦特
Kneil	尼尔
Fess	费斯
Pirie	皮里
Norlund	诺伦德
Surridge	瑟里奇
Braudy	布劳迪
Riffle	里弗尔
Sitton	西顿
Branner	布兰纳
Dew	迪尤
Grumbly	格伦布利
Falast	法拉斯特
Donsia	唐西亚
Rosenkrantz	罗森克兰茨
Fincher	芬彻
Kolb	科尔布
Ducrow	迪克罗
Greganti	格雷甘蒂
Walk	沃克
Giro	吉罗
Walker	沃克
Masius	马修斯
Barrios	巴里奥斯
Farfaglia	法法利亚
Bowdon	鲍登
Madison	麦迪逊
Lehner	莱纳
McCollam	麦科勒姆
McCain	麦凯恩
Dergracht	德格拉赫特
Myerburg	迈尔伯格
McLucas	麦克卢卡斯
Standaloft	斯坦德洛夫特
Sievwright	西夫赖特
Gemmell	格默尔
Medlin	梅德林
Ercklentz	厄克伦茨
Lyons	莱昂斯
Dvorchak	德沃夏克
Hennggeler	亨格勒
Fabricant	法布里坎特
Milmore	米尔莫尔
Elkus	埃尔克斯
Coughran	库格伦
Docktor	多克托
Fraunces	弗朗西斯
Filene	法林
Wilcocks	威尔科克斯
Dinkin	丁金
Beard	比尔德
Weathersby	韦瑟斯比
Macquarry	麦夸里
Scholle	肖勒
Bagot	巴戈特
Lull	勒尔
Chakiris	查基里斯
Shields	希尔兹
Hafner	哈夫纳
Feennell	芬内尔
Kleiler	克莱勒
Sigley	西格利
Schindell	欣德尔
Keaton	基顿
Motley	莫特利
Ellithorp	埃利索普
Evershed	埃弗谢德
Pickup	皮卡普
Semenza	西门扎
Malash	马拉什
Hasenfus	哈森弗斯
Tominson	托明森
Delphin	德尔芬
Garthoff	加特霍夫
Ansary	安萨里
Adger	阿杰
Tixier	蒂克西尔
Cheyenne	夏恩
Walrath	沃尔拉思
Blinken	布林肯
Avrett	阿夫里特
Petrone	佩特龙
Evitt	埃维特
Coxe	考克斯
Philos	菲洛斯
Berwald	伯沃尔德
Brebner	布雷布纳
Gracie	格雷西
Grisanti	格里桑迪
Cormack	科马克
Berdan	伯丹
Meekins	米金斯
Login	洛金
Bryanna	布里安娜
Sober	索伯
Mares	马雷斯
Tiedemann	蒂德曼
Mapes	梅普斯
Gussman	古斯曼
Pounteney	庞特尼
Aneirin	阿内林
Lesly	莱斯利
Tamia	塔米娅
Fynmore	芬莫尔
Schwendeman	施文德曼
Granquist	格兰奎斯特
Roubik	鲁比克
Gownley	高恩利
Bordash	博达什
Picarda	皮卡达
Casasent	卡萨森特
Laubengayer	劳本盖耶
Arturous	阿图罗斯
Finkle	芬克尔
Blankenbaker	布兰肯贝克
Ademola	阿德莫拉
Maiman	梅曼
Boothman	布思曼
Larabee	拉勒比
Pennant	彭南特
Eskandarian	伊斯坎达里安
Zwolinski	兹沃林斯基
Hodgkin	霍奇金
Giallorenzi	贾洛伦齐
Bosch	博施
Gager	盖杰
Baylen	贝伦
Bary	巴里
Themudo	塞穆多
Sloop	斯卢普
Reyner	雷纳
Colquitt	科尔基特
Monmonier	蒙莫尼尔
Mansker	曼斯克
Kibbin	基宾
Dushman	杜什曼
Basart	巴萨特
Redstone	雷德斯通
Bitondo	比顿多
Eadbald	埃德博尔德
Snitow	斯尼托
Chanen	查嫩
Spangler	斯潘格勒
Seib	塞布
Bessone	贝森
Monk	蒙克
Kesey	凯西
Thaler	塞勒
Saikowski	赛科夫斯基
Segrave	西格雷夫
Suirdale	舍代尔
Burn	伯恩
Cavenagh	卡夫纳
Clavering	克拉弗林
Giffard	吉法德
Hamor	哈默
Bosomworth	博索姆沃思
Buchmann	布克曼
Burnim	伯尼姆
Puppe	普珀
Mollenhoff	莫伦霍夫
Carstensen	卡斯滕森
Schmid	施密德
Campos	坎波斯
Merwin	默温
Tarmugl	塔穆格尔
Haire	海尔
Mcannally	麦坎纳利
Brassell	布拉塞尔
Hakewill	黑克威尔
Gonzalez	冈萨雷斯
Inglefield	英格尔菲尔德
Mona	莫娜
Grainne	格兰妮
Bryholdt	布赖霍尔特
Bovino	博维诺
Zwerdling	兹沃德林
Pretty	普雷蒂
Starbuck	斯塔巴克
Trueheart	特鲁哈特
Reister	赖斯特
Bradstreet	布拉德斯特里特
Jeton	杰顿
Bisson	比森
Fieberger	菲伯格
Burgmann	伯格曼
Cumish	卡米什
Macstiofain	麦克斯蒂奥芬
Craufurd	克劳弗德
Molinelli	莫利内利
Klopfer	克洛普弗
Yette	耶特
Shimeon	希米恩
Finkl	芬克尔
Gahn	加恩
Yarymovych	雅里莫维奇
Grunert	格鲁纳特
Denniston	丹尼斯顿
Senior	西尼尔
Hartsid	哈齐德
Stoeckel	斯托克尔
Boisragon	博勒根
Rebut	雷巴特
Cahners	卡纳斯
Folts	福尔茨
Metropolis	梅特罗波利斯
Saussure	索热尔
Cauley	考利
Ferebee	费尔比
Jewett	朱伊特
Llangattock	兰加托克
Argyros	阿吉罗斯
Coxon	考克森
Scrutator	斯克鲁泰特
Griser	格赖泽
Levings	莱文斯
Hazelip	黑兹利普
Blanscet	布兰西特
Bowie	鲍伊
Hargrave	哈格雷夫
Deven	德文
Gervers	杰弗斯
Spertzel	斯珀策尔
Boale	博尔
Bartosh	巴托什
Proud	普劳德
Booley	布利
Prestopino	普雷斯托皮诺
Rollock	罗洛克
Berania	贝拉尼亚
Draffan	德拉芬
Goldsymon	戈德西蒙
Allbeck	奥尔贝克
Leining	莱宁
Witman	威特曼
Schuerholz	许霍尔茨
Showkeir	肖基尔
Stancliffe	斯坦克利夫
Wichser	威克瑟
Aroni	阿罗尼
Tewwell	图韦尔
Arrow	阿罗
Kohlhepp	科尔黑普
Freling	弗雷林
Fusco	富斯科
Dortignac	多蒂尼亚克
Bodd	博德
Henahan	赫纳汉
Gerrish	格里什
Guizar	吉扎
Longwell	朗韦尔
Scouler	斯库勒
Scotton	斯科顿
Boateng	博滕
Everhart	埃弗哈特
Eddington	埃丁顿
Ruocco	罗科
Duckworth	达克沃思
Pattenson	帕滕森
Barzilay	巴尔齐莱
Ganor	加诺
Walgren	沃尔格伦
Baldeschwieler	巴尔德施维勒
Bourland	布兰
Slonim	斯洛宁
Martha	玛莎
Forness	福尼斯
Bauduin	鲍德温
Litzenberger	利曾伯格
Castellain	卡斯特兰
Perseck	佩塞克
Viron	瓦伊伦
Pirsson	皮尔逊
Soults	肖尔茨
Cheatham	奇塔姆
Josias	乔赛亚斯
Evvard	埃瓦德
Gerould	杰罗尔德
Jaegher	耶格
Rend	伦德
Pick	皮克
Gasking	加斯金
Herreshoff	赫雷斯霍夫
Arram	阿拉姆
Gaver	盖弗
Defree	德弗里
Profitt	普罗菲特
McGhee	麦吉
Milbank	米尔班克
Sirkin	西尔金
Conomy	科诺米
Pipe	派普
Macmartin	麦克马丁
Goff	戈夫
Curran	柯伦
Valenzuela	巴伦苏埃拉
Guist	吉斯特
Showers	肖沃斯
Bailiff	贝利夫
Benninghoff	本宁霍夫
Delargy	德拉吉
Wadey	韦迪
Agwu	阿古
Flux	弗勒克斯
Cousley	库斯利
Truby	特鲁比
Sohler	索莱尔
Gosden	戈斯登
Hinch	欣奇
Pagano	帕加诺
Mol	莫尔
Troubridge	特鲁布里奇
Kahane	卡亨
Goodding	古丁
Atkielski	阿特基尔斯基
Adamnan	阿达姆南
Creeden	克里登
Hindman	欣德曼
Antrim	安特里姆
Pakiser	帕基泽
Cassillis	卡西利斯
Wellwood	韦尔伍德
Linn	林
Driker	德里克
Richard	理查德
Robertson	罗伯逊
Delacour	德拉库尔
Dakan	达坎
Gitsham	吉彻姆
Keel	基尔
Poepoe	波波
Liveoak	莱夫奥克
Vanderhoof	范德胡夫
Prusman	普拉斯曼
Keifer	凯弗
Gehan	吉亨
Schnukne	施努克内
Mager	马杰
Argall	阿高尔
Bettenberg	贝滕伯格
Belfield	贝尔菲尔德
Beuttler	博伊特勒
Wennerstrum	温纳斯特鲁姆
Lundahl	伦达尔
Cable	凯布尔
Luedecke	利迪克
Jordre	乔德尔
Pluenneke	普伦尼克
Hirschtritt	赫什特里特
Bukatzsch	布卡奇
Welkener	韦尔克纳
Berard	贝拉尔
Ovard	奥瓦德
Rubino	鲁比诺
Culpeper	卡尔佩珀
Pickles	皮克尔斯
Palfry	帕尔弗里
Copley	科普利
Toler	托勒
Shayna	谢娜
Hennigan	亨尼根
Teddlie	特德利
Wigham	威格姆
Mulvenon	马尔韦农
Lamarr	拉马尔
Gurtov	格托夫
Downing	唐宁
Florenz	弗洛伦兹
Calloway	卡洛韦
Battram	巴特拉姆
Mcguinty	麦金蒂
Piper	派珀
Kalish	卡利什
Astwood	阿斯特伍德
Swanborough	斯旺伯勒
Avondale	埃文代尔
Grisogonia	格丽索戈尼娅
Depauw	德波
Yarbro	亚布罗
McEvers	麦克弗斯
Cook	库克
Rosebrough	罗斯伯勒
Drakert	德雷克特
Annise	安妮斯
Grower	格罗尔
Howsam	豪萨姆
Kaminski	卡明斯基
Hauger	豪格
Coffeen	科芬
Blythe	布莱思
Dooling	杜林
Hemstreet	赫姆斯特里特
Blackman	布莱克曼
Myburgh	迈伯勒
Dworkin	德沃金
Attlesey	阿特莱西
Gagnebin	加涅班
Hackshaw	哈克肖
Acres	阿克斯
Freehling	弗里林
Gatewood	盖特伍德
Saltzman	萨尔茨曼
Howe	豪
Dallenback	达伦巴克
Blechschmidt	布莱希施米特
Herwitz	赫威茨
Mains	梅因斯
Kland	克兰
Blouke	布劳克
Memminger	梅明杰
Molinaro	莫利纳罗
Breslin	布雷斯林
Matarazzo	马塔拉佐
Heavey	希维
Dreiske	德赖斯克
Tosches	托希斯
Laude	劳德
Marmaduke	马默杜克
Wedgewood	韦奇伍德
Armidale	阿米代尔
Foskett	福斯克特
Wolverson	沃尔弗森
Axelrod	阿克塞尔罗德
Fabris	法布里斯
Appleton	阿普尔顿
Preil	普里尔
Adcock	阿德科克
Biroum	比鲁姆
Dekkers	德克斯
Wylie	怀利
Bayuk	贝尤克
Corneiro	科内罗
Lim	利姆
Robards	罗巴兹
Crouse	克劳斯
Garin	加林
Quillen	奎林
Towers	托尔斯
Stokvis	斯托克维斯
Niessen	尼森
Villari	维拉里
Gruene	格伦
Kerlan	克兰
Quadro	夸德罗
Beth	贝丝
Byrholdt	伯霍尔特
Provencher	普罗文彻
Yohe	约埃
Engfer	恩弗
Yatron	亚特隆
Skym	斯基姆
Happy	哈皮
Gewartowski	格瓦尔托夫斯基
Shipman	希普曼
Warthen	沃森
Zeisler	蔡斯勒
Wissler	威斯勒
Eachard	伊查德
Siess	西斯
Buthlay	布思莱
Bliven	布利文
Clink	克林克
Angelina	安杰利娜
Gatschet	加切特
Minsch	明施
Brann	布兰
Alfidi	阿尔菲迪
Everson	埃弗森
Almony	阿尔莫尼
Riutta	里乌塔
Talley	塔利
Witteried	威特里德
Prunty	普朗蒂
Colsell	科尔塞尔
Putman	帕特曼
Girling	格林
Kovy	科维
Naughten	诺滕
Pinger	平格
Nevins	内文斯
MacNaughton	麦克诺顿
O'Gara	奥加拉
Fierst	菲尔斯特
O'Laughlin	奥劳克林
D'Ambrosio	丹布罗西奥
Mayoras	马约拉斯
Evelegh	伊夫利
Veysey	维齐
Stahl	斯塔尔
Pawlenty	波伦蒂
Larissa	拉丽莎
Baseman	贝斯曼
Guggenheimer	古根海默
Keck	凯克
Wollstonecraft	沃斯通克拉夫特
Oaksey	奥克西
O'Kane	奥凯恩
Favrot	法夫罗
Arman	阿尔曼
Sarazyn	萨拉津
Layla	莱拉
Burray	伯雷
Amiot	阿米奥特
Bedel	比德尔
Adney	埃德尼
Orpen	奥彭
Poock	普克
Bedau	贝多
Mollenauer	莫勒瑙尔
Skiles	斯基尔斯
Fenvessy	芬韦西
Goostree	古斯特里
Pach	帕克
Vassal	瓦萨尔
Sabin	萨宾
Nethersole	内瑟索尔
Harney	哈尼
Gelder	格尔德
Behlke	贝尔克
Urien	尤里安
Niemann	尼曼
Southern	萨瑟恩
Pepiot	佩皮奥特
Nottage	诺蒂奇
Bachar	巴卡尔
Floyd	弗洛伊德
Allbaugh	阿尔博
Fordham	福德姆
Gamet	加梅特
Kiness	基尼斯
Rettew	雷图
Schaefer	谢弗
Deligiorgis	德利乔治斯
Eisenhart	艾森哈特
Garel	加勒尔
Lahee	莱希
Ole	奥利
Budwine	布德温
Beeton	比顿
Dio	戴奥
Broelsch	布勒尔施
Dozer	多泽
Harbach	哈巴克
Savele	萨维尔
Vukota	武科塔
Nansen	南森
Rixson	里克森
Burt	伯特
Levie	利维
Groncki	格朗茨基
Brunk	布伦克
Garcon	加肯
Midlarsky	米德拉斯基
Ogsbury	奥格斯伯里
Erbe	厄布
Wormeley	沃姆利
Loughran	洛克伦
Schimler	席姆勒
Brutlag	布鲁特拉格
Romen	罗门
Efimenco	埃菲门科
Daemmrich	德姆里克
Scholderer	斯科德勒
Duby	达比
Ted	特德
Mizel	米泽尔
Beilby	比尔比
Rohter	罗特
Middaugh	米多
Boskind	博斯坎德
Peacock	皮科克
Surveyer	瑟维耶
Ahnee	阿尼
Coate	科特
Jakobi	雅各比
Binning	宾宁
Muille	缪尔
Tink	廷克
Nunemaker	努尼梅克
Lyell	莱尔
Anis	安妮斯
Brownback	布朗巴克
Levington	莱文顿
Ablin	埃布林
Bander	班德尔
Rossall	罗塞尔
Shad	沙德
Etcheson	艾奇逊
Fawssett	福西特
Kipling	基普林
Bigg	比格
Olave	奥拉夫
Krenn	克伦
Maufe	莫夫
Mavity	马维蒂
Arsdale	阿斯代尔
Guildford	吉尔福德
Sief	西夫
Giddy	吉迪
Aawick	阿威克
Agase	阿加丝
Atiyeh	阿提耶
Lenfant	朗方
Euphrosyne	尤弗罗西尼
Washbourne	沃什伯恩
Jeremiah	杰里迈亚
Ayerst	艾尔斯特
Reoch	里奥克
Ayala	阿亚拉
Calcagno	卡尔卡尼奥
Mainwaring	梅因沃林
Frankenberger	弗兰肯伯格
Petrides	佩特里迪斯
Hasson	哈森
Scarborough	斯卡伯勒
Corder	科德
Davern	达文
Rozanne	罗珊
Howley	豪利
Lorge	洛奇
Greenhow	格里诺
Glymour	格利穆尔
Hauschka	豪施卡
Gotshal	戈查尔
MacGillicuddy	麦吉利卡迪
Meryl	梅里尔
Weddell	韦德尔
Sligh	斯莱
Kenning	肯宁
Tilson	蒂尔森
Fain	费恩
Shays	谢斯
Elena	埃琳娜
Decook	德库克
Rolland	罗兰
Duwe	杜韦
Sherrill	谢里尔
Breder	布里德
Ekstract	埃克斯特拉克特
Broderick	布罗德里克
Cottroll	科特罗尔
Keedy	基迪
Savelle	萨维尔
McGahern	麦加亨
Leban	莱班
Winthrop	温思罗普
Muralt	缪拉尔持
Bakewell	贝克韦尔
Salome	萨洛米
Yanover	亚诺弗
Wilbern	威尔伯恩
McCutchen	麦卡琴
Moley	莫利
Likeman	莱克曼
Marisa	马里萨
Mollo	莫洛
Windrow	温德罗
Puner	普纳
Laval	拉瓦尔
Shauna	肖娜
Padelford	帕德尔福德
Ferrabosco	费拉博斯科
Kerruish	克鲁伊什
Shapar	沙帕尔
Boultinghouse	博尔廷豪斯
Lauinger	劳因格
Chatty	查蒂
Dohanian	多哈尼安
Hagner	哈格纳
Honess	霍尼斯
Eugenia	尤金妮亚
Speidel	斯派德尔
Spurrier	斯珀里尔
Spear	斯皮尔
Diefendorf	迪芬多夫
Medwadowski	梅德瓦多夫斯基
Fleetwood	弗利特伍德
Hieatt	海厄特
Fites	菲茨
Cogdell	科格德尔
Mandy	曼迪
Heap	希普
Triebwasser	特里布沃瑟
Whitchliffe	惠特克利夫
Gurtin	格廷
Carlisle	卡莱尔
Noland	诺兰
Giuffrida	朱弗里达
Auberger	奥伯格
Ritcher	里彻
Diarmid	迪尔米德
Cobis	科比斯
Britten	布里滕
Wison	威森
Hufstader	赫夫斯塔德
Letica	莱蒂卡
Dechert	德克特
Oriolda	奥丽奥尔达
Feuer	福伊尔
Embling	恩布林
Loveden	洛夫登
Olive	奥利芙
Dunnachie	邓纳基
Deveney	迪夫尼
Erchebald	厄奇博尔德
Gorski	戈尔斯基
Stroud	斯特劳德
Lasby	拉斯比
Heimsoth	海姆塞特
Sallick	萨利克
Boccadi	博卡迪
Comstock	科姆斯托克
Verdery	维德里
Hibbard	希巴德
Cosmo	科斯莫
Hewish	休伊什
Geistfeld	盖斯特费尔德
Egbert	埃格伯特
Witney	威特尼
Castner	卡斯特纳
Taliaferro	托利弗
Bramante	布拉曼特
Tytler	泰特勒
Wilhide	威尔海德
Mursell	默塞尔
Eddowes	埃多斯
Eborall	埃博拉尔
Whyman	怀曼
Lycett	莱西特
Peer	皮尔
Lygon	利根
Oleksiw	奥莱克休
Whytehead	怀特黑德
Allez	阿莱
Saxer	萨克瑟
Aronin	阿罗宁
Cadwaladyr	卡德瓦拉德
Rideal	里迪尔
Willum	威勒姆
Sulwen	西尔温
Shadel	沙德尔
Hambley	汉布利
Flatt	弗拉特
Chalstrey	查尔斯特里
Tancreto	坦克雷托
Bonavita	博纳维塔
Weddle	韦德尔
Leesman	利斯曼
Baroff	巴罗夫
Oliverson	奥利弗森
Bovard	博瓦德
Fadyean	法迪恩
Berklund	伯克伦
Degenford	德根福德
Shuter	舒特
Ker	克尔
Bisat	比萨特
Ellerker	埃勒克
Drennen	德雷宁
Decher	德谢尔
Heist	海斯特
Morr	莫尔
Buttram	巴特拉姆
Casillas	卡西拉斯
Cockren	科克伦
Walde	沃尔德
Mackoul	麦考尔
Pulteney	普尔特尼
Truzzi	特拉齐
Abdian	阿布迪恩
Sconyers	斯科尼尔斯
Steinfeld	斯坦菲尔德
Batte	巴特
Sosman	索斯曼
Montemoreno	蒙特莫雷诺
Tori	托丽
Awdrey	奥德里
Fuller	富勒
Greensword	格林斯沃德
Henley	亨利
Apsley	阿普斯利
Carrillo	卡里略
Teagle	蒂格尔
Beeby	毕比
Bolen	博伦
Marthena	马塞纳
Genesen	吉尼森
MacIntosh	麦金托什
Nouza	努扎
Cali	卡利
Pollan	波伦
Hering	赫林
Gaitenbein	盖滕宾
Mezera	梅泽拉
Varmus	瓦默斯
Shackell	沙克尔