O'Niel	奥尼尔
Meadow	梅多
Halfon	哈尔丰
Flaum	弗劳姆
Gorvin	戈文
O'Brine	奥布兰
Clucas	克卢卡斯
Schaetzel	谢策尔
Brovarsky	布罗瓦尔斯基
Ismene	伊斯梅娜
Selb	塞尔布
Byers	拜尔斯
Abourezk	阿布雷兹克
Joakson	乔克森
McCormick	麦考密克
Chermayeff	切尔马耶夫
Edington	埃丁顿
Moorefield	穆尔菲尔德
Crousaz	克劳萨斯
Quester	奎斯特
Durenberger	达伦伯杰
Dix	迪克斯
Pucciarelli	普恰雷利
Popeski	波佩斯基
Amia	埃米娅
Sorini	索里尼
Burde	伯德
Romeu	罗梅乌
Brois	布罗伊斯
Mitze	米策
Sixpence	西克斯彭斯
Baczynski	巴钦斯基
Salomon	萨洛蒙
Trowbridge	特罗布里奇
Branstad	布兰斯塔德
Jakosky	贾科斯基
Eckhardt	埃克哈特
Norwood	诺伍德
Jeames	杰姆斯
Marti	马蒂
Fogelson	福格尔森
Timperley	廷珀利
Call	考尔
Donnelly	唐纳利
Filippi	菲利皮
Besse	贝西
Petre	彼得
Gatherum	盖思勒姆
Leathers	莱瑟斯
Brianus	布赖纳斯
Walster	沃尔斯特
Dellinger	德林杰
Weins	温斯
Crombie	克龙比
Redecker	雷德克
Stuchbury	斯塔奇伯里
Donkin	唐金
Kendricks	肯德里克斯
Leaken	利肯
Gottwald	戈特瓦尔德
Witham	威瑟姆
Paster	帕斯特
Eppner	埃普纳
Heaf	希夫
Dibley	迪布利
Hultz	赫尔茨
Grigson	格里格森
Gesteland	格斯特兰
Macnaghten	麦克诺滕
Sisson	西森
Bernandine	伯南丁
Whittmayer	惠特迈耶
Blakefield	布莱克菲尔德
Dungarvan	邓加文
Zoellick	佐利克
Cowing	考因
Stockham	斯托克姆
Althea	奥尔西娅
Stulak	斯图拉克
Steele	斯蒂尔
Starry	斯塔里
Bucklin	巴克林
Sheatsley	希茨利
Marakas	马拉卡斯
Deffigos	德菲戈斯
Gore	戈尔
Coveny	科文尼
Holroyd	霍尔罗伊德
Rowson	罗森
McAnally	麦卡纳利
Demonte	德蒙特
Zubieta	苏维塔
Graph	格拉夫
Skene	斯基恩
Chain	钱恩
Northbrook	诺思布鲁克
Minshall	明歇尔
Wolpe	沃尔普
Cromelin	克罗姆林
Becket	贝克特
Balmette	巴尔梅特
Galileo	加利莱奥
Abbado	阿巴多
Junior	朱尼尔
Sitrin	西特林
Nuske	纳斯克
Walkerdine	沃克丁
Hayhoe	海霍
Greenler	格林勒
Seabright	西布赖特
Zenoff	泽诺夫
Harrill	哈里尔
Oedipus	奥迪珀斯
Crocombe	克罗科姆
Freney	弗雷尼
Kirkman	柯克曼
Hakkinen	哈基宁
Siegman	西格曼
Baumer	鲍默
Seasholes	西肖尔斯
McHose	麦克霍斯
Conibear	科尼贝尔
Achtemeier	阿赫特迈耶
LaCerva	拉塞尔瓦
Brander	布兰德
Moire	莫蕾
Tyzzer	泰泽
Gabridge	加布里奇
Pott	波特
Schlendorf	施伦多夫
Strohm	斯特罗姆
Newbon	纽本
Lutener	卢特纳
Capasso	卡帕索
Imhof	英霍夫
Spoehr	斯波尔
Doreen	多琳
Durnbaugh	邓博
MacFarland	麦克法兰
Wagstyl	韦格斯蒂尔
Rowden	罗登
Isitt	艾西特
Narney	纳尼
Rabon	拉本
Chrowder	克劳德
Cavazos	卡瓦佐斯
Marovitz	马罗维茨
Cumerford	卡默福德
Jabbour	杰伯
Grassle	格拉斯尔
Acclestone	阿克尔斯通
Coplin	科普林
Spingold	斯平戈尔德
Heldenfels	赫尔登费尔斯
Dolier	多利埃
Tungay	滕盖
Rotty	罗蒂
McNichols	麦克尼科尔斯
Stutzman	斯塔茨曼
Lempra	伦普拉
Audioun	奥迪翁
Belongia	贝朗吉亚
Baekeland	贝克兰
Gounaris	古纳里斯
Upson	厄普森
Beaman	比曼
Easley	伊斯利
Langille	兰吉尔
Crillis	克里利斯
Ferer	费勒
Kandel	坎德尔
Stevenot	史蒂夫诺特
Landeck	兰德克
Ticciati	蒂恰蒂
Finer	芬纳
Jami	杰米
Quelle	奎尔
Elstob	埃尔斯托布
Stottlemyer	斯托特尔迈尔
Leveridge	莱弗里奇
Nirenberg	尼伦伯格
Wethered	韦瑟德
Labey	拉比
Riddleberger	里德尔伯格
Nickell	尼克尔
Carlotte	卡洛特
Ditmars	迪特马斯
Beery	比里
Broglie	布罗格利
Caesar	西泽
Shenkel	申克尔
Pant	潘特
Cobbett	科贝特
Menyuk	门尤克
Klinhoffer	克林霍弗
Nimes	尼姆斯
Diefenderfer	迪芬德弗
Mackenchnie	麦肯奇尼
Duchemin	杜舍明
Shalit	沙利特
McAlpin	麦卡尔平
Ender	恩德
Salote	萨洛特
Labonte	拉邦特
Pinder	平德
Lagemann	拉格曼
Landrum	兰德勒姆
Colecchia	科莱基亚
Macgilp	麦吉尔普
McClenahan	麦克莱纳汉
Duerr	杜尔
Alvarez	阿尔瓦雷斯
Momis	莫米斯
Lowles	洛莱斯
Mellish	梅利什
Trova	特罗瓦
Hamele	哈梅利
Gudeman	古德曼
Hoffheimer	霍夫海默
Stookey	斯图基
Achorn	埃科恩
Searell	西雷尔
Sandall	桑德尔
Way	韦
Herrold	赫罗尔德
McArtney	麦卡特尼
Mugridge	马格里奇
Wiggers	威格斯
Corneal	科尼尔
Bussie	伯西
Ruston	拉斯顿
Sorn	索恩
Arfa	阿尔法
Plymely	普利姆利
Ciment	西门特
Caulfield	考尔菲尔德
Ryeland	赖兰
Katzin	卡津
Cartledge	卡特利奇
Englund	英格伦
Krier	克里尔
Aldisert	奥尔迪泽特
Perrault	佩罗
Deeds	迪兹
Hoenmans	霍恩曼斯
Withers	威瑟斯
Corrothers	科罗瑟斯
Magad	马加德
Eacott	伊科特
Pusey	普西
Sperling	斯珀林
Guskin	古斯金
Carrasco	卡拉斯科
Stockder	斯托克德
Censits	森西茨
Bryde	布赖德
Moss	莫斯
Lauri	劳里
Milner	米尔纳
Weikell	韦克尔
Lightbody	莱特博迪
Morlen	莫伦
Riedman	里德曼
Zeps	泽普斯
Thwing	特温
Mowarin	莫韦林
Moncur	蒙克尔
Bayol	贝约尔
Regehr	雷格尔
Paquin	帕坎
Springle	斯普林格尔
Woulfe	沃尔夫
Melcio	梅尔西奥
Scheffer	谢弗
McPeak	麦克皮克
Nealis	尼利斯
Hughen	休恩
Uelses	尤尔塞斯
Biever	比弗
Auping	奥平
Hoctor	霍克特
Fonkalsrud	方卡尔斯鲁德
Priaulx	普里奥
Minix	米尼克斯
Starck	斯塔克
Exo	埃克索
Hessey	赫西
Lilburn	利尔伯恩
Chrysler	克莱斯勒
Chafer	蔡弗
Feibelman	费布尔曼
Fortescue	福蒂斯丘
Kamlesh	卡姆利什
Filgas	菲尔加斯
Eudaly	尤德利
Brayan	布赖恩
Stavert	斯塔弗特
Macivor	麦基弗
Alresford	奥尔斯福德
Norberg	诺伯格
Lingle	林格尔
Lessore	勒索尔
Schulgen	舒尔根
McElduff	麦克尔达夫
Abdiel	阿布迪尔
Fitzwilliam	菲茨威廉
Barcroft	巴克罗夫特
McNash	麦克纳什
Rozmarek	罗兹马雷克
Slye	斯莱
Chesluk	切斯勒克
Teagarden	蒂加登
Frascoia	弗拉斯科亚
Octavian	奥克塔文
Tress	特雷斯
Bishinger	比欣格
Hostler	霍斯勒
Timmerhaus	蒂默豪斯
Finlator	芬莱特
Felipa	费莉帕
Daiker	戴克
Grylls	格里尔斯
Burris	伯里斯
Caw	考
Knowlson	诺尔森
Dasent	达森特
Stucky	斯塔基
Kelakos	凯拉科斯
Cuppia	卡皮亚
Strain	斯特兰
Paulding	波尔丁
Skuse	斯丘斯
Stai	斯泰
Ephron	埃夫龙
Farmbrough	法恩伯勒
Sykes	赛克斯
Balcom	巴尔科姆
Migdal	米格德尔
Laking	莱金
Kirkendoll	柯肯多尔
Midleton	米德尔顿
Goldsbrough	戈兹布拉夫
Ruche	鲁什
Lautner	劳特纳
Turro	图罗
Wormsley	沃姆斯利
Vinaver	维纳弗
Dionisius	狄奥尼修斯
Fennebresque	芬内布雷斯克
Malloy	马洛伊
Summerford	萨默福德
Holmesdale	霍姆斯代尔
Juarez	华雷斯
Bing	宾
Liberty	利伯蒂
Kraemer	克雷默
Poppe	波普
Mohrhardt	莫尔哈特
Eckford	埃克福德
Infante	因方特
Bryson	布赖森
Cossar	科萨尔
Leland	利兰
Jarrell	贾雷尔
Loosley	卢斯利
Hankey	汉基
Levinger	莱文杰
Segars	西格斯
Lindauer	林道尔
Moorfield	穆尔菲尔德
Timpano	廷帕诺
Mied	米德
Highsaw	海索
Vorhauer	沃豪尔
Kanline	坎兰
Instone	因斯通
Mickenberg	米肯伯格
Battye	巴蒂
Vanderburg	范德堡
Hearson	赫森
Hammick	哈米克
Macindoe	麦金杜
Wyly	怀利
Trivaskis	特里瓦斯基斯
Swynnerton	斯温纳顿
Mindak	明达克
Roth	罗思
Verber	维伯
Friedl	弗里德尔
Polley	波利
Wickman	威克曼
Verel	维雷尔
Ramsdell	拉姆斯德尔
Efrem	埃弗雷姆
Herrin	赫林
Kempelman	肯普尔曼
Oley	奥利
Chmelik	赫梅利克
Pellerzi	佩勒齐
Pask	帕斯克
Kuenzel	金泽尔
Travess	特拉韦斯
Chesarek	切萨雷克
Nearing	尼尔林
Ketchen	凯琴
Sequoya	塞阔亚
Rathbun	拉思本
Galenson	加伦森
Morgenthaler	莫根塔勒
Aviado	阿维亚多
Pentreath	彭特里思
Andreasen	安德烈亚森
Levy	利维
Banscher	班舍
Cadge	卡奇
Burzynski	布尔津斯基
Bachus	巴克斯
Payton	佩顿
Giesen	吉森
Rude	鲁德
Fessenden	费森登
Lande	兰德
Burrell	伯勒尔
Yocam	约卡姆
Romanes	罗马尼斯
Clap	克拉普
Heppworth	赫普沃思
Frow	弗劳
Hudspeth	赫兹佩思
Dannenbaum	丹嫩鲍姆
Bignall	比格纳尔
Narramore	纳拉莫尔
Shipsey	希普西
Okonor	奥科纳
O'Grady	奥格雷迪
Southesk	索塞斯克
Viking	瓦伊金
Henslow	亨斯洛
Grossberg	格罗斯伯格
Stoneman	斯通曼
Tade	塔德
Ming	明
Acworth	阿克沃思
Tochen	托肯
Gessman	格斯曼
Buechle	比希勒
Kniffen	尼芬
Sach	塞奇
Caslon	卡斯隆
Musha	穆沙
Cedric	锡德里克
Kanner	坎纳
Mackerras	麦克拉斯
Chmurny	克默尼
Horsey	霍西
Chluski	赫卢斯基
Goeb	戈布
Boyea	博亚
Doxsee	多克西
Blackmar	布莱克默
Goodway	古德韦
Orrery	奥雷里
Dulai	杜莱
Macleverty	麦克莱弗蒂
Rubens	鲁宾斯
Beales	比尔斯
Nye	奈
Whiteford	怀特福德
Hedeman	赫德曼
Balram	巴尔拉姆
Chorin	乔林
Boys	博伊斯
Switzer	斯威策
Wisman	威斯曼
Saker	萨克尔
Palin	佩林
Goetzmann	戈茨曼
Siler	赛勒
Perutz	佩鲁茨
Ressets	雷塞茨
Ticknor	蒂克纳
Levey	利维
Deibler	戴布勒
Warkentin	沃肯廷
Huddleston	赫德尔斯顿
Odren	奥德伦
Evanbeck	伊万贝克
Ruml	拉姆尔
Patterson	帕特森
Hawkey	霍基
Mozley	莫兹利
Oxenberg	奥克森伯格
Wilcoxen	威尔科克森
Whitfill	惠特菲尔
Loshak	洛沙克
Graybiel	格雷比尔
Farre	法尔
Douch	杜奇
Melugin	梅卢金
Hedger	赫杰
Heinzerling	海因策林
Tonka	汤卡
Vedder	维德
Beutel	比特尔
Emont	埃蒙
Corrigan	科里根
McClary	麦克拉里
Meine	迈因
Goldis	戈迪斯
Baffin	巴芬
Lambertson	兰伯森
Gettys	格蒂斯
Bumiller	巴米勒
Bagshawe	巴格肖
McNeill	麦克尼尔
Nevil	内维尔
Jalyn	贾琳
Potts	波茨
Eichman	艾希曼
Seetz	西茨
Byane	拜恩
Sharrott	沙罗特
Guilbert	吉伯特
Grammer	格拉默
Goeler	戈勒
Spinks	斯平克斯
Pinchemain	平什曼
Verhovek	弗霍韦克
Nemeroff	内梅罗夫
Appolonia	阿波洛尼娅
Kamman	坎曼
Zolotow	佐洛托
Rippingale	里平格尔
Drohan	德罗安
Cooray	库雷
Chewning	丘宁
Miesenheimer	米森海默
Truly	特鲁利
Bridgewater	布里奇沃特
Rothesay	罗思赛
Fadeley	法德利
Lefrak	勒弗拉克
Ellard	埃拉德
Holzinger	霍尔津格
Phaneuf	法纳夫
Efendi	埃芬迪
Padwick	帕德威克
Valentia	瓦伦西亚
Holdsworth	霍尔兹沃思
LeMaitre	勒梅特
Weese	威斯
Dominy	多米尼
Helton	赫尔顿
Tie	泰伊
Callsen	卡尔森
Fuseli	菲尤泽利
Fitches	菲切斯
Reimert	赖默特
McEnchroe	麦肯赫罗
Geoffrey	杰弗里
Shantie	尚蒂
Sportsman	斯波茨曼
Yetka	耶特卡
Jonah	乔纳
Bocking	博金
Wiclif	威克利夫
Laverdiere	拉弗迪尔
Hilsman	希尔斯曼
Higgson	希格森
Benford	本福德
Worzel	沃泽尔
Collin	科林
Pakchar	帕克查尔
Stangboom	斯唐布姆
Sleigh	斯莱
Moysey	莫伊西
Derk	德克
Holbrow	霍尔布罗
Reichhard	赖克哈德
Sandilands	桑迪兰兹
Svenningsen	斯文宁森
Mirick	米里克
Rukeyser	鲁凯泽
Macguineas	麦吉尼亚斯
Jasper	贾斯珀
Climie	克莱米
Beeners	比纳斯
Dantin	丹廷
Palmen	帕尔门
Megley	梅格利
Dunson	邓森
Lesman	莱斯曼
Sendak	森达克
Wickes	威克斯
Armigel	阿米格尔
Ebert	埃伯特
Laroque	拉罗克
Daily	戴利
Dunscomb	邓斯库姆
Marcius	马修斯
Hirons	海伦斯
Schadeck	谢德克
Ink	英克
Grampp	格兰普
Romilly	罗米利
Wittwer	威特沃
Heyliger	海利格
Ansellus	安塞卢斯
Holwill	霍威尔
Lilley	利利
Touchy	塔奇
Simms	西姆斯
Dewerth	德沃思
Faiman	费曼
Cumberbeach	坎伯比奇
Blodget	布洛杰特
Markin	马金
Keene	基恩
Slatton	斯莱顿
Genereux	吉尼罗
Eamon	埃蒙
Oveta	奥维塔
Erlenmeyer	埃伦迈尔
Topf	托夫
Caldow	卡尔多
Dribben	德里本
Bellm	贝尔姆
Coppage	科皮奇
Yozwiak	约兹维亚克
Nurkse	纳克斯
Graul	格劳尔
Ezequiel	伊齐基尔
Nunzio	农西奥
Corbin	科尔宾
Spelling	斯佩林
Croosier	克鲁泽
Brodersen	布罗德森
Haas	哈斯
Twaddell	特沃德尔
Valtz	瓦尔茨
Broadmead	布罗德米德
Sinai	赛奈
Douall	道尔
Arenstein	阿伦斯坦
Blackstone	布莱克斯通
Tappas	塔帕斯
Liccini	利奇尼
Lotspeich	洛茨皮奇
Rickman	里克曼
Achibald	阿奇博尔德
Decies	德希斯
Ravelstein	拉韦尔斯坦
Eamer	伊默
Milic	米利克
Thornberry	索恩伯里
Carrington	卡林顿
Lonsdale	朗斯代尔
Ryno	赖诺
Perlez	珀莱兹
Gilfred	吉尔弗雷德
Molter	莫尔特
Stetz	斯特茨
Bitts	比茨
Onge	翁奇
Ceyelin	塞耶林
Notopoulos	诺托普洛斯
Koplik	科普利克
Carterette	卡特雷特
Biscop	比斯科普
Gyngell	金吉尔
Gleckman	格莱克曼
McAvoy	麦卡沃伊
Herrman	赫尔曼
Macinstalker	麦金斯托克
Weichel	韦克尔
Shulton	舒尔顿
Setser	塞策
Shenon	谢农
Wack	瓦克
Endre	恩德雷
Bles	布莱斯
Yorick	约里克
Halloway	哈洛韦
Tingleff	廷莱夫
Maltese	马尔特斯
Freestun	弗里斯顿
Aegerter	埃格特尔
Headen	黑登
Namias	纳米亚斯
Boe	博
Winnington	温宁顿
Berrigam	贝里格姆
Hertig	赫蒂希
Hilley	希利
Bless	布莱斯
Triplett	特里普利特
Ashcom	阿什科姆
Barraud	巴罗
Parmele	帕米利
Nemshick	内姆希克
Forrestal	福里斯特尔
Mulhollan	马尔霍兰
Roswell	罗斯韦尔
Hickerson	希克森
Zapapas	扎帕帕斯
Neef	尼夫
Cikins	赛金斯
Vigority	维戈里蒂
Purchese	珀奇斯
Sacks	萨克斯
Romero	罗梅罗
Drimmer	德里默
Cesca	塞斯卡
Cuddington	卡丁顿
Arwel	阿韦尔
Lebreton	勒布雷顿
Musselwhite	马塞尔怀特
Creasman	克里斯曼
Morpeth	莫佩思
Gattie	加蒂
Hallmark	霍尔马克
Wassenaar	瓦塞纳
Jarchow	雅霍夫
Daer	德尔
Adelmann	阿德尔曼
Meenan	米南
Beizer	贝泽
Cappon	卡彭
Loie	洛伊
Moynahan	莫伊纳汉
Multhauf	马尔特霍夫
Marinoff	马里诺夫
Boobbyer	布拜尔
Derrough	德拉夫
Verrier	维里尔
Kestnbaum	凯斯滕鲍姆
Bizic	比齐克
Dibiaggio	迪比亚乔
Mertz	默茨
Tarbat	塔巴特
Cardon	卡登
Gasser	加瑟
Connick	康尼克
Daglish	达格利什
Swannack	斯旺纳克
Vermillion	弗米利恩
Gelehrter	格莱尔特
Edey	埃迪
Ciano	查诺
Trinder	特林德
McPhee	麦克菲
Barbata	芭芭塔
Prater	普拉特
Vallentine	瓦伦丁
Pheeters	菲特斯
Trippier	特里皮尔
Mooring	穆林
Assender	阿森德
Boehmler	贝姆勒
Lucianus	卢西亚努斯
Deviney	迪瓦伊尼
Hom	霍姆
Blatch	布拉奇
Meyerson	迈耶森
Wilby	威尔比
Wait	韦特
Stewardson	斯图尔森
Ellerbee	埃勒比
Botez	博泰兹
Novakovic	诺瓦科维奇
Trueta	特鲁塔
Lancy	兰西
Lambourn	兰伯恩
Alasager	奥拉萨杰
Dillon	狄龙
Schanes	尚斯
McCue	麦丘
Audries	奥德里斯
Treweek	特里威克
Turetsky	图雷茨基
Laurentius	劳伦修斯
Barbro	巴布罗
Boniwell	博尼韦尔
Thartoovan	萨图文
Botthof	博特霍夫
Mab	马布
Doubell	道贝尔
Janion	贾尼恩
Arms	阿姆斯
DiBattiste	迪巴蒂斯特
Zacchaeus	扎凯厄斯
Everaert	埃弗雷特
Vaillant	瓦利恩特
Graysmith	格雷史密斯
Dickson	迪克森
Pratt	普拉特
Shorell	肖雷尔
Cernan	塞尔南
Bickel	比克尔
Scothern	斯科森
Bosvile	博斯维尔
Lucken	卢肯
Usborne	厄斯本
Drachman	德拉克曼
Parsky	帕尔斯基
Berlinsky	贝尔林斯基
Heberton	赫伯顿
Altobelli	阿尔托贝利
Javelin	贾夫林
Swatek	斯沃特克
Harkrider	哈克赖德
McOmish	麦科米什
Barkin	巴尔金
Kalmenson	卡尔门森
Ivone	伊冯
Bennethum	本内瑟姆
Farthing	法辛
Nazareth	纳萨雷特
Steffey	斯特菲
Brandt	勃兰特
Bruggeman	布鲁格曼
Macovski	马科夫斯基
McCutchan	麦卡琴
Allers	阿勒斯
Inglis	英格利斯
Itamar	伊塔马尔
Allhusen	阿尔休森
Schuster	舒斯特
Ryall	赖亚尔
McLaglen	麦克拉格伦
Rawling	罗林
Diefenbaker	迪芬贝克
Kilzer	基尔泽
Tadworth	塔德沃思
Deringer	德林杰
Ackerson	阿克森
Drayne	德雷恩
Sproxton	斯普罗克斯顿
Glacy	格拉西
Rattner	拉特纳
Filler	菲勒
Auerswald	奥尔斯瓦尔德
Wakid	瓦基德
Assum	阿萨姆
Cleanthous	克利安瑟斯
Meany	米尼
Pugh	皮尤
Dunitz	达尼茨
Yessenia	耶塞妮娅
Moldaw	莫尔道
Pianalto	皮亚纳尔托
Heinize	海尼兹
Pacetti	帕塞蒂
Poplett	波普利特
Houbigant	霍比甘特
Ririe	里里
Devaney	德瓦尼
Bork	博克
Powles	波尔斯
Cronbach	克龙巴赫
Reignier	赖格尼尔
Wanniski	万尼斯基
Radius	雷迪厄斯
Rudesill	拉德西尔
Errol	埃罗尔
Carlyle	卡莱尔
Westaby	韦斯特比
Winget	温格特
Bernbach	伯恩巴克
McComas	麦科马斯
Miskimen	米斯基门
Hacquoil	哈阔伊尔
Hanam	哈纳姆
Sitterson	西特森
Bryden	布赖登
Theophanous	西奥法努斯
Reaveley	里夫利
McGladery	麦格拉德里
Tallmer	托尔默
Maestre	梅斯特里
Almualla	奥尔穆瓦拉
Pringle	普林格尔
Tonlinson	汤林森
Harvanek	哈瓦内克
Rockafield	罗克菲尔德
Krislov	克里斯洛夫
Balliot	巴利奥特
MacRidis	麦克里迪斯
Dunham	邓纳姆
Garrelts	加勒尔茨
Groeger	格罗杰
Ligo	莱戈
Aram	阿拉姆
Rowlandson	罗兰森
Woliston	沃利斯顿
Carrozzo	卡罗佐
McConachie	麦康纳基
Berman	伯曼
Apgar	阿普加
Babst	巴布斯特
Belvin	贝尔文
Ammidon	安米登
Breickwood	布里克伍德
Beals	比尔斯
Ffion	菲恩
Noakes	诺克斯
Burnup	伯纳普
Kine	凯恩
Seifert	塞弗特
Meserve	梅泽夫
Lobjoit	洛布乔伊特
Heavenrich	海文里奇
Ive	艾夫
Fuelleman	菲勒曼
Tavernise	塔弗尼斯
Sunder	森德
Casland	卡斯兰
Follen	福林
Rebein	雷宾
Gejdenson	盖登森
Elzey	埃尔齐
Franta	弗兰塔
Fendrich	芬德里希
Winterfelt	温特费尔特
Helburn	赫尔本
Dryhurst	德赖赫斯特
Sundquist	森德奎斯特
Alysia	阿莉西娅
Littleton	利特尔顿
Mizener	迈兹纳
Petteys	佩蒂斯
Gotchy	戈齐
Lindbergh	林德伯格
McNaghton	麦克诺顿
Woolman	伍尔曼
Derlugt	德卢格特
Corbaley	科尔巴利
Rapport	拉波特
Hoornstra	霍恩斯特拉
Nizer	奈泽
Noyon	诺扬
Vampell	范佩尔
Belew	贝卢
Chegin	切金
Ayden	艾登
Namee	纳米
Jacobsen	雅各布森
Boeder	伯德
Oland	奥兰
Ganger	甘杰
Lothrop	洛思罗普
Ihrig	伊里格
Kilgour	基尔戈
Gaubert	高贝尔
Mecherle	米彻尔
Harway	哈韦
Broshar	布罗沙
Mazankowski	马赞科斯基
Romer	罗默
Halleck	哈勒克
Sokol	索科尔
Augener	奥格纳
Damgard	达姆加德
Mars	马尔斯
Enright	恩赖特
Chesemore	切泽莫尔
Costain	科斯坦
Berkow	伯科
Pallanck	帕兰克
Stubbs	斯塔布斯
Alven	阿尔文
Gamage	加米奇
Heaberlin	希伯林
Cliffe	克利夫
Trumbull	特朗布尔
Coalter	科尔特
Nolin	诺林
Cuneo	库内奥
Weichbrodt	韦克布罗特
Treaster	特里斯特
Mazlish	马兹利什
Kaldor	卡尔多
Cheit	凯特
Pooley	普利
Target	塔吉特
Sever	塞弗
Ganley	甘利
Stapp	斯塔普
Lesage	勒萨热
Hopp	霍普
McGeorge	麦乔治
Smiroldo	斯米罗尔多
Floberg	弗洛伯格
Weedon	威登
Granery	格兰纳里
Naifeh	奈菲
Bubenzer	布本泽
Blindell	布林德尔
Donnison	唐尼森
Hodgkins	霍奇金斯
Wachem	瓦赫姆
Reavley	里夫利
Fenby	芬比
Woolford	伍尔福德
Kilday	基尔迪
O'Geron	奥热龙
Nian	尼恩
Hixon	希克森
Kieran	基兰
Solberg	索尔伯格
Handin	汉丁
Umfreville	乌姆弗勒维尔
Dahlgren	达尔格伦
Murkison	默基森
Lindert	林德特
Rue	鲁
Mulinos	穆利诺斯
Pruss	普拉斯
Sevigny	塞维尼
Dunwoodie	邓伍迪
Ivatt	艾瓦特
Georges	乔治斯
Brueckheimer	布吕克海默
Muncaster	芒卡斯特
Baranson	巴兰森
Fanning	范宁
Breedlove	布里德洛夫
Girdlestone	格德尔斯通
Dunkelberg	邓克尔伯格
Cicconi	西科尼
Rule	鲁尔
Bieter	比特
DeWeese	德威斯
Martelli	马特利
Mirfin	默芬
Ferrland	费尔兰
Bergerman	伯格曼
Bremridge	布雷姆里奇
Fieldman	菲尔德曼
Beamand	比曼德
Roney	罗尼
Karloff	卡洛夫
Vicoy	维科伊
Raber	拉伯
Colligan	科利根
Brueckner	布吕克纳
Tauc	托克
Giarrusso	贾鲁索
Lathey	莱西
Folliot	福利厄特
Killearn	基勒恩
Borle	博尔
Barlerin	巴勒林
Carriere	卡里尔
Minudri	米纳德里
Rodak	罗达克
Ozias	奥扎厄斯
Feninger	费宁杰
Jelliffe	杰利夫
Kerrigan	克里根
Camelick	卡姆利克
Caiger	凯杰
Krisher	克里舍
Mellins	梅林斯
Baulch	鲍奇
Moulden	莫尔登
Blacker	布莱克
Gaskill	加斯基尔
Henges	亨吉斯
Eleanore	埃莉诺
Vahey	瓦伊
Worledge	沃利奇
Auerbach	奥尔巴克
Hammant	哈曼特
Sugarman	休格曼
Chesson	切森
Hamar	哈马尔
Gekas	格卡斯
Worner	沃纳
Mahurin	马胡林
Koshetz	科谢茨
Agatha	阿加莎
Tremills	特雷米尔斯
Brandborg	布兰德堡
Batsakis	巴察基斯
Triggle	特里格尔
Kealoha	基洛哈
Perriton	佩里顿
Kellermann	凯勒曼
Gorovsky	戈罗夫斯基
Calisher	卡利舍
Stoessiger	斯托西格
Bullokar	布洛卡
Gershinowitz	格希诺威茨
Autry	奥特里
Leouric	勒里克
Legitimus	莱吉蒂穆斯
Crittenden	克里滕登
Pragnell	普拉格内尔
Cogdill	科格迪尔
Quirey	奎厄里
Heart	哈特
Butchman	布奇曼
Mackames	麦卡姆斯
Orowan	奥罗万
Jursa	朱尔萨
Eliza	伊丽莎
Cockerham	科克勒姆
Colvard	科尔瓦德
Scorrer	斯科勒
Swales	斯韦尔斯
Ermolaev	叶尔莫拉耶夫
Hutson	赫特森
Dely	德利
Moresby	莫尔斯比
Crosthwaite	克罗思韦特
Ansbacher	安斯巴克
Oldershaw	奥尔德肖
Helyer	赫利尔
Embrey	恩布里
Cogan	科根
Huycke	海克
Purnell	珀内尔
Timm	蒂姆
Salsberg	萨尔斯伯格
Teiger	泰杰
Bye	拜伊
Acraman	阿克拉曼
Narbrough	纳伯勒
MacLeish	麦克利什
Daum	多姆
Vinter	文特
Moise	莫伊兹
Tigar	泰格
Waites	韦茨
Thede	锡德
Vacca	瓦卡
Wilbond	威尔邦德
Colston	科尔斯顿
Chruikhorn	克鲁克霍恩
Pappert	佩珀特
MacRobert	麦克罗伯特
Melhuish	梅尔休伊什
Heebe	希贝
Dechter	德克特
Gollan	高兰
Sivigny	西维尼
Trefonas	特雷福纳斯
Mommsen	莫姆森
McGreath	麦格雷思
Berridge	贝里奇
Hanzlik	汉兹利克
Simonis	西莫尼斯
Lear	利尔
Tarnya	塔尼娅
Chotiner	乔蒂纳
Walter	沃尔特
Breay	布雷
Ferrari	费拉里
Gabe	盖布
Hartel	哈特尔
McCann	麦卡恩
Pierpont	皮尔庞特
Zakkay	扎凯
Yalow	亚洛
Marris	马里斯
Loggin	洛金
Handel	汉德尔
Edgar	埃德加
DiNunzio	迪农齐奥
Nuessle	纽斯利
Mosley	莫斯利
Atack	阿塔克
Penhaligon	彭哈利根
Gagne	加涅
Neilon	尼伦
Graburn	格拉伯恩
Frischknecht	弗里施克内希特
Crowe	克罗
Lait	莱特
Fagerberg	法格伯格
Clever	克莱弗
Borenius	博里尼厄斯
Rait	雷特
Wildwood	怀尔伍德
Hille	希勒
Adwick	阿迪克
Beinart	贝纳特
Gordon	戈登
MacManus	麦克马纳斯
Tapsfield	塔普斯菲尔德
Eriksen	埃里克森
Eberlein	埃伯莱因
Callo	卡洛
Roof	鲁夫
Lesk	莱斯克
Pouch	波奇
Arielle	阿丽尔
Kettering	凯特林
Baumgardner	鲍姆加德纳
Orahood	奥拉胡德
Grenn	格伦
Jayanne	杰安妮
Silverman	西尔弗曼
Nurick	纽里克
Yglesias	伊格莱西亚斯
Sabatini	萨巴蒂尼
Maislin	梅斯林
Goldwater	戈德华特
Moule	莫尔
Kleckner	克莱克纳
Gumucio	古穆西奥
Meldrum	梅尔德伦
Feiner	费纳
Leroy	勒罗伊
Selkirk	塞尔扣克
Drohat	德罗哈特
Lindemann	林德曼
Felsted	费尔斯特德
Bonser	邦瑟
Kristina	克里斯蒂娜
Jubb	朱布
Searby	西尔比
Hannegan	汉尼根
Zurn	朱恩
Paullin	波林
McCardell	麦卡德尔
Platt	普拉特
Sumners	萨姆纳斯
Gramp	格兰普
Eglon	埃格伦
Thorley	索利
Gailey	盖利
Tomash	托马什
Zepf	泽普夫
Hale	黑尔
Hatriston	哈特里斯顿
Medish	梅迪什
Ratajczak	拉塔伊恰克
Cackett	卡克特
Glad	格莱德
Bachula	巴丘拉
Woodworth	伍德沃思
Hart	哈特
Podevin	波德温
Wethy	韦西
Peteseeger	皮特西格
Huffines	赫法恩斯
Bradeen	布拉登
Ilbert	伊尔伯特
Rivington	里文顿
Haba	哈巴
Matterson	马特森
Glube	格卢布
LeSauteur	勒索特
Bendixson	本迪克森
Zoon	佐恩
Cassani	卡萨尼
Flieger	弗利格
Lybrand	莱布兰德
Anish	阿尼什
Baliunas	巴柳纳斯
Callaghan	卡拉汉
Cordiere	科迪埃
Hilles	希尔斯
Alesia	阿莱西亚
Bermant	伯曼特
Gullion	格利恩
Beranek	贝拉尼克
Youngblade	扬布莱德
Sugaski	苏加斯基
Seile	塞尔
Candlish	坎德利什
McCullagh	麦卡拉
Frankhauser	弗兰克豪泽
Raeen	雷恩
Clausman	克劳斯曼
Blackbeard	布莱克比尔德
Witwer	威特沃
Wayburn	韦伯恩
Sherley	雪莉
Crie	克里
Eversull	埃弗萨尔
Tamarkin	塔马金
Cullers	卡勒斯
Anfelise	安费莉丝
Sedan	塞丹
DeCell	德塞尔
Croake	克罗克
LaFerte	拉弗特
Brachman	布拉赫曼
Rempel	伦佩尔
Larry	拉里
Soobitsky	苏比茨基
Calhoon	卡尔霍恩
Rubach	鲁巴赫
Aly	阿利
Goubeaux	古博
Selke	塞尔克
Kilburn	基尔伯恩
Fribourgh	弗里伯勒
Ammonds	安蒙兹
Chandrasekhar	钱德拉塞卡尔
Bargery	巴杰里
Heikoff	海科夫
Rumhill	拉姆希尔
Miser	迈泽
Schleiter	施莱特
Doble	多布尔
Reneau	雷诺
Whatmore	沃特莫尔
Balke	鲍克
Hawpe	霍普
Texon	特克松
Kobel	科贝尔
Alys	艾丽斯
Chazen	查曾
Burgee	伯吉
Grayck	格雷克
Coolbrith	库尔布里思
Deslongchamps	德朗尚
Birkerts	伯克茨
Cranston	克兰斯顿
Gouran	古伦
Resor	里索
Henize	赫尼兹
Faircloth	费尔克洛思
Netschert	内彻特
Hupman	赫普曼
Hiler	希勒
Baeda	比达
Coburn	科伯恩
Sakolski	萨科尔斯基
Spragins	斯普拉金斯
Town	汤
Jubal	朱巴尔
Oss	奥斯
Rhiannon	里安农
Steverson	斯蒂弗森
Eschbach	埃施巴赫
Maconchy	麦康基
Gossman	戈斯曼
McClenaghan	麦克莱纳根
Soloff	索洛夫
Allegany	阿利盖尼
Mauck	莫克
Harap	哈拉普
Fial	法耶尔
Watret	沃特里特
Unthank	昂桑克
Euphie	尤菲
Grimm	格里姆
Redfield	雷德菲尔德
Auger	奥格
Schinn	希恩
Benians	贝尼恩斯
Minnigerode	明尼格罗德
Grado	格拉多
Allibone	阿利本
Catmur	卡特默
Barletta	巴莱塔
Illiott	伊利奥特
Lew	卢
Fushman	富什曼
Broward	布劳沃德
Padrick	帕德里克
Berthelot	贝特洛
Croxall	克罗克索尔
Fargie	法吉
Meinig	迈尼希
Toumey	图米
Fabricand	法布里坎德
Snelgrove	斯内尔格罗夫
Layne	莱恩
Bick	比克
Finucan	菲纽肯
Drinker	德林克
Vandegrift	范德格里夫特
Norrish	诺里什
Wojtul	沃杰特尔
Dethloff	德特洛夫
Falwell	福尔韦尔
Gradowski	格拉多夫斯基
Mogey	莫吉
Pennekamp	彭尼坎普
Szczebak	什切巴克
Trehane	特里亨
Haes	黑斯
Mackellaigh	麦凯莱格
Horsfield	霍斯菲尔德
Barford	巴福德
Jampson	詹普森
Browe	布劳
McNaught	麦克诺特
Bologna	博洛尼亚
Ingerson	英格森
Luciano	卢西亚诺
Hautzinger	豪青格
Buik	别克
Seim	塞姆
Amyx	阿米克斯
Neynaber	内纳伯
Catell	卡特尔
Wild	怀尔德
Cirbo	西尔博
Pinfield	平菲尔德
Kinmount	金芒特
Weil	韦尔
Sylvanus	西尔韦纳斯
Angland	安格兰
Keyon	基恩
Belger	贝尔杰
Griffing	格里芬
Aldham	奥尔德姆
Hecht	赫克特
Laxson	拉克森
Ogdon	奥格登
Tolan	托兰
Cronon	克罗农
Mckeeman	麦基曼
Hatwood	哈特伍德
Nouat	诺瓦特
Cranton	克兰顿
Woodbine	伍德拜恩
Opie	奥佩
Davisson	戴维森
Ragent	雷金特
Pippett	皮佩特
Tevelin	蒂夫林
Sisler	西斯勒
Fauconberg	福肯贝格
Filippelli	菲利佩利
Spier	施皮尔
Weisburd	韦斯伯德
Hochwalt	霍克瓦尔特
Ledeen	莱丁
Krogh	克罗
Rovelstad	罗维尔斯塔德
Reyburn	雷伯恩
Apthorp	阿普索普
Ayrst	艾尔斯特
Crunkilton	克伦基尔顿
Asser	阿瑟
Hulden	赫尔登
Ardrey	阿德里
Langbridge	兰布里奇
Ballaire	巴莱尔
Gotley	戈特利
Thomason	托马森
Bousch	布施
Wrightsman	赖茨曼
Totton	托顿
Parkhill	帕克希尔
Emmons	埃蒙斯
Emery	埃默里
Wisneski	威斯内斯基
Stables	斯特布尔斯
Cosway	科斯韦
Merryman	梅里曼
Wolf	沃尔夫
Ytterberg	伊特伯格
Cauty	考蒂
Covault	科沃尔特
McGavock	麦加沃克
Muhonen	穆霍宁
Cattanach	卡塔纳克
Vans	万斯
Germans	杰曼斯
Dassin	达辛
Giffin	吉芬
Zellerbach	泽勒巴克
Stimpson	斯廷普森
McGonagle	麦戈纳格尔
Kodis	科迪斯
Drapkin	德拉普金
Sullivan	沙利文
Thripp	思里普
Peskin	佩斯金
Mekler	梅克勒
Tagget	塔格特
Elya	伊莱亚
Milicent	米莉森特
Sprules	斯普鲁尔斯
Angelo	安杰洛
Worfson	沃尔夫森
Gertrude	格特鲁德
Fanshel	范谢尔
Lathrop	莱思罗普
Rafler	拉弗勒
Gadbow	加德博
Grossinger	格罗辛格
Geachie	吉奇
Skantze	斯坎策
Storke	斯托克
Denison	丹尼森
Lamy	拉米
Gravina	格雷维纳
Marton	马顿
Gewin	格温
Courlson	库尔森
Densmore	登斯莫尔
Gramstorff	格拉姆斯托夫
Euralia	尤雷利娅
Grove	格罗夫
McFaddin	麦克法丁
Ryann	瑞安
Warfard	沃法德
Gunn	冈恩
Grahamit	格拉哈米特
Greenslade	格林斯莱德
Raymont	雷蒙特
Claire	克莱尔
Giannasi	詹纳西
Blakelock	布莱克洛克
Bonney	邦尼
Tannen	坦嫩
Tancredo	坦克雷多
Kokoschka	科科施卡
Golembieski	戈伦别斯基
Dyment	戴门特
Delony	德洛尼
Hamnell	哈姆内尔
Popenoe	波普诺
Weimers	韦默斯
Condoleeza	康多莉扎
Vitela	维特拉
Prizer	普赖泽
Kidney	基德尼
Loweree	洛厄里
Spiller	斯皮勒
Tomory	托莫里
Skardon	斯卡登
Gochberg	戈克伯格
Wadson	沃森
Panday	潘戴
Cadmus	卡德默斯
Mima	米玛
Homsley	霍姆斯利
Bandler	班德勒
Haydn	海登
Pluto	普卢托
Dongan	唐根
Barebone	贝邦
Whitsitt	惠齐特
Heberden	赫伯登
Guigan	圭根
Dersal	德索尔
Cocci	科奇
Buskell	巴斯克尔
Eisenstaedt	艾森施泰特
Brugler	布鲁格勒
Lorain	洛兰
Welheim	韦尔海姆
Brafford	布拉福德
Cashen	卡申
Nisbet	尼斯比特
Buckles	巴克尔斯
Bigeleisen	比格莱森
Batastini	巴塔斯蒂尼
Goldsmid	戈德斯米德
Pannall	潘纳尔
Sapirie	萨皮里
Seabron	西布龙
Allcut	奥尔克特
Nealon	尼伦
Carek	卡雷克
Swinnerton	斯温纳顿
Brisco	布里斯科
Hackenberg	哈肯伯格
Trew	特鲁
Saenz	萨恩斯
Trapnell	特拉普内尔
Eckert	埃克特
Swickey	斯威基
Mansell	曼塞尔
Keila	凯拉
Bonin	博宁
McCaughey	麦考伊
Spring	斯普林
Corken	科肯
Ames	埃姆斯
Gustine	古斯坦
Seaga	西加
Richton	里奇顿
Surrey	萨里
Goodden	古登
Rackham	拉克姆
Doll	多尔
Kieman	基曼
Trillo	特里洛
Packington	帕金顿
Aberdare	阿贝代尔
Vargo	瓦戈
Staenberg	斯坦伯格
Routien	鲁蒂恩
Coomey	库米
Sillitto	西利托
Sclove	斯克洛夫
Nourse	诺斯
Tylden	蒂尔登
Bukowski	布科夫斯基
McClory	麦克洛里
Gehringer	格林格
Lutwidge	勒特威奇
Gutin	古廷
Murdock	默多克
Kanne	坎内
LeQuesne	勒凯纳
Bridge	布里奇
Looney	卢尼
Lomas	洛马斯
Oxborrow	奥克斯博罗
Markeson	马克森
Gratz	格拉茨
Hogh	霍
Alling	阿林
Rossby	罗斯比
Moys	莫伊斯
Dirlam	德拉姆
Lowdon	洛登
Penttala	彭塔拉
Maney	梅尼
Smullen	斯马伦
Mucho	马乔
Toms	汤姆斯
Allin	阿林
Garnet	加尼特
Dysart	戴萨特
Staring	斯塔林
Dinstein	丁斯坦
Azpeitia	阿兹佩希亚
Griskey	格里斯基
Fournet	福内特
Cecere	切切里
Mcgeogh	麦吉奥赫
Helewicz	赫莱维奇
Collier	科利尔
Portner	波特纳
Perchard	珀沙德
Erler	埃勒
Kalb	卡尔布
McNinch	麦克宁奇
Pohlman	波尔曼
Raisa	赖莎
Malashevich	马拉舍维奇
Woodridge	伍德里奇
Bessant	贝赞特
Sessions	塞申斯
Lilac	莱拉克
Violette	维奥莉特
Biester	比斯特
Emony	埃莫尼
Twiname	特威内姆
Horsfall	霍斯福尔
Ede	伊德
Lagow	拉戈
Mchaffie	麦克哈菲
McIvor	麦基弗
Grassie	格拉西
Petzoldt	佩佐尔特
Maag	马格
Moe	莫
Konz	康茨
Goodstein	古德斯坦
Greinke	格伦克
Dubowsky	杜博夫斯基
Lendrum	伦德拉姆
DeHarde	德哈德
Broadnax	布罗德纳克斯
Aubolle	奥博尔
Rachlin	拉克林
Bewick	比伊克
Zeffert	泽弗特
Algase	阿尔加斯
Rizzo	里佐
Saby	萨比
Devonald	德沃纳德
Macbeath	麦克贝思
Rennison	伦尼森
Zelma	泽尔马
Ding	丁
Terkla	特克拉
Huxsoll	赫克索尔
Camm	卡姆
McGaughy	麦高希
Penhale	彭黑尔
Kamenske	卡门斯克
Bressan	布雷森
Chettle	切特尔
Abdalian	阿布达利安
Tomei	托梅
Crittall	克里托尔
Moton	莫顿
Gassaway	加萨韦
Southall	索撒尔
Alonso	阿朗索
LeCarre	勒卡雷
Barringer	巴林杰
Heffelbower	赫费鲍尔
Scoullar	斯库拉
Duncan	邓肯
Blahut	布拉胡特
Birkenstock	比肯施托克
Metrinko	梅特林科
Domokos	多莫科什
Hunigan	哈尼根
Usilaner	尤西拉纳
Olgilvy	奥吉尔维
Soyer	索耶
Scogings	斯科金斯
Blydenburgh	布莱登伯勒
Hamberger	汉伯格
Fritzke	弗里茨克
Manrice	曼赖斯
Selena	塞莱娜
Kirly	柯利
Nordberg	诺德伯格
Barraclough	巴勒克拉夫
Proudfit	普劳德菲特
Apodaca	阿波达卡
Dedrick	戴德里克
Shepley	谢普利
Dettman	德特曼
Vanous	瓦努斯
Ninon	妮农
McGavin	麦加文
Humphrey	汉弗莱
Scordato	斯科达托
Borovoy	博罗沃伊
Arabella	阿拉贝拉
Goodloe	古德洛
Dantley	丹特利
Milham	米勒姆
Bull	布尔
Tilloch	蒂洛赫
Moyra	莫伊拉
Koppang	科庞
Belieu	贝利厄
Undery	昂德里
Crady	克拉迪
Gimbel	金贝尔
Rihoy	里奥伊
Heming	赫明
Jedediah	杰迪代亚
Willicomb	威利科姆
Rigney	里格尼
Osburn	奥斯本
Daynes	戴恩斯
Isern	艾森
Frayn	弗雷恩
Lickess	利基斯
Alberg	阿尔伯格
Pippard	皮帕德
Baumrin	鲍姆林
Haggin	哈金
Beishline	贝什兰
Gresov	格雷索夫
Leanna	利安娜
Cogenhoe	库格诺
Strumph	斯特伦夫
Fassberg	法斯伯格
Bellwin	贝尔温
Stockbroker	斯托克布鲁克
Halio	哈利奥
Canciello	坎切洛
Lenky	伦基
Rennebohm	伦尼邦
Lamson	拉姆森
Reichhold	赖克霍德
Ackeli	阿克利
Smirke	斯默克
Zemeckis	泽梅基斯
Witlam	威特勒姆
Edelsten	埃德尔斯滕
Gaye	盖伊
Bonforte	邦福特
Benita	贝妮塔
Truscott	特拉斯科特
Southwood	索思伍德
Lestrade	莱斯特雷德
Sandrak	桑德拉克
Boursy	布尔西
Amen	阿门
Mirrielees	米里利斯
Birkhoff	伯克霍夫
Gamewell	盖姆韦尔
Fraily	弗雷利
Myhren	迈伦
Battle	巴特尔
Alphonse	阿方斯
Daughtrey	多特里
Addams	亚当斯
Viner	瓦伊纳
Richman	里奇曼
Carnevale	卡内瓦莱
Maugham	莫姆
Diecke	迪克
Rennagel	雷纳格尔
Agrait	阿格赖特
Eastland	伊斯特兰
How	豪
Stefansson	斯蒂芬森
Eyberg	艾伯格
Hershey	赫尔希
Dyneley	戴恩利
Herlipy	赫利比
Hamelin	哈梅林
Onsager	翁萨格
Corgan	科根
Cadwalader	卡德瓦拉德
Gorth	戈特
Gerrits	格里茨
Bodden	博登
Zupan	朱潘
Newburger	纽伯格
Kinnell	金内尔
Tombstone	图姆斯通
Tarcher	塔彻
Goodrich	古德里奇
Elks	埃尔克斯
Witzel	威策尔
Zimny	齐姆尼
Barttelot	巴特洛特
Bolley	博利
Eichenberg	艾肯伯格
Cayetano	卡耶塔诺
Hecox	希科克斯
Kanter	坎特
Rowcliff	罗克利夫
Bingord	宾戈德
Kelso	凯尔索
Baucus	鲍卡斯
Melanson	梅兰森
Kivney	基夫尼
Corish	科里什
Couling	库林
Marts	马茨
Craknel	克拉克内尔
Bannard	班纳德
Moszkowski	莫斯科夫斯基
Matthias	马赛厄斯
Hotchner	霍奇纳
Leete	利特
Clean	克林
Ciprianus	西普里亚纳斯
Spaeth	斯佩思
Hartin	哈廷
Peverell	佩弗雷尔
Onslow	翁斯洛
Dinwoodey	丁伍迪
Murfin	默芬
Richert	里克特
Dittmer	迪特默
Betzig	贝齐格
Deem	迪姆
Roseway	罗斯韦
Klebanoff	克莱巴诺夫
Foxley	福克斯利
Sendejo	森德乔
Henline	亨兰
Iggelden	伊格尔登
Corotis	科罗蒂斯
Fishel	菲谢尔
Sandars	桑达斯
Garelick	加勒利克
Kimbark	金巴克
Crain	克雷恩
Cromie	克罗米
Jennette	詹妮特
Hepp	赫普
MacMahon	麦克马洪
Sonya	索尼娅
Folkner	福克纳
Cis	茜丝
Rentoul	伦图尔
Mikardo	米卡多
Mikelonis	米克洛尼斯
Schuyten	斯库滕
Dineen	迪宁
Coggon	科根
Whitlock	惠特洛克
Laydon	莱登
O'Regan	奥里甘
Sheblak	谢布拉克
Buskirk	巴斯柯克
Souby	苏比
Bogdan	波格丹
Rothholz	罗思霍尔茨
Zelizer	泽利泽
Brazell	布雷泽尔
Oboler	奥博勒
Bornemann	博恩曼
Gremillion	格雷米林
Dym	迪姆
Keyworth	基沃思
Abramoff	阿布拉莫夫
MacOwan	麦克欧文
Kolko	科尔科
Doverdale	多弗代尔
Buttleman	巴特尔曼
Waguespack	瓦格斯帕克
Enelow	埃尼洛
Satz	萨茨
Tsiapera	齐亚佩拉
Brownlow	布朗洛
Rado	雷多
Handelsman	汉德尔斯曼
Steely	斯蒂利
Gosling	戈斯林
Geeves	吉夫斯
Klem	克莱姆
Eron	埃伦
Debby	黛比
Corette	科雷特
Harbottle	哈博特尔
Taffinder	塔芬德
Kinghorn	金霍恩
Baco	巴科
Edzell	埃泽尔
Ashin	阿欣
Broke	布罗克
Lavis	拉维斯
McConachy	麦康纳基
Russ	拉斯
Dinshaw	丁肖
Titus	泰特斯
Mahony	马奥尼
Baskir	巴斯基尔
Ardia	阿尔迪亚
Bott	博特
Shonfield	肖恩菲尔德
Mullikin	马利金
Ferrone	费龙
Moossa	穆萨
McIldowie	麦基尔杜伊
Harroff	哈罗夫
Fenske	芬斯克
Klaus	克劳斯
Hourigan	胡里根
Xystus	齐斯特斯
McMartin	麦克马丁
Friederich	弗里德里希
Heaton	希顿
Bersoff	伯索夫
Tetcher	特彻
Floate	弗洛特
Christenson	克里斯滕松
Dowty	道蒂
Bussey	伯西
Gunst	冈斯特
Averitt	埃夫里特
Earsman	伊尔兹曼
Broccoli	布罗科利
Briginshaw	布里金肖
Marcotte	马科特
Brunel	布鲁内尔
Scalzi	斯卡尔齐
MacNichol	麦克尼科尔
Warf	沃夫
Hoey	霍伊
Mardam	马德姆
Emrich	埃姆里克
Couch	库奇
Coroniti	科罗尼蒂
Duchin	达钦
Seelman	西尔曼
Trader	特雷德
Housh	胡什
MacChiarola	麦基亚罗拉
Connable	康纳布尔
Wilges	威尔奇斯
Uffelman	乌费尔曼
Gilruth	吉尔鲁思
Dimitman	迪米特曼
Sams	萨姆斯
Ismach	伊斯马赫
Furchtgott	弗奇戈特
Hoge	霍格
Macraild	麦克雷尔德
Morawetz	莫拉韦茨
Fieleke	菲利克
Koke	科克
Sting	斯廷
Chimsky	奇姆斯基
Martuge	马图格
Atiyah	阿提耶
Wax	瓦克斯
Grooms	格鲁姆斯
Honeyman	霍尼曼
Helinski	赫林斯基
Weyl	韦尔
Ainsworth	安斯沃思
Wenk	温克
Gabrielson	加布里埃尔森
Crisostomo	克里索斯托莫
Packman	帕克曼
Yaney	亚尼
Doniach	多尼亚克
Digedan	迪杰丹
Kettyle	凯特尔
Sansome	桑瑟姆
Lillegard	利勒加德
Clausing	克劳辛
Minuit	米纽伊特
Danbrunt	丹布伦特
Furino	富里诺
Reynardson	雷纳森
Mahlstede	马尔斯特德
Clenaghan	克莱纳根
Davidow	达维多夫
Sicoe	西科
Jurat	朱拉特
Mallinson	马林森
Deakins	迪金斯
Bram	布拉姆
Momerie	马默里
Pogue	波格
Backustein	巴克斯泰因
Wedlake	韦德莱克
Nemerever	尼姆里弗
Umhoefer	乌姆赫弗
Nixon	尼克松
Wilgress	威尔格雷斯
Paskin	帕斯金
Hendler	亨德勒
Tendler	滕德勒
Kitchison	基奇森
Puelicher	普韦利克
Harrington	哈林顿
Ducommun	杜科蒙
Inge	英奇
Gerry	格里
Spradling	斯普拉德林
Ketchum	凯彻姆
Angeloff	安杰洛夫
Bodfish	博德菲什
Nussel	尼塞尔
Ideny	伊德妮
Plomer	普洛默
Frankfort	法兰克福
Jenney	珍妮
Cansdale	坎斯代尔
Orgel	奥格尔
Madansky	马丹斯基
Sharley	莎莉
Roddie	罗迪
East	伊斯特
Arblaster	阿布拉斯特
Doctorow	多克托罗
Aney	阿内
Zelby	泽尔比
Secombe	塞科姆
Mckercher	麦克彻
Yelverton	耶尔弗顿
Hirschfeld	赫希菲尔德
Roft	罗夫特
Culf	卡尔夫
MacDonnell	麦克唐奈
Hogue	霍格
Goldhammer	戈德哈默
Vandernoot	范德努特
Cephas	西法斯
Leich	莱克
Hene	希尼
Buckler	巴克勒
Chahine	查欣
Hight	海特
Carton	卡顿
Huizenga	休伊曾加
Studebaker	史蒂倍克
Galliart	加利亚特
West	韦斯特
Bockstein	博克斯坦
Depeer	德皮尔
Bradt	布拉特
Borcherdt	博赫特
Romeril	罗默里尔
Eckhoff	埃克霍夫
Perrot	佩罗特
Higden	希格登
Linsey	林赛
Street	斯特里特
Smelzer	斯梅尔策
Purdue	珀杜
Ethan	伊桑
Bonaparte	波拿巴
Schulman	舒尔曼
Symeon	西米恩
Crosbie	克罗斯比
Habib	哈比卜
Moynhan	莫因汉
Bacheller	巴切勒
Uff	乌夫
Bautz	鲍茨
Opfer	奥普弗
Windler	温德勒
Mendell	门德尔
Spell	斯佩尔
Rolph	罗尔夫
Lukeman	卢克曼
Meech	米奇
Graettinger	格雷廷杰
Lanneau	兰诺
Fettes	费蒂斯
Pershing	珀欣
Sculpher	斯卡尔弗
Kreager	克里格
Martell	马特尔
Elfenbein	埃尔芬拜因
Blaszkowski	布拉斯科夫斯基
Weirick	韦里克
LeCourt	勒考特
Means	米恩斯
Wilks	威尔克斯
Swearingen	斯韦林根
MacEwan	麦克尤恩
Leidy	莱迪
Claypool	克莱普尔
Merry	梅里
Orgelist	奥奇利斯特
Hartgen	哈特根
Francisca	弗朗西丝卡
Clenon	克莱农
Commings	康明斯
Friede	弗里德
Bauch	鲍赫
Welman	韦尔曼
Birir	比里尔
Amery	埃默里
Wallender	沃伦德
Arcari	阿尔卡里
Federer	费德勒
Eibhlin	艾夫琳
Doniphan	多尼芬
Battenhouse	巴腾豪斯
Amsterdam	阿姆斯特丹
Gunnora	贡诺拉
Kutish	库蒂什
Kayley	凯莉
Lasbrey	拉斯布里
Bellis	贝利斯
Creagan	克里根
Ruffin	拉芬
Calverley	卡尔弗利
Magennis	莫根尼斯
Sides	塞兹
Buxbaum	巴克斯鲍姆
Merven	默文
Marotta	马罗塔
Gitta	吉塔
Carret	卡雷特
Macquin	麦奎恩
Stephana	斯蒂芬娜
Toomre	图姆尔
Rustum	拉斯特姆
Kipp	基普
Schairer	谢勒
Chronic	克罗尼克
Crynes	克赖恩斯
Bourgogne	布戈尼
Walkinshaw	沃金肖
Sherar	谢拉尔
Markwick	马克威克
Yukon	尤康
Anstee	安斯蒂
Bennison	本尼森
Streibert	斯特赖伯特
Banas	巴纳斯
D'Erlanger	德朗热
Copperfield	科珀菲尔德
Bachrach	巴克拉克
Wearn	沃恩
Irsay	伊尔赛
Rury	鲁里
Uhlenhop	乌伦霍普
Cukor	丘克
Zoete	佐特
Anice	安妮斯
Aaronian	阿罗尼安
Duba	杜巴
Mardian	马迪安
Fancher	范彻
Picher	皮彻
Bartosic	巴尔托西克
Cledwyn	克莱德温
Iverson	艾弗森
Brosseau	布罗索
Jenkins	詹金斯
Kreuser	克罗伊泽
Towell	托厄尔
Zerin	泽林
Aelmer	艾尔默
Winfree	温弗里
Bovetti	博韦蒂
Chamberland	钱伯兰
Sloane	斯隆
Faeth	费思
Spikes	斯派克斯
Girardeau	吉拉尔多
Roppuld	罗普尔德
Taft	塔夫脱
Mawby	莫比
Mathias	马赛厄斯
Neukom	诺伊康
Goldgraben	戈德格拉本
Dworsky	德沃尔斯基
Sirman	西尔曼
Thakurdas	撒克达斯
Talia	塔莉娅
Swain	斯温
Lovre	洛弗
Liimatainen	利马泰宁
Parshall	帕歇尔
Clabby	克拉比
Kiernan	基尔南
Massura	马苏拉
Rochford	罗奇福德
Tamagni	塔马尼
Topping	托平
Joules	焦耳斯
Smithett	史密西特
Eton	伊顿
Auberon	奥伯龙
O'Riordan	奥赖尔登
Reily	赖利
Brandi	布兰迪
Weigall	韦戈尔
Halide	哈利德
Norfolk	诺福克
Laxton	拉克斯顿
James	詹姆斯
Manuwa	马努瓦
Scalpino	斯卡尔皮诺
Cotterman	科特曼
Jungwirth	琼沃思
Donaho	多纳霍
Beasinger	比辛杰
Cremore	克雷莫尔
Boocock	布科克
Lan	兰
Higginbotham	希金博特姆
Fitzmaurice	菲茨莫里斯
Sciama	夏默
Lizars	利扎斯
Newingham	纽因厄姆
Stockins	斯托金斯
Itzkowitz	伊茨科维茨
Chunn	丘恩
Knaebel	内布尔
Freeth	弗里思
Murarka	穆拉尔卡
Rayler	雷勒
Hammerstrom	哈默斯特伦
Lothian	洛西恩
Gellantley	格兰特利
Pais	佩斯
Keown	基翁
Montais	蒙泰
Maguistretti	马圭斯特雷蒂
Vigorito	维戈里托
Skubitz	斯库比茨
Arouh	阿鲁
Bunsen	本森
Halpern	哈尔彭
Hargrove	哈格罗夫
Gerken	格肯
Feinsilber	范西尔伯
Figley	菲格利
McIsaac	麦基萨克
Ustad	乌斯塔德
Imbroscio	英布罗肖
Demetry	德梅特里
Vitter	维特
Punch	庞奇
Morrall	莫罗尔
Newcomer	纽科默
Cullum	卡勒姆
Colquhoun	科洪
Meihaus	迈豪斯
Delane	德莱恩
Murphy	墨菲
Hickinbotham	希金博特姆
Yaeger	耶格尔
Kellstadt	凯尔斯塔特
Lebherz	莱布赫茨
Milkman	米尔克曼
Crispo	克里斯波
McChlery	麦克莱里
Bres	布雷斯
Hakes	哈克斯
Kendon	肯登
Taren	塔伦
Coxwell	考克斯韦尔
Joske	乔斯克
Shrapnel	施雷普内尔
Fredericksen	弗雷德里克森
Wilts	威尔茨
Mudell	马德尔
Lewine	卢因
Blacken	布莱肯
Alberthal	艾伯索尔
Attaway	阿塔韦
Althorp	奥尔索普
Proinsias	普罗因西亚斯
Barefoot	贝尔富特
Ipcar	伊普卡
Tegetmeier	特盖特迈耶
Melchner	梅尔克纳
Aisner	艾斯纳
Gallegos	加莱戈斯
Los	洛斯
Ragland	拉格兰
Fricke	弗里克
Mewett	缪伊特
Soni	索尼
Touche	图什
McCartney	麦卡特尼
Slawsky	斯拉夫斯基
Erisman	埃里斯曼
Zemp	曾普
Fegley	费格利
Doms	多姆斯
Koenke	凯恩克
Duma	杜马
Angelou	安杰卢
Boffey	博费
Schurz	舒尔茨
Imogen	伊莫金
Sorling	索林
Fauset	福塞特
Beeson	比森
Gilmour	吉尔摩
Meloche	梅洛希
Ritts	里茨
Marlo	马洛
Alfreda	阿尔弗里达
Dalvia	达尔维娅
Wieberg	威伯格
Hector	赫克托
Cursley	柯斯利
Conaboy	科纳博伊
Whitener	怀特纳
Garfinkel	加芬克尔
Harbord	哈博德
Tolor	托勒
Kuexes	基克塞斯
Theiss	泰斯
Banbury	班伯里
Minsheu	明舒
Focht	福赫特
Platts	普拉茨
Balcarres	巴尔卡雷斯
Hilda	希尔达
Kindregan	金德里根
McConaghy	麦康纳基
Osmund	奥斯蒙德
Biggy	比吉
Bordin	博尔丁
Ismail	伊斯梅尔
Bartlit	巴特利特
Allbritton	奥尔布里顿
MacLeod	麦克劳德
Burkhalter	伯克哈尔特
Vandyck	范戴克
Home	霍姆
Koperski	科佩尔斯基
Wyrobek	怀罗贝克
Branston	布兰斯顿
Broxis	布罗克西斯
Boog	布格
Gropius	格罗皮厄斯
McCallam	麦卡勒姆
Holmead	霍尔米德
Dossetter	多塞特
Machol	马乔尔
Potter	波特
Dworetzky	德沃雷茨基
Talebot	塔利博特
Beare	比尔
Fender	芬德
Kathleen	凯瑟琳
Anscomb	安斯科姆
Lamerton	拉默顿
Podobnikar	波多布尼卡
Ree	雷
Fafian	法菲安
Allenby	艾伦比
DeGeorge	德乔治
Hyman	海曼
Goroncy	戈龙西
Flershem	弗勒谢姆
Dreylinger	德赖林格
Banerian	巴纳里安
Brummer	布鲁默
MacCarton	麦卡顿
Tanya	塔尼娅
Harvatt	哈瓦特
Erhard	埃哈德
Meldaig	梅尔代格
Milhollan	米尔霍兰
Davoren	达沃伦
Hortiz	霍蒂兹
Leeburn	利伯恩
McClay	麦克莱
Barkhorn	巴克霍恩
Corkle	科克尔
Mankey	曼基
Bonelli	博内利
Leverett	莱弗里特
Sjoholm	肖霍姆
Currant	柯伦特
Lamothe	拉莫思
Zais	蔡斯
Milhaven	米尔黑文
Rushdie	拉什迪
Gellmann	格尔曼
Nordland	诺兰
Alpha	阿尔法
Larance	拉伦斯
Amschel	阿姆谢尔
Shkor	什科
Alfreton	奥尔弗里顿
Brockholst	布罗克霍斯特
Schooner	斯库纳
Schutzman	舒茨曼
Lataur	拉托尔
Kiel	基尔
Werkman	沃克曼
Mihok	米霍克
Kinbbin	金宾
Winchell	温切尔
Hemrick	赫姆里克
Fleishmann	弗莱什曼
Kristol	克里斯托尔
Murgett	默吉特
Orin	奥林
Pettengill	佩滕吉尔
Rothes	罗西斯
Grego	格雷戈
Dalway	多尔韦
Joppa	乔帕
Mignot	米尼奥
Luchford	拉奇福德
Baynon	贝农
Penton	彭顿
Stok	斯托克
Mickel	米克尔
Shanley	尚利
Abish	阿比什
Wvendth	文特思
Morrah	莫拉
Silvio	西尔维奥
Bestinvest	贝斯廷维斯特
Rauscher	劳舍尔
Obenshain	奥本沙因
Whale	惠尔
Bishar	比沙
Barbash	巴巴什
Thiselton	西塞尔顿
Goeglein	戈格莱因
Huckelsby	赫克尔斯比
Wysner	怀斯纳
Cimeno	西梅诺
Baida	拜达
McSheehy	麦克希伊
Perrin	佩林
Darewski	达列夫斯基
Gabb	加布
Trainer	特雷纳
Hutner	赫特纳
Turnheim	特恩海姆
Posnett	波斯内特
Aguayo	阿瓜约
Birkinshaw	伯金肖
Hind	欣德
Janice	贾尼丝
Kemmons	凯蒙斯
McMurray	麦克默里
Spachner	斯帕克纳
Luftig	拉夫蒂格
Muehlenbeck	米伦贝克
Bulke	巴尔克
Herold	赫罗尔德
Dannay	丹奈
Dore	多尔
Felker	费尔克
Stanislas	斯坦尼斯拉斯
Medberry	梅德贝里
Heinekey	海尼基
Colehan	科勒汉
Gollong	戈隆
Boulter	博尔特
Faulkland	福克兰
Briercliffe	布赖尔克利夫
Masheck	马谢克
Namby	南比
Capella	卡佩拉
Blanchet	布兰切特
Lanfear	兰菲尔
Moorer	穆勒
Culverwel	卡尔弗韦尔
Cuttress	卡特里斯
Uretz	乌雷茨
Schinz	欣兹
Leighly	莱利
Nary	纳里
Gaisford	盖斯福德
Garamendi	加拉门迪
Merrian	梅里安
Pyer	派尔
Kersh	克什
Gesell	格塞尔
Himstead	希姆斯特德
Bridgers	布里杰斯
Rev	雷夫
Gingold	金戈尔德
Birgutta	伯格塔
McAll	麦卡尔
Threlkeld	思雷尔克德
Taplin	塔普林
McGahey	麦加希
Libertucci	利贝图奇
Ysseldyke	伊塞尔代克
Simcoe	西姆科
Berrill	贝里尔
Bardrick	巴德里克
Seidman	塞德曼
Griller	格里勒
Glenard	格莱纳德
Altan	阿尔坦
Corbeil	科贝伊
McElmurry	麦克尔默里
Peig	佩格
Joachim	乔基姆
Kimsey	基姆西
Kahanamoku	卡哈纳莫库
Chatham	查塔姆
Thornburg	索恩伯格
Dembowski	登博夫斯基
Cavallo	卡瓦略
Pallan	帕兰
Karst	卡斯特
Sanderson	桑德森
Panofsky	帕诺夫斯基
Bantz	班茨
Marietta	玛丽埃塔
Spinak	斯皮纳克
Furby	弗比
Hayflick	海弗利克
Bedeian	贝代安
Quetsch	奎奇
Allum	阿勒姆
Trefgarne	特雷夫加恩
Attwater	阿特沃特
Tattnall	塔特诺尔
Searwar	西尔沃
Hughes	休斯
Kreslins	克雷斯林斯
Schuker	舒克
Banaszynski	巴纳辛斯基
Israelson	伊斯雷尔森
Goodreds	古德雷兹
Ruter	拉特
O'Melia	奥梅利亚
Laslingh	拉斯林
Hershkowitz	赫什科维茨
Hagedorn	哈格多恩
Dobelle	多贝尔
Beaucamps	博康
Hootman	胡特曼
Tempelton	坦佩尔顿
Robin	罗宾
Horichens	霍里琴斯
Mackall	麦考尔
Barrington	巴林顿
Hennessey	亨尼西
Heim	海姆
Olsson	奥尔森
Revell	雷维尔
Ridgley	里奇利
Collender	科伦德
Stoller	斯托勒
McDavid	麦克戴维
Wooley	伍利
Gushurst	古斯赫斯特
DiMario	迪马里奥
Eccles	埃克尔斯
Schally	沙利
Talleur	塔勒
Cammaerts	卡默茨
Mensforth	门斯福思
Bailly	贝利
Dipalma	迪帕尔马
O'Shiel	奥希尔
Swarbrick	斯沃布里克
Dinos	迪诺斯
Dull	达尔
Peet	皮特
Segal	西格尔
Grad	格拉德
Stoopin	斯图平
Mohn	莫恩
Gordimer	戈迪默
Bochco	博奇科
Prosperi	普罗斯佩里
Macchlerich	麦克莱里奇
Halter	霍尔特
Clanahan	克拉纳汉
Craner	克雷纳
Geisel	盖泽尔
Tingelstad	廷格尔施塔德
Pepperday	佩珀迪
Yester	耶斯特
Cowcher	考彻
Eilberg	艾尔伯格
Dentan	登坦
Zealous	泽勒斯
Emmote	埃莫特
Proffitt	普罗菲特
Fabrycy	法布里西
Brubacher	布鲁巴克
Duthoit	杜索伊持
Lucie	露西
Schafer	谢弗
Fillips	菲利普斯
Hardaker	哈达克
Rootes	鲁茨
Sardeson	萨德森
Farraby	法拉比
Gretzky	格雷茨基
Aggie	阿姬
Jamblin	詹布林
Fenichel	费尼切尔
Bybee	拜比
Forme	福姆
Clintic	克林蒂克
Tillison	蒂利森
Behnke	本克
Kennerly	肯纳利
Penhallow	彭哈洛
Pinchbeck	平奇贝克
Bezzant	贝赞特
Deitz	戴茨
Gartenberg	加滕伯格
Pyrah	派拉
Cisco	西斯科
Courtown	科尔敦
Harsh	哈什
Wiener	威纳
Hammock	哈莫克
Cobham	科巴姆
Grau	格劳
Blackiston	布莱基斯顿
Erigena	埃里杰纳
Yorkston	约克斯顿
Eite	艾特
Mcinnery	麦金纳里
Mestrovic	梅斯特罗维奇
Magog	梅戈格
Whicker	威克
Aylwyn	艾尔温
Larocco	拉罗科
Mausshardt	莫斯哈特
Leftwich	莱夫特威克
MacMurd	麦克默德
Farbman	法布曼
Sarbanes	萨班斯
Mengedoth	门格多特
Nabers	内伯斯
Wentwoeth	温特沃思
Doggett	多格特
Breuer	布鲁尔
Lael	莱尔
Sillivan	西利文
Brucker	布鲁克
Creutz	克罗伊茨
Mortensen	莫滕森
Doroshaw	多罗肖
Poulterer	波尔特勒
Micaela	米凯拉
Palman	帕尔曼
Withey	威西
Horseman	霍斯曼
Valancy	瓦兰西
Melville	梅尔维尔
Spriggs	斯普里格斯
Unique	尤妮克
Gamber	甘伯
Piet	皮特
Epton	埃普顿
Clift	克利夫特
McGroarty	麦格罗蒂
Huckshorn	赫克肖恩
Wiarda	威亚尔达
Bendethen	本德森
Covalesky	科瓦列斯基
Burgoyne	伯戈因
Aylett	艾利特
Deslandes	德朗德
Cotlow	科特洛
Beith	比思
Satchell	萨切尔
Royster	罗伊斯特
Wittenbach	威滕巴克
Neckam	尼卡姆
Munch	芒奇
Genung	杰农
Mitchelson	米切尔森
Krause	克劳斯
Seever	西弗
Marcom	马科姆
Kummings	库明斯
Baroody	巴鲁迪
Hasty	黑斯蒂
Sites	赛茨
Heefner	希夫纳
Gustlin	古斯特林
Canfield	坎菲尔德
Bataille	巴塔伊
Jobe	乔布
Steddom	斯特多姆
Comerer	科默勒
Lesser	莱塞
Seppy	塞比
Maidie	梅迪
Pellini	佩利尼
Scollon	斯科隆
Hougen	霍根
Loudoun	劳登
Abernathy	阿伯内西
Parham	帕勒姆
Schumaker	休梅克
Frito	弗里托
Borgading	博加丁
Huntingfield	亨廷菲尔德
Camron	卡姆伦
Aldun	奥敦
Dargue	达格
Klontz	克朗茨
Seversky	塞维尔斯基
Bursey	伯西
Bright	布赖特
Duret	迪雷
Cohroy	科罗伊
Heidbreder	海德布雷德
Wallbank	沃尔班克
Dopping	多平
Carlingford	卡林福德
Belesme	贝莱姆
Gerhold	格霍尔德
Kerchum	克尔楚姆
Liddell	利德尔
Gisvold	吉斯沃尔德
Ayana	艾安娜
Halki	霍尔基
Philby	菲尔比
Himsworth	希姆斯沃思
Brandin	布兰丁
Erwitt	厄威特
Saris	萨里斯
Voisey	沃伊齐
Erwin	欧文
Goodby	古德拜
Justman	贾斯特曼
Barriere	巴里尔
Darbishire	达比希尔
Penlington	彭林顿
Boothby	布思比
Zachem	扎克姆
Foord	富德
Stockley	斯托克利
Gardin	加丁
Reft	雷夫特
Palme	帕姆
Iscoe	伊斯科
Corddry	科德里
Ricklefs	里克莱夫斯
Purviance	珀维安斯
Dowlin	道林
Sheeder	希德
Selcke	塞尔克
Lewey	卢伊
Fertell	费特尔
Fortuin	福泰因
Nacler	纳克勒
Coy	科伊
Ehrensberger	埃伦斯伯格
Lere	勒尔
Ballarat	巴勒拉特
Streatfield	斯特里特菲尔德
Hyde	海德
Bergman	伯格曼
Elswyth	埃尔斯威思
Lobenstine	洛本斯坦
Hulick	赫利克
Shockley	肖克利
Havey	哈韦
Strattner	斯特拉特纳
Helfrecht	赫尔弗雷克特
Frisina	弗里西纳
Gourevitch	古雷维奇
Finnemore	芬尼莫尔
Faul	福尔
Boyko	博伊科
Marr	马尔
Lutes	卢茨
Nassetta	纳塞塔
Staker	斯泰克
Creveling	克里夫林
Waldheim	瓦尔德海姆
Olmo	奥尔莫
Stofan	斯托凡
Fressanges	弗雷桑热
Rombauer	龙鲍尔
Wistar	威斯塔
Zoretich	佐尔蒂奇
Brokenshire	布罗肯希尔
Arbon	阿尔邦
Eudora	尤多拉
Hedley	赫德利
Nepote	尼波特
McAnany	麦卡纳尼
Dukana	杜卡娜
Osterloff	奥斯特洛夫
Myra	迈拉
Kebbon	凯本
Sigur	西古尔
Brownjohn	布朗约翰
Boelter	贝尔特
Weatherhill	韦瑟希尔
Renold	雷诺
Caroll	卡罗尔
Solborg	索尔伯格
Gaston	加斯顿
Hegarty	赫加蒂
Toot	图特
Maruff	马勒夫
Fernald	弗纳尔德
Haddy	哈迪
Hafer	哈弗
Ganas	加纳
Gytha	吉莎
Riegger	里格
Eliphalet	伊利法莱特
Williamson	威廉森
Difford	迪福德
Iremonger	艾尔芒格
Burdett	伯德特
Ireson	艾尔森
Macilriach	麦基里亚克
Boyes	博伊斯
Elswood	埃尔斯伍德
Stayer	斯特耶
Kroenke	克伦克
Salley	萨利
Schoch	肖赫
Kesting	凯斯廷
Salvador	萨尔瓦多
Nel	内尔
Duncalf	邓卡夫
Ormelie	奥米利
Lybrook	利布鲁克
Overmiller	奥弗米勒
Ingels	英格尔斯
Hersman	赫斯曼
Horstmyer	霍斯特迈耶
McGuffin	麦古芬
Kenney	肯尼
Smither	史密瑟
Bondley	邦德利
Darvall	达瓦尔
Tyrwhitt	蒂里特
Guizard	吉扎德
Schollander	斯科兰德
Volze	沃尔兹
Pashley	帕什利
Holmyard	霍姆亚德
Ballam	巴勒姆
Bortree	博特里
Hermening	赫梅宁
Feodora	费奥多拉
Maki	梅基
Azrael	阿兹雷尔
Owlett	奥利特
Lubell	卢贝尔
Ozell	奥泽尔
Ouchi	乌奇
Humes	休姆斯
Megronigle	梅格罗尼格尔
Ennever	恩尼弗
Dake	戴克
Leveck	莱韦克
Curll	柯尔
Stredwick	斯特雷德威克
Schweimler	施韦姆勒
Dawbney	道布尼
Foran	福伦
Tessler	特斯勒
Woodville	伍德维尔
Georgiade	乔治亚德
Matalin	马塔林
Macvey	麦克维伊
Amisano	阿米萨诺
Mittemeyer	米特迈耶
Poos	普斯
Angermueller	安杰米勒
Hallows	哈洛斯
Eagleburger	伊格尔伯格
Camelon	卡默伦
Treverton	特雷弗顿
Bryfonski	布里方斯基
Grissinger	格里辛格
Sheble	谢布尔
Tatom	塔托姆
Myrlie	迈利
Steyaert	斯泰亚特
Heyligher	海利格
Schifter	希夫特
Jaquest	杰奎斯特
Pepe	佩佩
Tague	塔格
Teeling	蒂林
Kevles	凯夫利斯
Netsch	内奇
Docker	多克尔
Mobley	莫布利
Gabelman	加贝尔曼
Joines	乔因斯
Yendell	延德尔
Taintor	泰恩托
Myrs	迈尔斯
Molyneux	莫利纽克斯
Spiegelblatt	施皮格尔布拉特
Dan	丹
Fitzgibbon	菲茨吉本
Kleinman	克兰曼
Bachman	巴克曼
Allchin	奥尔欣
Capice	卡皮斯
Mascarenhas	马什卡雷尼亚什
Rottet	罗泰特
Hobley	霍布利
Minear	迈尼尔
Conroe	康罗
Bednarek	贝德纳雷克
Bacharach	巴卡拉克
Cantini	坎蒂尼
Gosson	戈森
Conchubhar	康丘巴尔
Blucke	布卢克
Frankino	弗兰基诺
Culbertson	卡伯特森
Barbey	巴比
Elegant	埃勒根特
Reubens	鲁本斯
Shortlidge	肖特利奇
Overby	奥弗比
Sargis	萨吉斯
Laise	莱斯
Yannick	扬妮克
Gilgore	吉尔戈尔
Phyllida	菲莉达
Knecht	克内克特
Langeler	兰格勒
Dakin	戴金
Donati	多纳蒂
Dolley	多利
McMindes	麦克明兹
Baerreis	贝雷斯
Tishman	蒂什曼
Blatnik	布拉特尼克
Cheskaty	切斯卡蒂
Lederman	莱德曼
Amey	埃米
Combes	库姆斯
Pulfer	普尔弗
Hemke	赫姆克
Princus	普林克斯
Lemass	勒马斯
Lardy	拉迪
Falbraith	法尔布雷思
Downey	唐尼
Wallgeren	沃尔格伦
Birnsingl	伯恩辛格尔
Axtmann	阿克斯特曼
Daulton	道尔顿
Guindi	金迪
Michelham	米彻勒姆
Foxlee	福克斯利
Raper	雷珀
Pankhurst	潘克赫斯特
Tiefel	蒂费尔
Ridder	里德
Diversey	戴弗西
Englesmith	恩格尔史密斯
Sorgeloost	索奇卢斯特
Gilstein	吉尔斯坦
Tovey	托维
Roots	鲁茨
Fly	弗莱
Pall	帕尔
Firebaugh	法尔博
Hosenball	霍森鲍尔
Hosler	霍斯勒
Osmanski	奥斯曼斯基
Unteriner	昂特里纳
Emmer	埃默
Tracer	特雷瑟
Vandiveer	范迪维尔
Bernadette	贝尔纳黛特
Meyrick	梅里克
Hauksbee	霍克斯比
Desborough	德斯伯勒
Willing	威林
Kosner	科斯纳
Caracristi	卡拉克里斯蒂
Millsap	米尔萨普
Inderfurth	因德弗思
Weinman	温曼
Feidler	费德勒
Pinwill	平威尔
Siple	赛普尔
Medrano	梅德拉诺
McCarrison	麦卡里森
Jaden	杰登
Erleigh	厄利
Hovanesian	霍瓦尼西安
Prall	普劳尔
Malige	马利奇
Baugh	鲍
Verdier	维迪尔
Whitelaw	怀特洛
Meikleham	米克勒姆
Saubergue	索伯格
Wilk	威尔克
Melsa	梅尔萨
Garvin	加文
Rohrabacher	罗拉巴克尔
Oberholtzer	奥伯霍尔策
Boz	博兹
Allaun	阿朗
Moosbrugger	穆斯布鲁格
Fouchard	福查德
Senhouse	森豪斯
Wetherby	韦瑟比
Millhiser	米尔希泽
Selznick	塞尔兹尼克
Hington	欣顿
Durkan	德坎
Sehrt	塞尔特
Micks	米克斯
Ebersold	埃伯索尔德
Salner	萨尔纳
Jury	朱里
Thurkettle	瑟克特尔
Leo	利奥
Elder	埃尔德
Craig	克雷格
Enulty	伊纳尔蒂
Cullinan	卡利南
Christ	克赖斯特
Solowey	索洛韦
Lowell	洛厄尔
Rudney	鲁德尼
Sinnatt	辛纳特
Chernow	切尔诺夫
Kameron	卡梅伦
Rignall	里格纳尔
Ells	埃尔斯
Margetts	马吉茨
Gresley	格雷斯利
Ingelram	英杰拉姆
Mabbott	马博特
Okell	奥克尔
Grave	格雷夫
Christopherson	克里斯托弗森
Steese	斯蒂斯
Meisenhelder	迈森黑尔德
Werther	沃瑟
Glassmeyer	格拉斯迈耶
Ockham	奥卡姆
Biblowitz	比布洛维茨
Cashel	卡谢尔
Zlotnick	兹洛特尼克
Fischbach	菲施巴赫
Stilwell	史迪威
Bamberg	班伯格
Stothard	斯托瑟德
Feffery	费弗里
Kinnear	金尼尔
Brinkhous	布林克豪斯
Quilter	奎尔特
MacQuigg	麦奎格
Phalen	弗伦
Noce	诺斯
Vavasour	瓦瓦苏
Bavis	巴维斯
Binz	宾兹
Gettell	格特尔
Coode	库德
Lovill	拉维尔
Baruck	巴鲁克
Halliwell	哈利韦尔
Netta	妮特
Fliegers	弗利格斯
Gardner	加德纳
Lansing	兰辛
Breckenridge	布雷肯里奇
Batliner	巴特利纳
Ekeblad	埃克布拉德
Hapke	哈普克
Bergsma	伯格斯马
Nankivell	南基韦尔
Kaelin	凯林
McLuskie	麦克拉斯基
Duncliffe	邓克利夫
Hekking	赫金
Edmonton	埃德蒙顿
Pendrous	彭德勒斯
Bagila	巴吉拉
Mancill	曼西尔
Lempfert	伦普弗特
Yarger	亚格尔
Arpad	阿帕德
Bax	巴克斯
Kuykendall	凯肯德尔
Catterns	卡滕斯
Zacca	扎卡
Mueller	米勒
Pattrick	帕特里克
Tarnopol	塔诺波尔
Sammond	萨蒙德
Foley	福利
Omeara	奥米拉
Salls	索尔斯
Schoenherr	舍恩赫尔
Milly	米利
Magge	玛吉
Finis	菲尼斯
Lewlin	卢林
Broady	布罗迪
Weiby	韦比
Baumgartel	鲍姆加特尔
Althoff	奥尔索夫
Annais	安奈丝
Huffstutler	赫夫斯塔特勒
Courville	考维尔
Yassky	亚斯基
Vining	瓦伊宁
Kolpitts	科尔皮茨
Mariano	马里亚诺
Munnery	芒内里
Fyers	法尔斯
Pegrum	佩格勒姆
Pavloska	帕夫洛斯卡
Synon	赛农
Rossetti	罗塞蒂
Obermiller	奥伯米勒
Giniger	吉尼格
Budd	巴德
Broger	布罗格
Gerdes	格迪斯
Creton	克雷顿
Eimer	艾默
Lillitos	利利托斯
Gitelman	吉特尔曼
Byntom	宾托姆
Maslin	马斯林
Romain	罗曼
Barban	巴尔班
Daingerfield	丹杰菲尔德
Rettie	雷蒂
Ikenson	伊肯森
Pitter	皮特
Maccio	马乔
Iliffe	艾利夫
Cottrill	科特里尔
Hanpton	汉普顿
Smuck	斯马克
Levitt	莱维特
Rander	兰德
Glennan	格伦南
Maccombie	麦康比
Lyles	莱尔斯
Nielsen	尼尔森
Prevatt	普雷瓦特
Debutts	德巴茨
Maltwood	马尔特伍德
Milborough	米尔博萝
Blickwede	布利克韦德
Blaquiere	布拉基埃
Diederich	迪德里希
Kuper	库珀
Bourk	伯克
Gusfield	古斯菲尔德
Cullison	卡利森
Wenitong	韦尼通
Frumkin	弗鲁姆金
Stelzle	斯特尔兹利
Stoll	斯托尔
Anshaw	安肖
Angleman	安格尔曼
Arrol	阿罗尔
Corruccini	科鲁奇尼
Dellas	德拉斯
Grory	格罗里
Gabbay	加贝
Bass	巴斯
Medwin	梅德温
Schriber	施赖伯
Colvill	科尔维尔
Madia	马迪亚
Marke	马克
Wormington	沃明顿
Taffe	塔夫
Slonaker	斯洛内克
Garpow	加波
Corrado	科拉多
Geismar	盖斯马
Borst	博斯特
Zeh	泽
Nove	诺夫
Feutz	福伊茨
Huff	赫夫
Sparham	斯帕汉
Latchum	拉彻姆
Gus	格斯
Blunsum	布伦瑟姆
Mink	明克
Frieght	弗雷特
Norman	诺曼
Hodel	霍德尔
Salathiel	萨拉西埃尔
Leisenring	莱森林
Keesey	基西
Dugal	杜加尔
Ameel	埃米尔
Bachauer	巴乔尔
Valdiserri	瓦尔迪塞里
Kristofferson	克里斯托弗森
Mezey	梅齐
Tandem	坦德姆
Carruth	卡鲁思
Coulling	库林
Maylon	梅伦
Zetlin	泽特林
Sack	萨克
Leinsdorf	莱因斯多夫
Karageannes	卡拉金斯
Eyden	艾登
Brighid	布丽吉德
McGusty	麦格斯蒂
Squadrilat	斯夸德里拉特
Plumleigh	普拉姆利
Tead	蒂德
Macleskey	麦克莱斯基
Hoyer	霍耶
Saralinda	萨拉琳达
Rushing	拉欣
Sporkin	斯波金
Caper	卡珀
McLane	麦克莱恩
MacKinnon	麦金农
Kittoe	基托
Schanche	尚克
Taze	泰兹
Defabis	德法比斯
Reiser	赖泽
Peacre	皮克
Dosik	多西克
Slover	斯洛弗
Rawley	罗利
Person	珀森
Grumich	格鲁米奇
Tinley	廷利
Horovitz	霍罗维茨
Brotemarkle	布罗特马克尔
Nuckolls	纳科尔斯
Utgoff	乌特戈夫
Bromelow	布罗米洛
LeVesconte	勒韦康特
Verulam	韦鲁勒姆
O'Grad	奥格拉德
Spreiregen	施普赖雷根
Bargeron	巴杰伦
Daniella	丹妮拉
Letoumeau	勒图莫
Mehren	梅伦
Sinz	辛兹
Lohr	洛尔
Hytier	海蒂尔
Lubel	卢贝尔
Carlee	卡莉
Marsingall	马辛格尔
Roxie	罗克西
Allance	阿伦斯
Debra	德布拉
Rosenau	罗西瑙
Carrier	卡里尔
Brundidge	布伦迪奇
Yoest	约斯特
Dechar	德查尔
Jonet	琼妮特
Lueders	利德斯
Landefeld	兰德费尔德
Vibert	维贝尔
Bacall	巴考尔
Volpe	沃尔普
Manser	曼瑟
Mosich	莫西克
Cuccia	卡西亚
Boorady	布拉迪
Blakemore	布莱克莫尔
Borgman	博格曼
DeWolf	德沃尔夫
Niemeyer	尼迈耶
Uicker	尤克
Willins	威林斯
Nadzo	纳佐
Grigg	格里格
Ahern	埃亨
Swiney	斯威尼
Stapleton	斯特普尔顿
Paxman	帕克斯曼
Delmore	德尔莫尔
Noble	诺布尔
Vergil	弗吉尔
Lysaght	莱萨特
Mochrie	莫克里
Holdgreiwe	霍尔格雷韦
Bohrod	博罗德
Berkemeyer	伯克迈耶
Kusserow	库斯罗
Chrissy	克丽茜
Greives	格里夫斯
LeFondre	勒方德雷
Strangman	斯特兰曼
Michelli	米凯利
Arango	阿朗戈
Pashby	帕什比
Meshech	米谢克
Buker	布克
Dlab	德拉布
Bruenn	布鲁恩
Ostler	奥斯特勒
Faussett	福塞特
Tagg	塔格
Scherbacher	谢尔巴赫
Coatsworth	科茨沃思
Lybecker	利贝克
Orders	奥德斯
Madland	马德兰
Awes	奥斯
Hannen	汉嫩
Aude	奥德
Dial	戴尔
Goldbeck	戈德贝克
Barkan	巴坎
Dixon	狄克逊
Glazer	格莱泽
Columbine	科伦拜恩
Lederer	莱德勒
Legum	利格姆
Eggan	埃根
Billes	比尔斯
Millimet	米利米特
Garrigue	加里格
McGinness	麦金尼斯
Kalischer	卡利舍
Muro	穆罗
Brionna	布里奥娜
Carmichael	卡迈克尔
Lashman	拉什曼
Foch	福克
Ashcombe	阿什科姆
Pawson	波森
Newlands	纽兰兹
Conston	康斯顿
McCoy	麦科伊
Waddups	沃杜普斯
Goldstein	戈尔茨坦
Herford	赫福德
Boon	布恩
Stonestreet	斯通斯特里特
Altgeld	奥尔特盖尔德
Eggerton	埃格顿
Claar	克拉尔
Gipsy	吉普赛
Peatfield	皮特菲尔德
Eneas	埃尼亚斯
Cranstoun	克兰斯顿
Bulkley	巴尔克利
Semsrott	森斯罗特
Gamper	甘珀
Vallender	瓦伦德
Gittings	吉廷斯
Bouvier	布维尔
Emmeluth	埃米卢思
Valenti	瓦伦蒂
Ditmore	迪特莫尔
Dolce	多尔斯
Ellig	埃利希
Solana	索拉纳
Imbault	安博
Dushkin	杜什金
Depalma	德帕尔马
Southampton	索桑普顿
Pagett	佩吉特
Morten	莫滕
Barkman	巴克曼
Goffney	戈夫尼
Spross	斯普罗斯
Feirstein	费尔斯坦
Class	克拉斯
Atkinson	阿特金森
Ilutovich	伊卢托维奇
Rouvelas	鲁维拉斯
Schaddelee	谢德利
Deangelo	迪安杰洛
Beauclerk	博克莱尔
Lessing	莱辛
Bonfante	邦凡特
Sigurdson	西格森
Hanson	汉森
Lavora	拉沃拉
Vaughan	沃恩
Foght	福特
Endsley	恩兹利
Heck	赫克
Coblenz	科布伦茨
Cristol	克里斯托尔
Prokosch	普罗科施
Malachy	马拉奇
Mollica	莫利卡
Roach	罗奇
O'Mard	奥马德
Caspersen	卡斯佩森
Jayson	杰森
Clagget	克拉格特
McMurry	麦克默里
Hugh	休
Denunzio	德农西奥
Sagalyn	萨加林
Schacter	沙克特
Krimendahl	克里门达尔
Galane	加兰
Taunton	汤顿
Horlacher	霍利克
Worster	沃斯特
Mcguirt	麦吉尔特
Reynfred	雷恩弗雷德
Seamgar	西姆加
Frances	弗朗西丝
Molen	莫伦
MacIlhatton	麦基尔哈顿
Hannaford	汉纳福德
Kutschbcach	库奇布卡克
Oseberne	奥斯本
Troquer	特罗克
Housden	豪斯登
Chedsey	切德西
Winchilsea	温奇尔西
Marasco	马拉斯科
Burrill	伯里尔
Blakenham	布莱克纳姆
Messmore	梅斯莫尔
Jerool	杰鲁尔
Dowen	道恩
Merkin	默金
Graven	格雷文
Flemming	弗莱明
Northfield	诺思菲尔德
Jewkes	朱克斯
Pfeiffenberger	法伊芬伯格
Keenum	基纳姆
Charyk	查里克
Stanvick	斯坦维克
Preyer	普赖尔
Cutchan	卡琴
Placeres	普拉塞雷斯
Edisbury	埃迪斯伯里
Berthan	伯森
Sattler	萨特勒
Poetker	波特克
Altermann	奥尔特曼
Swoap	斯沃普
McIntye	麦金蒂
Baumel	鲍梅尔
Bunford	邦福德
Con	康
Bartholow	巴塞洛
Roulston	鲁尔斯顿
Monninger	蒙宁格
Rojas	罗贾斯
Ansorge	安索奇
Rosenblum	罗森布拉姆
Holder	霍尔德
Zorbaugh	佐尔博
Kupka	库普卡
Balzer	鲍尔泽
Protasia	普罗塔西娅
Maccombe	麦库姆
Burkee	伯基
Tombros	汤布罗斯
Thurley	瑟利
Coulton	库尔顿
Destini	德斯蒂妮
Astuto	阿斯图托
Vorontsov	沃龙佐夫
Petherick	佩瑟里克
Fino	菲诺
Stoddard	斯托达德
Gummery	加默里
Southby	索思比
Osolin	奥索林
Suggs	萨格斯
Birman	伯曼
Sedlar	塞德拉
Minehan	迈尼汉
Lauwerys	劳韦里斯
Kronholz	克朗霍尔兹
Bowden	鲍登
Travis	特拉维斯
Gracht	格拉赫特
Bussone	巴索恩
Gantz	甘茨
Probert	普罗伯特
Lafontaine	拉方丹
Hunting	亨廷
Giamio	贾米奥
Dribbon	德里本
Adamina	阿达米娜
Copeland	科普兰
Berrington	伯林顿
Hooton	胡顿
Sawyers	索耶斯
Winegar	瓦恩加
Leask	利斯克
Zayek	扎耶克
Quarles	夸尔斯
Haag	哈格
Engelhard	恩格尔哈德
Menden	门登
Lundbeck	伦德贝克
Neil	尼尔
Gottwals	戈特沃尔斯
Overfield	奥弗菲尔德
Canoyer	卡诺耶
Mussen	马森
Benoni	贝诺尼
Hulman	哈尔曼
Fausett	福塞特
Arnwine	安瓦恩
Bollenbach	博伦巴克
Michelfelder	米歇尔菲尔德
Baber	巴伯
Dalzell	达尔泽尔
Dunipace	杜尼佩斯
Joad	乔德
Frommelt	弗罗梅尔特
Longden	朗登
Hurlburt	赫尔伯特
Pirson	皮尔逊
Pantlin	潘特林
Uthwatt	厄思沃特
Woodruff	伍德拉夫
Spradlin	斯普拉德林
Shute	舒特
Hugget	休格特
Eastburn	伊斯特本
Tedlock	特德洛克
Ersek	厄塞克
Morcos	莫尔科斯
Mankin	曼金
Sneddon	斯内登
Howie	豪伊
Vygmunt	维格蒙特
Schlieder	施利德
Seonad	塞奥娜德
Brayman	布雷曼
Katchen	卡琴
Popeo	波佩奥
Novel	诺韦尔
McNamara	麦克纳马拉
Massengale	马森盖尔
Casady	卡萨迪
Macilvrae	麦基尔夫雷
Dillard	迪拉德
Giller	吉勒
Baade	巴德
Morvant	莫文特
Gallop	盖洛普
Georgiades	乔治亚兹
Cockett	科克特
Lauth	劳思
Devereux	德弗罗
Ruskins	拉斯金斯
Medvecky	梅德韦茨基
Papperman	佩珀曼
Gingham	金厄姆
Cuckler	卡克勒
Duff	达夫
Schoen	舍恩
Thornycroft	桑尼克罗夫特
Goulet	古利特
Gness	内斯
Stragnell	斯特拉格内尔
Mansley	曼斯利
McNalty	麦克纳尔蒂
Beamsley	比姆斯利
Ivison	艾维森
Mallery	马勒里
Dwelley	德韦利
Amourette	阿穆雷特
Ashkenazy	阿什克纳齐
Brahams	布雷厄姆斯
Panter	潘特
Claudette	克劳德特
Hauserman	豪泽曼
Gomez	戈麦斯
Schoutze	舒策
Magarshack	马格沙克
Burmeister	伯迈斯特
Mudaliar	马达利尔
Ralphs	拉尔夫斯
Wykle	威克尔
Minchin	明钦
Wurman	沃尔曼
Juris	朱里斯
Christobelle	克丽丝托贝尔
Poppen	波彭
Welldon	韦尔登
Sprecher	斯普雷彻
Musial	穆夏尔
Greifer	格雷弗
Bigart	比加特
Athos	阿索斯
Munn	芒恩
Godding	戈丁
Fabricius	法布里修斯
Jowell	乔韦尔
Bloggs	布洛格斯
Besnard	贝纳德
Danby	丹比
Gilham	吉勒姆
Hab	哈布
Hemily	赫米利
Bibertein	比伯坦
Macfarquher	麦克法奎尔
McGroarth	麦克格罗蒂
Mich	米奇
Ampthill	安普西尔
Finnigan	芬尼根
Riegle	里格尔
Sturmer	斯特默
Cumberland	坎伯兰
Bingaman	宾加曼
Ledyard	莱迪亚德
Kingsburgh	金斯伯勒
Youel	尤埃尔
Varona	瓦罗纳
Morandini	莫兰迪尼
Paver	佩弗
Limbert	林伯特
Teichman	泰克曼
Clabaugh	克莱博
Fleischman	弗莱施曼
Cozzarelli	科扎雷利
Ogerus	奥格勒斯
Cattau	卡托
Dawis	戴维斯
Steinseifer	斯坦塞弗
Barnfield	巴恩菲尔德
Abigail	阿比盖尔
Degville	德格维尔
Rosmead	罗斯米德
Pinkney	平克尼
MacLyn	麦克林恩
Lobdell	洛布德尔
Pomeroy	波默罗伊
Tjaart	恰尔特
Byington	拜因顿
Somerton	萨默顿
Ballenden	巴伦登
Blotner	布洛特纳
Gruffy	格鲁菲
Bassford	巴斯福德
Bodkin	博德金
Freeberg	弗里伯格
Willbern	威尔伯恩
Korten	科滕
Desvaux	德沃
Motyer	默蒂耶
Houseman	豪斯曼
Beffort	贝福特
Backers	巴克斯
Macsween	麦克斯温
Currer	柯勒
Mulliken	马利肯
Mangun	曼根
Leburn	利伯恩
Claytor	克莱特
McGarity	麦加里蒂
Elisha	伊莱沙
Haye	海
Koepfli	凯夫利
Kunen	丘嫩
Clanricarde	克兰里卡德
Birbeck	伯贝克
Boone	布恩
Stix	斯蒂克斯
Amisius	埃米修斯
Clasper	克拉斯珀
Tosteson	托斯特森
Spellings	斯佩林斯
Neiderlehner	奈德莱纳
Piercy	皮尔西
Gessner	格斯纳
Clarie	克拉里
Lakin	莱金
Whitefoot	怀特富特
Thorsteinsson	索尔斯坦森
Ramaker	拉梅克
Duckett	达克特
Hartery	哈特里
Lemnitzer	莱姆尼策
Upcott	厄普科特
Limon	利蒙
Turnblad	特恩布拉德
Ashfield	阿什菲尔德
Fernau	费诺
Nemesius	内梅修斯
Brautbar	布劳特巴
Cready	克里迪
Herberger	赫伯格
Zellman	泽尔曼
Garsia	加西亚
Connar	康纳
Stogner	斯托格纳
Minkel	明克尔
Krumbein	克伦宾
Ansberry	安斯伯里
Hazouri	哈祖里
Pellow	佩洛
Trotman	特罗特曼
Walsworth	沃尔斯沃思
Mullenax	马莱纳克斯
Gracia	格拉西亚
Streeyter	斯特里特
Oyloe	奥伊洛
Hoskins	霍斯金斯
Toole	图尔
Mallabar	马拉巴尔
Epham	埃法姆
Damm	达姆
Reutlinger	罗伊特林格
Coulthard	库尔撒德
Tampell	坦佩尔
Mattera	马特拉
Quirke	夸克
Hamiter	哈米特
Brahm	布拉姆
Alexanian	亚历克萨尼安
Lockett	洛基特
Nickells	尼克尔斯
Hagarty	哈格蒂
Tulving	塔尔文
Enersen	埃纳森
Middelkamp	米德尔坎普
Swirbul	斯沃巴尔
Carlsson	卡尔森
Charleston	查尔斯顿
Hazel	黑兹尔
Magian	马吉恩
Shewen	休恩
Truskier	特拉斯基尔
Paschke	帕施克
Bicester	比斯特
Houbrick	霍布里克
Frigoletto	弗里戈莱托
McComic	麦科米克
Coupe	库普
Stiffler	斯蒂夫勒
Rodieck	罗迪克
Leathes	利斯
Fairman	费尔曼
Weinbaum	温鲍姆
Wannour	万努尔
Yvonne	伊冯娜
Canine	卡奈因
Meinwald	迈因沃尔德
Dietz	迪茨
Tanguy	坦吉
Royds	罗伊兹
Micklin	米克林
Mohun	莫恩
Leak	利克
Fredell	弗雷德尔
Laeri	莱里
Doutt	杜特
Buccino	布奇诺
Fassel	法斯尔
Maletta	马利塔
Vittum	维图姆
Dybeck	迪贝克
Edmunds	埃德蒙兹
Augulis	奥古利斯
Rummel	拉梅尔
Canan	卡南
Willcox	威尔科克斯
Annadale	安娜代尔
Baez	贝兹
Vautelet	沃特莱特
MacKerodt	麦克罗特
Rubottom	鲁博特姆
Christo	克里斯托
Gullett	格莱特
Amooti	阿穆蒂
Riddell	里德尔
Tilbur	蒂尔伯
Lieberson	利伯森
Bergesch	伯格施
Provan	普罗文
Sentz	森茨
Wearmouth	韦尔茅斯
DeVries	德弗里斯
Katzki	卡茨基
Malim	马利姆
Jorgensen	乔根森
Goodbar	古德巴
Cooledge	库利奇
Waldbauer	沃尔鲍尔
Lenihan	勒尼汉
Firstenberg	弗斯滕伯格
Dahlin	达林
Pipkin	皮普金
Kneiss	尼斯
Kummel	库梅尔
Ingrey	英格里
Overstone	奥弗斯通
McNeeley	麦克尼利
Broeker	布勒克
Carolus	卡罗勒斯
Sherbone	舍伯恩
Thacher	撒切尔
Wet	韦特
Delleur	德勒
Riehlman	里尔曼
Aarsleff	阿尔斯莱夫
Burgan	伯根
Craigmile	克雷格迈尔
Knable	克纳布尔
Munroe	芒罗
Byergo	拜尔戈
Perlow	珀洛
Madill	马迪尔
Deitrick	戴特里克
Redifer	雷迪弗
Steinberger	施泰因贝格尔
Nunally	纽纳利
Kauth	考思
Rebhann	雷布汉
Haslett	哈斯利特
Broadaway	布罗德韦
Replogle	里普洛格尔
Peurifoy	普里福伊
Fanta	范塔
Dinnerstein	迪纳斯坦
Jefferson	杰斐逊
Bercovitz	伯科维茨
Concordia	康科迪娅
Gellis	盖利斯
Gonigal	戈尼格尔
Blumstein	布卢姆斯坦
Whistler	惠斯勒
Lobban	洛班
Augier	奥吉尔
Kuyk	凯克
Mistry	米斯特里
Billingham	比林厄姆
Orable	奥拉布尔
Brouard	布鲁瓦德
Chaloner	查洛纳
Hocott	霍科特
Foye	福伊
Giovene	乔维尼
Sawbridge	索布里奇
Grebenik	格里布尼克
Lagan	拉根
Flemington	弗莱明顿
Catchpool	卡奇普尔
Huertematte	许尔特马特
Sweedler	斯威德勒
Drugo	德鲁戈
Jahant	杰汉特
Harary	哈拉里
Rewbell	鲁贝尔
Briand	布赖恩德
Sammons	萨蒙斯
Elcano	埃尔卡诺
Tretler	特雷特勒
Mangan	曼根
Alfleda	阿尔夫莉达
Cousy	库西
Coldhurst	科尔德赫斯特
Ginger	金杰
Twyman	特怀曼
Hodierna	霍迪娜
Sego	塞戈
Brunson	布伦森
Mosconi	莫斯科尼
McClaughry	麦克劳里
Foukner	福克纳
Forrester	福里斯特
Ging	金
Oberschmidt	奥伯施密特
Fatt	法特
Hultgren	赫尔特格伦
Hochschild	霍克希尔德
MacGillivray	麦吉利夫雷
Horacio	奥拉西奥
McFadzean	麦克法迪恩
Hasket	哈斯克特
Wyant	怀恩特
Terrick	特里克
Goetz	戈茨
Cordover	科多弗
Emlet	埃姆莱特
Haverlin	哈弗林
Loughnane	洛克南
Sword	索德
Shifter	希夫特
Ronnfeldt	龙费尔特
Gunyon	加尼恩
Sollins	索林斯
Rothschild	罗思柴尔德
Tuholski	图霍尔斯基
Gaiani	盖亚尼
Yurchenco	尤尔琴科
Slevin	斯莱文
Southerwood	萨瑟伍德
Sayler	塞勒
Dines	丹斯
Bronwen	布朗温
Bench	本奇
Shlaes	什莱斯
Foehl	福尔
Lattu	拉图
Goler	戈勒
Jelstrup	杰尔斯特鲁普
Murcer	默瑟
Frieske	弗里斯克
Radix	雷迪克斯
Petermann	彼得曼
Lethington	莱辛顿
Vrooman	弗鲁曼
Cleborne	克利伯恩
LeMay	勒梅
Edic	伊迪克
Rakof	雷科夫
Crist	克里斯特
Bevins	贝文斯
Haneke	哈尼克
Zwolenik	兹沃莱尼克
Eister	艾斯特
Hibbs	希布斯
Eusebius	尤西比厄斯
Swiggett	斯威格特
Selman	塞尔曼
Parle	帕尔
Merkowitz	默科维茨
Muehrcke	米尔克
Delomosne	德洛莫恩
Gertler	格特勒
Bolos	博洛斯
Pincus	平卡斯
Flegenheimer	弗莱根海默
Elota	埃洛塔
Hallaren	哈拉伦
McMurrin	麦克默林
Butterbrodt	巴特布罗特
Cotten	科滕
Given	吉文
Knickrehm	尼克雷姆
Tigay	蒂盖
Eames	埃姆斯
Steinbach	斯坦巴克
Brentford	布伦特福德
Lisle	莱尔
Buckhurst	巴克赫斯特
Orville	奥维尔
Fairless	费尔利斯
Stanyan	斯塔尼安
Artinian	阿尔蒂尼安
Biermann	比尔曼
Edel	埃德尔
Seaton	西顿
Krist	克里斯特
Tonitz	托尼茨
Gercke	格尔克
Krajeski	克拉耶斯基
Gehrig	格里克
Herschell	赫舍尔
Detwiller	德特威勒
Caborn	卡博恩
Waghen	沃恩
Bools	布尔斯
Codere	科德尔
Gennadios	金纳迪奥斯
Monical	莫尼卡尔
Rosengarden	罗森加登
Lune	伦
Ailuin	艾尔温
Clinkscales	克林克斯凯尔斯
Orlan	奥伦
Sabine	萨拜因
Parrott	帕罗特
Fidel	菲德尔
Ladds	拉兹
Wyck	怀克
Adalbert	阿德尔伯特
Rochon	罗尚
Croly	克罗利
Fitter	菲特
Norna	诺娜
Chotard	肖塔尔
Mulvey	马尔维
McGonigle	麦戈尼格尔
Whitwam	惠特瓦姆
Osheim	奥谢姆
Arbitman	阿比特曼
DeProspero	德普罗斯佩罗
Maclewis	麦克刘易斯
Patric	帕特里克
Wilstein	威尔斯坦
Hockema	霍克马
Swankin	斯旺金
Chadbourn	查德伯恩
Gieve	吉夫
Grabowski	格拉博夫斯基
Crewdson	克鲁森
Pretyman	普雷蒂曼
Kimball	金博尔
Jewson	朱森
Brion	布里翁
Gaenor	盖诺
Bontine	邦廷
Yalen	亚伦
Busciglio	布希利奥
Gulton	古尔顿
Felder	费尔德
Geertsma	吉尔茨马
Onstot	昂斯托特
Lattey	拉蒂
Dutt	达特
O'Kennedy	奥肯尼迪
Leacacos	利卡科斯
Straight	斯特雷特
Boggess	博格斯
Lympany	林帕尼
Adkinson	阿德金森
Golan	戈兰
Bathe	巴思
Magin	梅金
Ord	奥德
Enter	恩特
Skea	斯基
Loree	洛里
Choate	乔特
Macachallies	麦卡查利斯
Casmus	卡斯默斯
Gag	加格
Mennell	门内尔
Nelsen	内尔森
Dilly	迪利
Swinton	斯温顿
Edmondson	埃德蒙森
Saurat	索拉特
Buttolph	巴托尔夫
Szlumper	斯朗珀
Barthelme	巴特尔梅
Batho	巴索
Zobel	佐贝尔
Jostens	乔斯滕斯
Buckalew	巴卡柳
Whirter	沃特
Railton	雷尔顿
Kolbe	科尔比
Lates	莱茨
Ezra	埃兹拉
Collister	科利斯特
Huguet	休格特
Devan	德万
Mullis	穆利斯
Porras	波拉斯
Fern	弗恩
Bunte	邦特
Iggers	伊格斯
Previn	普雷文
Vins	文斯
Fernie	弗尼
Aburdene	阿伯迪恩
Bonomo	博诺莫
Berg	伯格
Partee	帕蒂
Barkway	巴克韦
Irfonwy	艾尔方威
Slocombe	斯洛科姆
Dencer	登瑟
Ehrling	埃尔林
Hugas	休加斯
Fierheller	菲雷勒
Labalme	拉巴尔姆
Wettstone	韦茨通
Brandner	布兰德纳
Shackleford	沙克尔福
Frankenheim	弗兰肯海姆
Capp	卡普
Borlik	博利克
Archetel	阿奇特尔
Chandra	钱德拉
Weisbecker	韦斯贝克
Portland	波特兰
Winckless	温克利斯
Kieft	基夫特
Krull	克鲁尔
Barre	巴雷
Cruddas	克鲁达斯
Brendel	布伦德尔
Jervoise	杰维斯
Sereseres	塞雷瑟里斯
Zacks	扎克斯
Bossidy	博西迪
Pynchon	平琼
Knoppers	诺珀斯
Metacomet	梅塔科米特
Edge	埃奇
Beautrice	比阿特丽丝
Shacklock	沙克洛克
Lubbock	卢伯克
Ariana	阿里安娜
Herissier	赫里西尔
Sivell	西韦尔
Burns	伯恩斯
Yonas	约纳斯
Atchison	艾奇逊
Eldemire	埃尔德迈尔
Szopa	索帕
Jaskilka	贾斯基尔卡
Rumpf	朗夫
Keens	金斯
Roberts	罗伯茨
Chip	奇普
Pestka	佩斯特卡
Kring	克林
Pugsley	帕格斯利
O'Ballance	奥巴兰斯
Tinn	廷
Baylay	贝利
Starobin	斯塔罗宾
Clopet	克洛佩特
Synck	辛克
Pyper	派珀
Hambrook	汉布鲁克
Volwiler	沃尔韦勒
Tyrone	蒂龙
Willard	威拉德
Sammonds	萨蒙兹
Moertel	莫特尔
Picon	皮肯
Carrol	卡罗尔
Breuilly	布鲁伊
Cisneros	西斯内罗斯
Bolte	博尔特
Whitlatch	惠特拉奇
Fonken	方肯
Dahlto	达尔托
Rhulman	鲁尔曼
Werdel	沃德尔
Aynsley	安斯利
Malecki	马莱茨基
Malitz	马利茨
Lienhop	林霍普
Carion	卡里翁
Bienenstock	比嫩斯托克
Rudiger	鲁迪格
Traer	特雷尔
Monkman	蒙克曼
Rosenqvist	罗森奎斯特
Thorud	托鲁德
Bair	贝尔
Rowdy	罗迪
Mutton	马顿
Busterood	伯斯特鲁德
Finegan	法恩根
Molony	莫洛尼
Wates	韦茨
Tall	托尔
Minisi	米尼西
Raupe	劳普
Tiffany	蒂法尼
McAteer	麦卡蒂尔
Chynoweth	查诺韦思
Moder	莫德
Skeats	斯基茨
Eisch	艾施
Kennamer	肯纳默
Bonynge	博宁
Marlon	马龙
Kouwenhoven	考恩霍文
Talbutt	塔尔伯特
Hebard	赫巴德
Shirville	舍维尔
Quenild	奎尼尔德
Hutton	赫顿
Schemeil	谢梅尔
Evand	伊万德
Mazur	梅热
Santos	桑托斯
Levitsky	列维茨基
Chaves	查维斯
Reizenstein	赖曾斯坦
Hilleary	希勒里
Anteroinen	安特罗伊宁
Milkina	米尔基纳
Windingstad	温丁斯塔德
Turbidy	特比迪
Dumbaugh	邓博
Roemer	罗默
Elianor	埃莉亚诺
Geating	吉廷
Gates	盖茨
Spanel	斯帕内尔
Borger	博格
Abeloff	阿贝洛夫
Vanderford	范德福德
Dandrow	丹德罗
Eiges	艾格斯
Rieser	里泽
Agronick	阿格罗尼克
Shtulman	施图尔曼
Neuner	纽纳
Ochiltree	奥基尔特里
Mantovani	曼托瓦尼
Buthinson	布辛森
Reshevsky	雷谢夫斯基
Bronston	布朗斯顿
Grafstein	格拉夫斯坦
Hunneman	亨尼曼
Jules	朱尔斯
Garigue	加里格
Windram	温德勒姆
Anella	阿内拉
Alleghany	阿利盖尼
Galuardi	加卢亚迪
Orgmore	奥格莫尔
Doarn	多恩
Line	莱恩
Karlee	卡莉
Doenges	登格斯
Weavers	韦弗斯
Burkill	伯基尔
Bublitz	布勃利茨
Afield	阿菲尔德
Anscombe	安斯科姆
Duns	邓斯
Clery	克利里
Brammer	布拉默
Bentcover	本特科弗
Raw	罗
Mancher	曼彻
Mallers	马勒斯
Minich	米尼克
Uebersax	尤伯萨克斯
Folliard	福利亚德
Kennison	肯尼森
Rosenthal	罗森塔尔
Vesto	维斯托
Boulding	博尔丁
Eisenmenger	艾森门格
Byron	拜伦
Clowney	克洛尼
Daniel	丹尼尔
Costick	科斯蒂克
Ensinger	恩辛格
Pursh	珀什
Guifoyle	吉福伊尔
Kitchens	基钦斯
Candlin	坎德林
Batt	巴特
Dailey	戴利
Curtice	柯蒂斯
Fletcher	弗莱彻
Shalt	沙尔特
Whiting	怀廷
Skipper	斯基珀
Feito	费托
Kapula	卡普拉
Akerman	阿克曼
Kinniston	金尼斯顿
Mulvee	马尔维
Pullman	普尔曼
Huguelet	休格利特
Gumpert	冈珀特
Hoffmann	霍夫曼
Sobin	索宾
Bhoe	布霍
Ellerbrook	埃勒布鲁克
Shewan	休恩
Creigh	克赖
Westall	韦斯托尔
Vaudin	沃丁
Hudgins	赫金斯
Ringan	林根
Thisler	西斯勒
Dashper	达什珀
Billman	比尔曼
Palmiter	帕尔米特
Hesiod	赫西奥德
MacLellan	麦克莱伦
Whyatt	怀亚特
Belim	贝利姆
Willmer	威尔默
Alwar	奥尔沃
Lovegreen	洛夫格林
Sluss	斯拉斯
Sydow	赛多
Orman	奥曼
McGwire	麦圭尔
Patriss	帕特里斯
Cserr	切尔
Gajan	盖詹
Jantzen	詹特森
Blinks	布林克斯
Kristensen	克里斯滕森
Hamlen	哈姆伦
Dubose	杜博斯
Brassey	布拉西
Zamponi	赞波尼
Zolberg	佐尔伯格
Burton	伯顿
Vrain	弗兰
Moretti	莫雷蒂
Bresler	布雷斯勒
Lewknor	卢克诺
Lanier	拉尼尔
Jocaby	乔卡比
Carias	卡里亚斯
Keyser	凯泽
Layh	莱
Leissner	莱斯纳
Urrows	厄罗斯
Lidgett	利杰特
Tirrell	蒂雷尔
Twenge	特文格
Sullenger	萨伦格
Freni	弗雷尼
Averill	埃夫里尔
Fagence	法根斯
Loeb	洛布
Giacomazzi	贾科马齐
Achstetter	阿赫施泰特
Ledgard	莱贾德
Trufitt	特鲁菲特
Miniclier	米尼克利尔
Marcine	马辛
Mario	马里奥
Arrott	阿罗特
Maskelyne	马斯基林
Baller	巴勒
Dobkin	多布金
Richarms	理查姆斯
Ver	维尔
Dreschfield	德雷施菲尔德
Danny	丹尼
Bergin	伯金
Flege	弗利奇
Cantu	坎图
Chagrin	沙格兰
Treumann	特罗伊曼
Pasymowski	帕西莫夫斯基
Westacott	韦斯特科特
Soanes	索恩斯
Bedke	贝德克
Fahringer	法林格
Haym	海姆
Baguley	巴古利
Bidmead	比德米德
Goertzel	戈策尔
Tiacocca	蒂亚科卡
Bice	比奇
Barran	巴伦
Sebele	塞贝尔
Macrossan	麦克罗森
Hadmont	哈德蒙特
Pinney	平尼
Neaman	尼曼
Hanrahan	汉拉恩
Brusilow	布鲁西洛夫
Lipsey	利普西
Macvail	麦克韦尔
Vannevar	万尼瓦尔
Shlaen	什莱恩
Lineberger	莱恩伯格
Adubato	阿杜巴托
Bersell	伯塞尔
Tussaud	图索
Shibe	夏伊布
Wrong	朗
Graves	格雷夫斯
Maclardie	麦克拉迪
Deserie	德塞里
Schuiling	舒伊林
Docwra	多克拉
Caporale	卡波拉尔
Greeson	格里森
Bussgang	巴斯冈
Preuss	普罗伊斯
Quain	奎因
Carryer	卡里耶
Donisthorpe	多尼索普
Ricky	里基
Kriegel	克里格尔
Forstmann	福斯特曼
Wallach	沃勒克
Riviana	里维亚纳
Wiggham	威厄姆
Ruane	鲁安
McKaig	麦凯格
Tergeson	特格森
Weltner	韦尔特纳
Blyholder	布莱霍尔德
Blews	布卢斯
Jesso	杰索
Linch	林奇
Morrissette	莫里塞特
Clubb	克拉布
Hayman	海曼
Crismon	克里斯蒙
Copps	科普斯
Bisby	比斯比
Colebrooke	科尔布鲁克
Thorbecke	托尔贝克
Colebrook	科尔布鲁克
Holschuh	霍尔舒
Lantaff	兰塔夫
Glasson	格拉森
Kraar	克拉尔
Hagburg	哈格伯格
Workinger	沃金杰
Lewry	卢里
Turnquest	特恩奎斯特
Hoxie	霍克西
Soucy	苏西
Melman	梅尔曼
Culin	丘林
Damaska	达马斯卡
Mysie	迈茜
Esperian	埃斯佩里安
Burts	伯茨
Kraushaar	克劳斯哈尔
Lobingier	洛宾吉
O'Duffy	奥达菲
Familey	法米利
Diaconis	迪亚科尼斯
Done	多恩
Ladner	拉德纳
Krumpholz	克伦鲁霍尔兹
Screvane	斯克里文
Sagendorph	萨根多夫
Stradwick	斯特拉德威克
Frediricks	弗雷迪里克斯
Kiser	凯泽
Hilliker	希利克
McMeel	麦克米尔
Mceast	麦基斯特
Brazer	布雷泽
Daire	戴里
Schantz	尚茨
Messmer	梅斯默
Welshimer	韦尔希默
Calarco	卡拉尔科
Mojonnier	莫琼尼尔
Arkus	阿库斯
Fitzgreene	菲茨格林
Bainbridge	班布里奇
Cone	科恩
Dormann	多尔曼
Garvenlock	加文洛克
Poole	普尔
Scarisbrick	斯卡尔斯布里克
Lebor	莱博尔
Polifka	波利夫卡
Bonallack	博纳拉克
Cadwallon	卡德瓦隆
Mandel	曼德尔
Skoufis	斯库菲斯
O'Conor	奥康纳
Raaberg	拉伯格
Tamposi	坦波西
Bagar	巴加尔
McVay	麦克维
Maurus	莫鲁斯
Cyrenne	西伦
Mare	梅尔
Crisona	克里索纳
Darr	达尔
Hoke	霍克
Westburgh	韦斯特伯勒
Scholastica	斯科拉丝蒂卡
Kieren	基伦
Harriell	哈里尔
Ponton	庞顿
Kanady	卡纳迪
Gund	冈德
Krout	克劳特
Godgifu	戈德吉富
Kimbrel	金布雷尔
Surgenor	瑟奇诺
Pisko	皮斯科
Gardener	加德纳
Wimer	怀默
Caliver	卡利弗
Bowe	鲍
Mihran	米伦
Roads	罗兹
Whearty	惠尔蒂
Gainey	盖尼
Diehm	迪姆
Pountney	庞特尼
Rash	拉什
Bodanszky	博丹斯基
Obeyeseker	奥贝塞克
Poletti	波莱蒂
Suddes	萨迪斯
Rhea	雷亚
Tears	蒂尔斯
Mancuso	曼库索
Valon	瓦朗
Ewin	尤因
Groseth	格罗塞思
Berengerus	贝伦格鲁斯
Hennion	亨尼恩
Kowalsky	科瓦尔斯基
Gaitskell	盖茨克尔
Davina	达维娜
Mancoff	曼科夫
Cosworth	科斯沃思
Macklin	麦克林
Heston	赫斯顿
Renchard	伦查德
Chesley	切斯利
Glassick	格拉西克
Copithorne	科皮索恩
Sevrinson	塞夫林森
Lambton	兰布顿
Ammi	安米
Bricett	布赖西特
Samwell	萨姆韦尔
Jahncke	扬克
Molfetto	莫尔费托
Willibrord	威利布罗德
LeNoury	勒努里
Manchee	曼谢
Rootham	鲁特姆
Zagoria	扎戈里亚
Cahan	卡恩
Mongoven	蒙戈文
Furr	弗
Hinkley	欣克利
Grams	格拉姆斯
Docter	多克特
Eisenhardt	艾森哈特
Tinghitella	廷吉泰拉
Roycroft	罗伊克罗夫特
Bolsover	博尔索弗
Bugotu	布戈图
Cains	凯恩斯
Ahrnsbrak	阿恩斯布拉克
Fortenbaugh	福滕博
Nordgren	诺格伦
Sewery	休厄里
Thrope	思罗普
Truran	特鲁兰
Gundersheimer	冈德斯海默
Mercado	默卡多
Ithiel	伊锡尔
Lachmann	拉赫曼
Wroblewski	弗罗布莱夫斯基
Daliana	达利亚娜
Macbeolain	麦克贝奥兰
Midcap	米德卡普
Robbio	罗比奥
Aldhelm	奥尔德赫姆
Fleury	弗勒里
Eiker	艾克
Manbre	曼布雷
Basil	巴兹尔
Malkasian	马尔卡西安
Lankester	兰克斯特
Wakerlin	韦克林
Fausold	福索尔德
Wotton	沃顿
Tomlin	汤姆林
Smedley	斯梅德利
Dorte	多蒂
Wordingham	沃丁厄姆
Burhop	伯霍普
Brooke	布鲁克
Fretwell	弗雷特韦尔
Gilder	吉尔德
Shaler	谢勒
Belkind	贝尔坎德
Ormrod	奥姆罗德
Nihan	尼汉
Claribel	克拉丽贝尔
Stewlato	斯图拉托
Wagstaff	瓦格斯塔夫
Broomfield	布鲁姆菲尔德
Pont	庞特
Moebius	莫比厄斯
Melzack	梅尔扎克
Hamp	汉普
Wexley	韦克斯利
Reuven	鲁文
Ansted	安斯特德
Plant	普兰特
Summerell	萨默雷尔
Keebler	基布勒
Maybank	梅班克
Ashkenazi	阿什克纳齐
Hagel	哈格尔
Andrias	安德里亚斯
Mallord	马洛德
Cowland	考兰
Yuetter	尤特
Bingley	宾利
Dannemeyer	丹内迈耶
McCurley	麦柯利
Meeks	米克斯
Culliton	卡利顿
Farish	法里什
Balk	鲍克
Pike	派克
Gleadowe	格莱多
Cance	坎斯
Babh	巴布
Solibakke	索利巴克
Lichtenberger	利希滕伯格
Zuckert	朱克特
McGeady	麦吉迪
Putt	帕特
Larocca	拉罗卡
Cheyne	切恩
Trelford	特雷尔福德
Whitmire	惠特迈尔
Maudeleyn	莫德琳
Glash	格拉什
Steitz	施泰茨
Desnick	德斯尼克
Cornely	科尔内利
Dorsett	多塞特
McMains	麦克梅因斯
Leverton	莱弗顿
Enock	伊诺克
Drollas	德罗拉斯
Dulany	杜拉尼
Warder	沃德
Allbutt	奥尔伯特
Dwelly	德韦利
Livens	利文斯
Bertak	伯塔克
Mahesh	马赫什
Verville	弗维尔
Pastor	帕斯特
Wien	威恩
Merlyn	默林
Geffen	格芬
Sar	萨尔
Hickie	希基
Aho	阿霍
Keleti	凯莱蒂
Marnham	马纳姆
Estrup	埃斯特拉普
Bermange	伯曼奇
Leduc	勒迪克
Gumbel	冈贝尔
Tredgett	特里吉特
Gayley	盖利
Gaush	高希
Wear	韦尔
Helmholz	赫姆霍尔兹
Entire	恩泰尔
Natty	纳蒂
Desbarres	德巴尔
Gorsuch	戈萨奇
Debakey	德贝基
Aarons	阿伦斯
Leonor	利奥诺
Joycelyn	乔伊斯林
Hartung	哈通
Kacey	凯茜
Lammi	拉米
Macwhir	麦克惠尔
Tidd	蒂德
Bellinger	贝林杰
Mcspirit	麦克斯皮里特
Dynes	戴恩斯
Forgerty	福格蒂
Proulx	普罗克斯
Curoe	丘罗
Gruhl	格鲁尔
Glaeser	格莱泽
Hertz	赫兹
Lamburn	兰伯恩
Derlyn	德林
Lutkins	卢特金斯
Zeuner	佐伊纳
Baver	贝弗
Evens	埃文斯
Sabrosky	萨布罗斯基
Byham	拜厄姆
Memorex	梅莫雷克斯
Flyer	弗莱尔
Dehaas	德哈斯
Peters	彼得斯
Westaway	韦斯塔韦
Sally	萨莉
Ackers	阿克斯
Elikann	埃利坎
Blankfort	布兰克福
Aldrin	奥尔德林
DeParle	德帕尔
Horkan	霍肯
Dewe	迪尤
McAlvany	麦卡尔瓦尼
Fanseen	范西恩
Velde	维尔德
Archambault	阿尔尚博
Salsac	萨尔萨克
Barck	巴克
Symmans	西曼斯
Andersland	安德斯兰
Latasi	拉塔西
Barby	巴比
Ronald	罗纳德
Correll	科雷尔
Winans	怀南斯
Cullem	卡勒姆
Derburgh	德伯格
Cazamian	卡扎米安
Lindey	林迪
Manring	曼林
Gervasi	格维西
Tollenger	托伦杰
Underwood	安德伍德
Ammerman	安默曼
Elisa	埃莉莎
Winbish	温比什
Chelioti	凯利奥蒂
Juckett	朱克特
Bencze	本切
Channing	钱宁
Fennessey	芬尼西
Hartley	哈特利
Comrie	科姆里
Dow	道
Boveri	博韦里
Balliol	巴利奥尔
Harkrader	哈克雷德
Bjornsen	比约恩森
Toy	托伊
Salway	萨尔韦
Kinrade	金雷德
Mccluskey	麦克拉斯基
Moisne	姆万
Kearse	基尔斯
Corse	科斯
Melick	梅利克
Mulloy	马洛伊
Alexbank	亚历克斯班克
Meddings	梅丁斯
Barrie	巴里
Holborne	霍伯恩
Ignico	伊格尼科
Hirsch	赫希
Mayhard	梅哈德
Moyls	莫伊尔斯
Soulby	索尔比
Colles	科利斯
Derhoff	德霍夫
Eadward	爱德华
Dougherty	多尔蒂
Nyquist	尼奎斯特
McGlotten	麦格洛滕
Willner	威尔纳
Schatz	沙茨
Dougall	杜格尔
Snoad	斯诺德
Berde	伯德
Gravenstein	格拉文斯坦
Dugoni	杜戈尼
Raney	拉尼
Kincer	金瑟
Langlois	朗格卢瓦
Riou	里乌
Corkran	科克伦
Hosken	霍斯肯
Malsky	马尔斯基
Cousin	卡曾
Thulean	图林
Jerauld	杰罗尔德
Kuntz	孔茨
Iddings	伊丁斯
Demerec	德梅雷茨
Traver	特拉弗
Asen	阿森
Daylin	戴林
Elsman	埃尔斯曼
Livie	利维
Ephremides	埃弗雷米兹
Tsongas	聪格斯
Sucher	苏赫尔
Drewry	德鲁里
Ziegelman	齐格尔曼
Colmen	科尔门
Cos	科斯
Thomson	汤姆森
Hingley	欣利
Batcell	巴特塞尔
Stayton	斯泰顿
Moerdler	莫德勒
Waller	沃勒
Cutshall	卡特歇尔
Wenke	温克
Nudd	纳德
Sicle	西克
Zelmanowitz	泽尔马诺维茨
Pushman	普什曼
Benninger	本宁格
Kovler	科夫勒
Tharnham	撒纳姆
Tempest	坦皮斯特
Friedberg	弗里德伯格
Kohlmann	科尔曼
Czech	切赫
Pellegrini	佩莱格里尼
Goetze	戈策
Cumber	坎伯
Winder	温德尔
Bolkus	博尔克斯
Prentis	普伦蒂斯
Fontanez	方塔内斯
Croxford	克罗克斯福德
Gwartney	格沃特尼
Allesley	奥尔斯利
Vonroemer	冯罗默
Teitge	泰奇
Kinetz	基内茨
Handler	汉德勒
Denbo	登博
Kelser	凯尔塞
Georgette	乔吉特
Favalora	法瓦洛拉
Terhune	特休恩
Dystel	迪斯特尔
Dinglay	丁格莱
Frampton	弗兰普顿
Wulff	伍尔夫
Sworder	索德
Joy	乔伊
Lough	洛
Kuzmack	库兹马克
Bruggink	布鲁金克
Crindle	克林德尔
Moora	穆拉
Hatie	哈蒂
Dockson	多克森
Storms	斯托姆斯
Heffner	赫夫纳
Fritsch	弗里奇
Friedlich	弗里德利克
Cartey	卡蒂
Lemoine	勒莫因
Loughridge	洛克里奇
Donath	多纳特
Cristina	克里斯蒂娜
Cockerline	科克莱恩
Kirtley	柯特利
Peill	皮尔
Strabmann	斯特拉布曼
Struyk	斯特鲁伊克
Tuohy	图伊
Friar	弗里亚尔
Kivette	基维特
Morath	莫拉特
Heathcote	希思科特
Brucken	布鲁肯
Dunford	邓福德
Akst	阿克斯特
Yung	扬
Kallmann	卡尔曼
Wheldon	惠尔登
Bovey	博维
Riga	里加
Frisco	弗里斯科
Phair	费尔
Pryor	普赖尔
Berinthia	贝林西娅
Culligan	卡利根
Coolins	库林斯
Burki	伯基
Mayor	梅厄
DeRosa	德罗莎
Schnebly	施内布利
Longford	朗福德
Faville	法维尔
Durance	迪兰斯
Chas	查斯
Finneran	芬纳兰
Villareal	维拉里尔
Lavin	拉文
Harrawood	哈拉伍德
Fingal	芬戈尔
Vejina	维吉纳
Bagenal	巴格纳尔
Yarley	雅利
Gaal	加尔
Condat	康达特
Wilmarth	威尔马思
Coplon	科普朗
Leonowens	利奥诺温斯
Athlone	阿思隆
Arlie	阿莉
Drosdick	德罗斯迪克
Aker	阿克
Caponigro	卡波尼格罗
Hartenberger	哈滕伯格
Estee	埃斯蒂
Andreoli	安德烈奥利
Crenna	克伦纳
Bryans	布赖恩斯
Mathile	马蒂尔
Bellenger	贝伦格
Mordant	莫登特
Gudebrod	古德布罗德
Gring	格林
McKernan	麦克南
Gillum	吉勒姆
Beltzer	贝尔策
Denonville	德农维尔
Vescy	维西
Bough	博夫
Romane	罗马尼
Stiervater	斯蒂尔瓦特
Dwan	德万
Dallmayr	多尔迈尔
Grodzins	格罗津斯
Stuckey	斯塔基
MacEachren	麦凯克伦
Desalme	德萨尔姆
Drutt	德拉特
Kramm	克拉姆
Hobby	霍比
Bruett	布吕特
Pass	帕斯
Shank	尚克
MacDermott	麦克德莫特
Paltock	帕尔托克
Raedwald	雷德沃尔德
Voris	沃里斯
Pithers	皮瑟斯
Tombaugh	汤博
Baskett	巴斯克特
Chinn	钦
Sheean	希恩
Tarn	塔恩
Timbers	廷伯斯
Perocchi	佩罗基
Paravicini	帕拉维奇尼
Shankle	尚克尔
Bortner	博特纳
Pittuck	皮塔克
Hjornevik	约恩维克
Aleke	阿利克
Slavens	斯莱文斯
Bahl	巴尔
Euphemius	尤菲米厄斯
Torian	托里安
Nassikas	纳西卡斯
Yokell	约克尔
Carnac	卡纳克
Berkerly	伯克利
Phie	菲
Marples	马普尔斯
Puryear	普里尔
Zoller	佐勒
Fraser	弗雷泽
Shon	肖恩
Denit	德尼特
Bergmoser	伯格莫泽
Lowis	洛伊斯
Cavadas	卡瓦达斯
Morot	莫罗特
Moxley	莫克斯利
Ruland	鲁兰
MacAllister	麦卡利斯特
Sier	西尔
Rooss	鲁斯
Shotton	肖顿
Bevel	贝弗尔
Wiesenberger	威森伯格
Golglacier	戈格莱西尔
Baldino	鲍迪诺
Cochans	科强斯
Ortiz	奥尔蒂斯
Heverly	赫弗利
Kotin	科廷
Nickolls	尼科尔斯
Zebrowits	泽布罗维茨
Almeley	阿姆利
Atkins	阿特金斯
Fornatto	福尔纳托
Cleve	克利夫
Fugard	富加德
Forster	福斯特
Konkel	康克尔
Merante	梅兰特
Haeberle	黑伯利
Tatz	塔茨
Manischewitz	马尼舍维茨
Finical	菲尼卡尔
Jansky	詹斯基
Mook	穆克
Karns	坎斯
Kissel	基塞尔
Canel	卡纳尔
Kibble	基布尔
Ecton	埃克顿
Delacombe	德拉库姆
Flussi	弗卢西
Jemmy	杰米
McAulay	麦考利
Gilwhite	吉尔怀特
Bragg	布拉格
Boeckman	伯克曼
Uvarov	尤瓦罗夫
Freith	弗雷思
Casazza	卡萨扎
Hazlehurst	黑兹尔赫斯特
All	奥尔
Gwinn	格温
Gardy	加迪
Caruth	卡鲁思
Ranald	拉纳尔德
Connock	康诺克
Meierhenry	迈尔亨利
Birchfield	伯奇菲尔德
Fiala	菲亚拉
Crudup	克留达普
Orison	奥里森
Mearson	米尔森
Pershall	珀歇尔
Pleissner	普莱斯纳
Idonea	伊多妮娅
Vacher	瓦舍
Packard	帕卡德
Pallister	帕利斯特
Belfrage	贝尔弗雷奇
Banfield	班菲尔德
Tollett	托利特
Craddock	克拉多克
Ingoldsby	英戈尔兹比
Walkden	沃克登
Hauk	豪克
Grassy	格拉西
Adlercron	阿德勒克朗
Joas	乔阿斯
Spacey	斯佩西
Musgrave	马斯格雷夫
Aldea	阿尔迪亚
Rebori	里博里
Weatherbie	韦瑟比
Elberfeld	埃伯菲尔德
Koslow	科斯洛
Decaro	德卡罗
Benesh	贝尼什
Dante	丹蒂
Wellmen	韦尔门
Steveson	斯蒂夫森
Choguill	科吉尔
Stouch	斯托奇
Braund	布朗德
Kubrick	库布里克
Amiss	埃米斯
Fee	菲
Lipsett	利普塞特
Gabriella	加布里埃拉
Herre	赫尔
Sansom	桑瑟姆
Rutherston	拉瑟斯顿
Adelard	阿德拉德
Binnie	宾尼
Cockrill	科克里尔
Capricia	卡普里西娅
Hottois	霍托伊斯
Evins	埃文斯
Rolshoven	罗尔斯霍文
Cotterill	科特里尔
Vanderplank	范德普兰克
McLeister	麦克莱斯特
Posner	波斯纳
Macphorlich	麦克福利克
Philibert	菲利伯特
Steane	斯特恩
Hyder	海德
Goolden	古尔登
Mille	米尔
Alhadeff	阿尔哈德夫
Ammons	安蒙斯
Bashir	巴希尔
Langum	兰格姆
Bacoats	巴科茨
Striplin	斯特里普林
Cummer	坎默
Lorant	洛伦特
Bodmin	博德明
Gernes	热内斯
Braycich	布雷西奇
Sherren	谢伦
Ivah	艾娃
Soliozy	索利奥齐
Meyerding	迈耶丁
Wilcannia	威尔坎尼亚
Calisti	卡利斯蒂
Basford	贝斯福德
Drinko	德林科
Domenyk	多梅尼克
Ahier	阿耶
Boegehold	伯格霍尔德
Agusta	阿古斯塔
Caulsen	考尔森
Eadon	伊登
Boyett	博耶特
Sibyl	西比尔
Yuss	尤斯
Frieman	弗里曼
Kelsea	凯尔西
Difillippo	迪菲利波
Skanderup	斯坎德拉普
Cree	克里
Durelle	迪雷勒
Severance	塞弗伦斯
Maccaskill	麦卡斯基尔
Guillermin	吉勒明
Gentling	根特林
Roan	罗恩
Yeargin	耶尔金
Merewether	梅里韦瑟
Cera	塞拉
Levinstein	莱文斯坦
Brotzman	布罗茨曼
Brauser	布劳泽
O'Mahoney	奥马霍尼
Politz	波利茨
Riney	赖尼
Ridsdale	里兹代尔
Aboody	阿布迪
Filiatrault	菲利亚特罗
Dash	达什
Ruthe	露丝
Flinn	弗林
Hambraeus	汉布雷乌斯
Zein	蔡恩
Ebbs	埃布斯
Hefferon	赫弗伦
Bogdonoff	博格多诺夫
Reich	赖克
Eppler	埃普勒
Rosenne	罗森
Reymond	雷蒙德
Beckman	贝克曼
Anderle	安德利
Brine	布赖恩
Engelhart	恩格尔哈特
Batcheller	巴彻勒
Wiens	威恩斯
Violet	维奥莱特
Swerdloff	斯维尔德洛夫
Klickmann	克利克曼
Tumulty	塔马尔蒂
Barka	巴卡
Singewald	辛奇沃尔德
Saidenberg	赛登伯格
Sprigle	斯普里格尔
Depoix	德普瓦
Gunther	冈瑟
Pickrell	皮克雷尔
Trostel	特罗斯特尔
Ladbrook	拉德布鲁克
Powell	鲍威尔
Loverseed	洛弗西德
Freser	弗雷瑟
Tomas	托马斯
Gengler	金格勒
Borson	博尔森
Sethi	塞西
Heilmeier	海尔迈耶
McEoin	麦克约恩
Harvey	哈维
Boushall	布歇尔
Comper	康珀
Blazer	布莱泽
LeFevre	勒费夫尔
McKew	麦丘
Cherniavsky	切尔尼亚夫斯基
Endershort	恩德肖特
Mattessich	马特西奇
Garrity	加里蒂
Farah	法拉
Belleek	比利克
Fansler	范斯勒
Edick	伊迪克
Hoban	霍本
Hammerman	哈默曼
Fiterman	特特曼
Zucca	朱卡
Hurlbut	赫尔伯特
Ashlee	阿什莉
Sinstead	辛斯特德
McCombs	麦库姆斯
Shankland	尚克兰
Kornblum	科恩布卢姆
Geerken	吉尔肯
Sheeran	希兰
Fuerbringer	菲尔布林格
Chillson	奇尔森
Etzkorn	埃茨科恩
Venediger	维内迪杰
Mehring	梅林
Massereene	马塞林
Carwithen	卡威森
Sabelli	萨贝利
Gellibrand	盖利布兰德
Markwardt	马克沃特
Broude	布劳德
Froning	弗罗宁
Sandon	桑登
Reading	雷丁
Meirowitz	迈罗维茨
Wooll	伍尔
Trotta	特罗塔
Tauke	陶克
Estabrook	埃斯塔布鲁克
Keson	凯森
Chargaff	查加夫
Horsnell	霍斯内尔
Meeler	米勒
Copeman	科普曼
Pemell	佩梅尔
Pettie	佩蒂
Malphrus	马尔夫勒斯
Lord	勋爵
Teago	蒂戈
Dericco	德里科
Torrie	托里
Harragin	哈拉金
Fielstra	菲尔斯特拉
Macatee	麦卡蒂
Weech	威奇
Culle	丘尔
Rigby	里格比
Mullins	马林斯
Timpane	廷潘
Mehn	梅恩
Greppin	格雷平
Ellinger	埃林杰
Dequan	德坎
Valerie	瓦莱丽
Truxal	特鲁克萨尔
Hornbein	霍恩宾
Tianna	蒂安娜
Hatty	哈蒂
Bergsten	贝格斯滕
Paugh	波
Ghiorsi	吉奥尔西
Spewack	斯皮瓦克
Seeschaf	西沙夫
Giddon	吉登
Stuit	斯图伊特
Krombein	克龙拜因
Brinkworth	布林克沃思
Tonnochy	汤诺基
Holls	霍尔斯
Hessberg	赫斯伯格
Brant	布兰特
Eastwood	伊斯特伍德
Ringold	林戈尔德
Altshull	阿特休尔
Derzon	德宗
Gilbert	吉尔伯特
Womack	沃马克
Comm	科姆
Sartain	萨廷
Kieves	基夫斯
Bloomhardt	布卢姆哈特
Terzian	特齐安
Siss	西丝
Wilshire	威尔希尔
Plaut	普劳特
Dau	多
Bochner	博克纳
Heather	希瑟
Brightwen	布赖特温
Chobanian	乔巴尼扬
Straw	斯特劳
Hagar	黑格
Freflie	弗雷弗利
MacAdams	麦克亚当斯
Letsche	莱奇
Daggatt	达加特
Mayers	迈耶斯
Nissen	尼森
Alport	奥尔波特
Marden	马登
Nensel	南塞尔
Smoker	斯莫克尔
Brodney	布罗德尼
Einbender	艾因本德
Liberthal	利伯索尔
Turaba	图拉巴
Longmore	朗莫尔
Scarbrough	斯卡伯勒
Kirbye	柯比
Friess	弗里斯
Elfelt	埃尔费尔特
Jacox	杰科克斯
Knebel	克内贝尔
Gosda	戈斯达
Highby	海比
Galotta	加洛塔
Reinsel	赖因泽尔
Breman	布雷曼
Frummel	弗鲁梅尔
Chitty	奇蒂
Loveland	洛夫兰
Rosenberger	罗森伯格
Browder	布劳德
Gillitt	吉利特
Nejako	内贾科
Rhomberg	龙伯格
Willy	威利
Sulivan	沙利文
Morcott	莫科特
Coupland	库普兰
Newenham	纽厄纳姆
Hinson	欣森
Cotgrave	科特格雷夫
Nininger	尼宁格
Knollys	诺利斯
Gehle	格利
Bulleid	布利德
Fernley	弗恩利
Leiken	莱肯
Ventimil	文蒂米尔
Madog	马多格
Stanford	斯坦福
Lecia	莱西娅
Ginsberg	金斯伯格
Lummus	拉默斯
MacMeeken	麦克米肯
Breathed	布雷思德
Palk	波尔克
Christensen	克里斯坦森
Naphin	纳芬
Sain	塞恩
Cetron	塞特龙
Lieber	利伯
Ceci	切奇
Cliver	克利弗
Culbert	卡伯特
Csanady	乔纳迪
Hare	黑尔
Gaskin	加斯金
Bilkey	比尔基
Ringham	林厄姆
Deeley	迪利
Gribben	格里本
Penney	彭尼
Feron	费龙
Pinta	平塔
Elvin	埃尔文
Lambert	兰伯特
Tidswell	蒂兹韦尔
Tinker	廷克
Leybourn	利伯恩
Beyette	贝耶特
Lawes	劳斯
Coffin	科芬
Inghram	英格拉姆
Nipp	尼普
Kott	科特
Beaudette	博德特
Bruller	布鲁勒
Shafter	沙夫特
Harp	哈普
Gellender	格伦德
Gelenger	格伦杰
Uhalley	乌哈利
Feazell	费泽尔
Blagrave	布莱格拉夫
Taichman	泰赫曼
Gressly	格雷斯利
Oschalk	奥沙尔克
Spellar	斯佩勒
Rudel	鲁德尔
Ayyar	艾亚尔
Bultman	布尔特曼
Vandenberg	范登堡
DeFrank	德弗兰克
Cannon	坎农
Thagard	撒加德
O'Hagan	奥黑根
Maier	梅尔
Tennihan	坦尼汉
Beeney	比尼
Tonks	汤克斯
Dinielli	迪涅利
Trachtenberg	特拉亨伯格
Hise	海斯
Lenon	莱农
Dement	德门特
Briggs	布里格斯
Charmaine	查梅因
Annaly	安纳利
Bartholomay	巴托洛迈
Turinsky	图林斯基
McInerny	麦金纳尼
Havenfield	黑文菲尔德
Donnell	唐奈
Odille	奥迪尔
McEachen	麦凯琴
Kievit	基维特
Harari	哈拉里
Mcbeath	麦克贝思
Pryce	普赖斯
Addleshaw	阿德尔肖
Belsey	贝尔西
Charlene	查伦
Albrecht	阿尔布雷克特
Barendse	巴伦兹
Farrand	法兰德
Hitchcock	希契科克
Jagadis	杰加迪斯
Kreisler	克赖斯勒
Sondergard	桑德加德
Kockler	科克勒
Feagley	费格利
Markels	马克尔斯
Snook	斯努克
Delhey	德尔希
Gysbers	吉斯伯斯
Nord	诺德
Delforge	德尔福奇
Shores	肖尔斯
Stufflebeam	斯塔弗尔比姆
Palmstierna	帕姆斯蒂纳
Goodlett	古德利特
Anselmus	安塞尔默斯
Janicki	贾尼基
Iry	艾里
Thrush	思拉什
Kleitz	克莱茨
Bridles	布赖德尔斯
Valery	瓦莱丽
Walt	沃尔特
Byars	拜厄斯
Rivoire	里瓦尔
Tremenheere	特雷明希尔
Heileman	海勒曼
Louchheim	洛凯姆
Alvaro	阿尔瓦罗
Cuthill	卡西尔
Castlemon	卡斯尔蒙
Silvester	西尔韦斯特
Tonbridge	汤布里奇
Baldragon	巴尔德拉根
Henrey	亨里
Brough	布拉夫
Tunnard	滕纳德
Ambridge	安布里奇
Clain	克莱恩
Spriegel	斯普里格尔
Holstrom	霍尔斯特龙
Koskinen	科斯基宁
Shelbie	谢尔比
Hoagland	霍格兰
Male	梅尔
Daft	达夫特
Flessner	弗莱斯纳
Greenberg	格林伯格
Rodis	罗迪斯
Odachowski	奥达霍夫斯基
Maclugash	麦克卢加什
Westermeyer	韦斯特迈耶
Dorkin	多尔金
Bromilow	布罗米洛
Roussel	鲁塞尔
Briody	布赖奥迪
Sommerlett	萨默利特
Pickle	皮克尔
Moberly	莫伯利
Heisenberg	海森伯格
Roome	鲁姆
Maxtone	马克斯通
Bowersock	鲍尔索克
Quirico	奎里科
Spoor	斯普尔
DeCarli	德卡利
Romberg	龙伯格
Breverman	布雷弗曼
Arliss	阿利斯
Rawlerson	罗勒森
Krutch	克鲁奇
Lurton	勒顿
Cluse	克卢斯
Mori	莫里
Zimble	津布尔
Bethurum	贝休伦
Evenden	埃文登
Boutflour	鲍特弗洛尔
McKendry	麦肯德里
Brom	布罗姆
Aleshire	阿利希尔
Honywood	霍尼伍德
Larimore	拉里莫尔
Sibbing	西宾
Voles	沃尔斯
Lazareth	拉扎雷思
Dunnells	邓内尔斯
Iott	约特
Ahearn	埃亨
Deshazier	德沙齐尔
Beathy	比西
Kranaskas	克拉纳斯卡斯
Fishlow	菲什洛
Ambro	安布罗
Searcy	瑟西
Bleakley	布利克利
Demps	登普斯
Whisenhunt	惠森亨特
Kerrich	克里奇
Thornp	索恩普
Lawrence	劳伦斯
Conwood	康伍德
Watermeier	沃特迈耶
Tewsbury	图斯伯里
Leibsly	莱布斯利
Jeft	杰夫特
Faricy	费里西
Peate	皮特
Hahne	哈恩
Robay	罗贝
Aleksich	阿列克西奇
McLachlin	麦克拉克林
McGeoch	麦吉奥赫
Angleton	安格尔顿
Temkin	特姆金
Esselstyn	埃塞尔斯廷
Henryson	亨利森
Ortega	奥尔特加
Seldes	塞尔迪斯
Cartmill	卡特米尔
Pezzati	佩扎蒂
Rew	鲁
Mcgonigal	麦戈尼格尔
Emria	埃姆丽娅
Bogardus	博加德斯
Goetchius	戈丘斯
Kharfen	卡芬
Janner	詹纳
Welling	韦林
Barnidge	巴尼奇
Clecak	克莱卡克
Hansel	汉塞尔
Kahneman	卡内曼
Gartlan	加特兰
Oglethorpe	奥格尔索普
Szasz	萨斯
Zuckerman	朱克曼
Gyle	盖尔
Baumgardt	鲍姆加特
Murase	穆拉斯
Prower	普劳厄
Denoble	德诺布尔
Shore	肖尔
Berryhill	贝里希尔
Buckle	巴克尔
Fulson	富尔森
Reilkoff	赖尔科夫
Schouweiler	斯考韦勒
Aldan	奥尔登
Gouldner	古尔德纳
Wallrodt	沃尔罗特
Gigot	吉戈特
Cosen	科曾
Schear	希尔
Curnell	柯内尔
Binnig	宾尼希
Brigadier	布里格迪尔
Fong	方
Jergens	杰根斯
Thalacker	撒拉克
Brement	布雷门特
Klug	克卢格
Calvillo	卡尔维洛
Dethmers	德思默斯
Gurwitch	格维奇
Allcroft	奥尔克罗夫特
Borgeson	博格森
Langston	兰斯顿
Erroll	埃罗尔
Liliana	利利安娜
Enders	恩德斯
Price	普赖斯
Bytheway	拜瑟韦
Cleverly	克莱弗利
Gurvitz	格维茨
Nupen	纽彭
Huffer	赫弗
Kirkaldie	柯卡尔迪
Hardyman	哈迪曼
Oberlander	奥伯兰德
Proper	普罗珀
Dandridge	丹德里奇
Skeffington	斯凯芬顿
Knollenberg	诺伦伯格
Cush	库什
Schwartzkopf	施瓦茨科普夫
Leva	利瓦
Adna	阿德纳
Lansford	兰斯福德
Laughland	劳赫兰
Varvle	瓦弗尔
Realff	里尔夫
Fridin	弗里丁
Druyun	德鲁延
Tollerton	托勒顿
Werts	沃茨
Diorio	迪奥里奥
Jephson	杰夫森
Pudaloff	普达洛夫
Howard	霍华德
Pecorini	佩科里尼
Kinnard	金纳德
Brinton	布林顿
Rainbow	雷恩博
Macmurdoch	麦克默多克
Urrutia	乌鲁希亚
Mondry	蒙德里
Pilon	皮隆
Gueanor	格娅诺尔
Britney	布里特妮
Fuselier	菲尤斯利尔
Spock	斯波克
Schulberg	舒尔贝格
Mansmann	曼斯曼
Holdcroft	霍尔德克罗夫特
Kilcoyne	基尔科因
Barondes	巴伦德斯
Craine	克雷恩
Burgett	伯吉特
Briefs	布里夫斯
Ozment	奥兹门特
Pendleton	彭德尔顿
Westrop	韦斯特罗普
Ifor	艾弗
Rust	拉斯特
Jarvie	贾维
Faye	费伊
Homrighausen	霍姆里格豪森
Albares	阿尔巴雷斯
Mullaney	马拉尼
Seibert	塞伯特
Visher	维舍
Shullenberger	舒伦伯格
Minshull	明舒尔
Zimmerly	齐默利
Huelster	许尔斯特
Blanchia	布兰奇娅
Lestocq	莱斯托克
Garratt	加勒特
Besly	贝斯利
Schoenholtz	舍恩霍尔茨
Tiecke	蒂克
Seyler	赛勒
Adonis	阿多尼斯
Axelbank	阿克塞尔班克
Dipietro	迪彼得罗
Killingworth	基林沃思
Livesey	利夫西
Gotteredson	戈特雷森
Elston	埃尔斯顿
Wenley	温利
Murnaghan	默纳汉
Wannamaker	沃纳梅克
Bickers	比克斯
Elberson	埃尔伯森
McLurkin	麦克勒金
Maken	梅肯
Grody	格罗迪
Engeman	恩格曼
Smithson	史密森
Crickmore	克里克莫尔
Skouras	斯库拉斯
Levermore	莱弗莫尔
Bohren	博伦
Fawcett	福西特
Eid	艾德
Richter	里克特
Gulli	格利
Lecelina	莱丝利娜
Bedini	贝迪尼
Fritzi	弗里齐
Knightly	奈特利
Daggar	达加
Prifti	普里夫蒂
Veiller	维勒
Mcgiolla	麦乔拉
Teninga	特宁加
Mowlyn	莫林
Provenzano	普罗文扎诺
Aitchison	艾奇逊
Lewell	卢埃尔
Eastlake	伊斯特莱克
Starey	斯塔里
Linnehan	利纳汉
Mengel	门格尔
Lohman	洛曼
Boehle	伯勒
Doerr	多尔
Sterrett	斯特雷特
Brockden	布罗克登
Garnde	加恩德
Zillmann	齐尔曼
Dunea	杜尼亚
Sikora	西科拉
Kavruck	卡夫勒克
Hermann	赫尔曼
Clibborn	克利伯恩
Ghoury	戈里
Simner	西姆纳
Givney	吉夫尼
Gonyea	戈尼亚
Almond	阿尔蒙德
Ackley	阿克利
Benney	本尼
Parker	帕克
McKeachie	麦基奇
Diegelman	迪格尔曼
Gerritsen	格里森
Sennett	森尼特
Gorthy	戈西
Bilka	比尔卡
Hazelton	黑兹尔顿
Redmond	雷德蒙
Kaitlynn	凯特琳
Havard	哈弗德
Custy	卡斯蒂
Bement	比门特
Sheraton	谢拉顿
Saletel	萨利特尔
Hanify	哈尼菲
Hanesian	哈尼西安
Rowe	罗
Gabbard	加伯德
Falle	法尔
Bastard	巴斯塔德
Hofacker	霍法克
Capshaw	卡普肖
Chrissie	克丽茜
Ardery	阿德里
Edwina	埃德温娜
Searl	瑟尔
Lubchenco	卢布琴科
Cardnell	卡德内尔
Tief	蒂夫
Kogok	科戈克
Rappitt	拉皮特
Shipen	希彭
Allendar	艾伦达
Tabiner	塔比纳
Berube	贝鲁布
Aabye	奥比
A'Court	埃科特
DeArmond	德阿蒙