费尔伯恩 | 费尔贝恩 | fairbairn
迪普斯 | 杜普斯 | dupes
埃德尔霍赫 | 埃德尔霍克 | edelhoch
瓦格尼 | 韦恩 | wagne
布罗兰 | 布罗林 | brorein
艾梅施 | 伊梅施 | imesch
埃尔托黑德 | 埃尔顿黑德 | eltonhead
特鲁普 | 思鲁普 | throop
加布尔 | 加伯 | gabbour
塔利亚雷罗 | 塔利亚费罗 | tagliaferro
马金南 | 马基嫩 | makinen
麦科瑙希 | 麦康瑙希 | mcconaughy
达文 | 达温 | darwen
卡斯格伦 | 卡斯格兰 | casgrain
菲达迪斯 | 菲丹迪斯 | fidandis
卡赫 | 卡尔 | karrh
杰罗尔 | 杰拉尔 | gerall
克雷 | 克里 | kerrey
斯特吉斯 | 斯特奇斯 | sturges
多 | 道 | daw
阿什多恩 | 阿什当 | ashdown
吉尔德 | 盖尔德 | geld
福伊希特瓦格 | 福伊希特万格 | feuchtwanger
克莱农 | 克勒农 | clernon
德鲁夫 | 德鲁伊夫 | druiff
德尔里戈 | 德尔列戈 | delriego
比沃特 | 拜沃特 | bywater
梅恩斯 | 默恩斯 | mearns
亚历山大 | 达历山大 | d'alexander
利多尔 | 利德尔 | liddall
斯蒂克 | 斯特克 | stirk
古特穆特 | 古特穆思 | gutermuth
玛乔林 | 马乔林 | marjolin
洛多维克 | 洛多威克 | lodowicke
弗拉泽 | 弗雷泽 | frazer
罗林格 | 罗林杰 | rollinger
克拉伯 | 克莱伯 | klaber
格里索德 | 格雷特黑德 | greathead
马尔特比 | 莫尔特比 | maltby
克拉特 | 克鲁特 | krutter
伍兹德 | 伍德赛德 | woodside
古妮拉 | 古尼拉 | gunilla
舒尔金德 | 舒尔坎德 | schulkind
皮什 | 佩什 | peche
利金斯 | 莱金斯 | lykins
利恩 | 利安娜 | leanne
格拉伯 | 格雷伯 | graber
弗兰库姆 | 弗兰克姆 | frankum
纽布兰克 | 纽布兰奇 | newbranch
布利肯斯弗 | 布利肯斯德弗 | blickensderfer
迪瓦斯 | 德瓦斯 | dewas
赫斯莱普 | 赫斯利普 | heslep
埃文 | 欧文 | ervin
埃加尔 | 埃加 | eggar
索恩顿 | 桑顿 | thornton
拉德姆 | 拉德勒姆 | rudderham
阿文特 | 埃文特 | avent
弗卡克 | 弗凯克 | verkaik
特雷富西斯 | 特里富西斯 | trefusis
科克伦 | 科克兰 | cockran
圭尔 | 瓜尔 | guare
卡莉尔 | 卡利尔 | kalil
肖茨 | 肖恩茨 | shontz
弗劳 | 弗劳德 | furlaud
福尔迪西 | 福尔德西 | foldessy
皮伦斯 | 佩伦斯 | peirens
费布勒 | 法布勒 | fabler
杜因特 | 德温特 | dewint
斯威特曼 | 斯韦特曼 | sweatman
范沃森 | 范福森 | vanfossan
拉弗莱奇 | 拉弗莱什 | lafleche
阿斯基思 | 阿斯奎思 | asquith
埃沃伊 | 伊沃伊 | evoy
坦吉 | 坦圭 | tanguay
布里尼希 | 布里尼格 | brinig
拉斯布里格 | 拉斯布里杰 | rusbridger
哈斯卢普 | 哈斯勒普 | haslup
休林斯 | 赫林斯 | hulings
贝雷 | 贝里 | berrey
麦克米切尔 | 麦克迈克尔 | mcmichael
阿尔曼 | 阿利芒 | allemang
格林胡特 | 格林赫特 | greenhut
福马尼克 | 福马内克 | formanek
赞皮略 | 赞皮耶洛 | zampiello
门宁 | 门嫩 | mennen
麦克雷思 | 麦克勒思 | mackereth
奥瑟 | 奥泽 | orser
杜布尔迪 | 道布尔迪 | doubleday
库普里尔 | 卡普里尔 | cuprill
多奇 | 德奇 | doetsch
切克齐安 | 彻克齐安 | cherkezian
艾肯格琳 | 艾肯格林 | eichengreen
麦克鲁登 | 麦克拉登 | mccrudden
奥尔斯塔特 | 阿尔斯塔特 | alstadt
博尼法修斯 | 博尼费修斯 | bonifacius
德里南 | 德赖南 | drynan
福韦尔 | 福尔韦尔 | faulwell
特里梅因 | 特里曼 | tremain
安克鲁姆 | 安克拉姆 | ancrum
哈雷尔 | 哈勒尔 | harrel
克雷希尔 | 克雷比尔 | krehbiel
梅罗维奇 | 迈罗维奇 | meirovitch
莫伊西维奇 | 莫伊塞维奇 | moiseiwitsch
米尔哈姆 | 米勒姆 | millham
雷德斯克 | 拉德斯克 | radesk
西拉森 | 西劳森 | cilawson
艾德斯莫 | 艾兹莫 | eidsmoe
韦斯特摩兰 | 威斯特摩兰 | westmoreland
布鲁克特 | 布勒克特 | broekert
迪安蒙特 | 迪亚门特 | diament
里森 | 里斯滕 | wristen
马利埃 | 马利尔 | mallier
隆巴德 | 伦巴德 | lumbard
贝塞尔 | 贝瑟尔 | bethell
法勒勒 | 法伊勒 | pfeiler
伊勒 | 伊尔 | ihle
阿尔曼 | 奥尔曼 | alman
麦克米切尔 | 麦克迈克尔 | macmichael
布利斯通 | 布莱斯通 | blystone
麦克尔汉农 | 麦克尔哈农 | mcelhanon
塔利奥 | 图利奥 | tullio
索利 | 索尔 | sowle
莱威尔 | 勒威尔 | lerwill
福伊齐 | 福伊西 | foisie
马夸里 | 麦夸里 | maquarie
斯沃兹 | 斯沃德什 | swadesh
鲍沃 | 鲍尔 | bouwer
麦克罗 | 麦肯罗 | mcenroe
佩雷兹 | 佩雷斯 | perez
埃德利 | 埃奇利 | edgley
希克 | 舍克 | shirk
派耶 | 派尔 | peyer
艾恩斯 | 安斯 | aines
霍勒修斯 | 霍雷修斯 | horatius
怀特莱尔 | 怀特莱瑟 | whiteleather
库兰西克 | 库兰齐克 | kurlantzick
赫德克 | 赫德基 | hedke
勒克龙 | 莱克龙 | leckrone
佩恩 | 佩因 | pain
莱托克 | 勒托克 | letocq
乔弗里翁 | 乔夫里翁 | joffrion
克纳森 | 克努森 | knuthsen
默克莱恩 | 默克莱因 | merklein
卡马科 | 卡马乔 | camacho
卡布尔 | 卡贝尔 | cabell
霍奇 | 霍根 | hodgan
里哈尔 | 雷哈尔 | rehal
克雷弗 | 克里弗 | crever
哈根 | 黑根 | hagan
维特拉尔 | 维特拉西尔 | vytlacil
麦卡拉克 | 麦柯拉克 | maccurrach
凯特琳萨克 | 卡特林萨克 | katrinsak
萨马罗尤 | 萨马鲁 | samaroo
卡赫特 | 卡彻特 | kachert
埃夫格 | 埃维尤 | evjue
贾斯珀 | 贾斯帕 | jaspar
威尔科夫斯基 | 维尔科夫斯基 | wilkowski
伯尼特 | 伯内特 | burnett
克拉姆 | 克鲁姆 | krumm
法兹卡斯 | 法泽卡斯 | fazekas
普莱斯顿 | 普利斯顿 | puleston
科森 | 科瑟恩 | cothern
劳格林 | 劳克林 | laughlin
米德利 | 米奇利 | midgley
科莫尼亚克里克 | 科莫尼亚雷克 | komoniarek
贝塔 | 伯塔 | berta
高迪安 | 高迪恩 | gaudian
霍沃思 | 豪沃思 | howarth
吉尔迪 | 吉亚尔迪 | ghiardi
查森 | 蔡森 | chasen
希拉克 | 希莱克 | shillaker
金索尔万 | 金索尔文 | kinsolving
皮尼 | 派尼 | piney
德赖伯格 | 德赖伯勒 | dryburgh
莱彭内克 | 勒佩内克 | lepennec
内姆切克 | 内姆泽克 | nemzek
尤曼斯基 | 乌曼斯基 | umansky
斯特克科 | 斯特科 | stecko
厄尔利 | 厄利 | earley
特里福迪迪斯 | 特里福尼迪斯 | trifonidis
伊利特 | 艾利特 | ilett
多伊希尔 | 多伊施尔 | deuschl
艾尔明杰 | 艾尔明格 | irminger
弗特尔 | 费特尔 | fertel
费滕 | 法滕 | phaten
登宁 | 丹宁 | denning
本内特 | 贝内特 | bennete
多本施克 | 多本斯佩克 | daubenspeck
迪克森 | 德克森 | dirksen
肖弗勒 | 肖夫勒 | schauffler
德加拉迪安 | 德加拉贝迪安 | dergarabedian
布罗厄斯 | 布罗斯 | broas
格瓦特金 | 格沃特金 | gwatkin
鲍尔丹齐 | 巴尔丹齐 | baldanzi
纳吉恩 | 纳金 | nagean
姆利纳米克 | 姆利纳奇克 | mlinarchik
拉费蒂 | 拉菲蒂 | laffeaty
赛格尔 | 西格尔 | sigel
施韦特德 | 施韦蒂德 | schwetid
加哈根 | 加黑根 | gahagen
特里布 | 特赖布 | tribe
沃尔伦德 | 沃尔龙德 | walrond
比基特 | 比克特 | bicket
耶妮 | 耶尼 | yeni
贾斯卡克斯 | 贾斯帕克斯 | jasparks
梅尔谢默 | 梅尔斯海默 | melsheimer
特比特 | 特贝特 | tebet
基伦 | 基兰 | kiran
邓科姆 | 邓库姆 | duncombe
迪克 | 迪克尔 | dicker
格鲍尔 | 格巴尔 | geballe
布吕恩 | 布鲁恩 | bruene
安杰尔斯 | 安杰利斯 | angeles
布龙森 | 布朗森 | bronson
卡莎 | 卡沙 | kasha
埃丝拉 | 埃斯拉 | esra
多诺霍尔 | 多诺莫尔 | donoughmore
奇德尔 | 切德尔 | chedell
法尔 | 费尔 | fayer
布朗丁 | 布隆丁 | blondin
金格莱克 | 金莱克 | kinglake
蒙卡姆 | 蒙特卡姆 | montcalm
费罗萨德 | 费罗祖德 | ferozud
瑟谢 | 塞希 | sershey
拉克斯里思 | 拉克斯弗里思 | laxfrith
埃诺 | 伊诺 | eno
科奇尼希 | 科奇尼格 | kotschnig
德罗姆戈尔 | 德罗姆古尔 | dromgoole
埃德弗丽德 | 埃德弗里德 | eadfrid
韦克滕 | 维克滕 | vechten
罗吉特 | 罗热 | roget
道布 | 多布 | daub
沙夫斯伯里 | 沙夫茨伯里 | shaftesbury
伦德罗 | 伦德弗罗 | rendfrow
麦克诺格尔 | 麦克诺尔 | mcnaugher
拉夫尚 | 拉夫肖恩 | rafshoon
加斯丘 | 加斯克 | gasque
齐梅尔曼 | 齐梅曼 | zimmeman
纳伯斯 | 内伯斯 | nabors
鲍尔达扎 | 巴尔丹扎 | baldanza
穆恩 | 穆安 | muan
林德内斯 | 莱因德尼斯 | rhindness
汉德沃 | 汉德沃格 | handwerger
贝特拉 | 伯特拉 | bertera
奇尔德 | 蔡尔德 | child
西莫尼什 | 西莫尼奇 | simonitsch
高蒂耶 | 高蒂尔 | gauthier
梅佩尔 | 马佩尔 | mapel
帕尼思 | 帕内思 | paneth
伯尔纳夫 | 伯纳夫 | bernulf
安弗丽德 | 安弗里德 | amfrid
哈尼迪 | 哈内迪 | harnedy
布利肯施塔夫 | 布利肯斯塔夫 | blickenstaff
阿尔卡尔德 | 阿尔卡德 | alcalde
帕克特 | 帕赫特 | pachter
比塔 | 比塔尔 | bitar
麦克斯帕兰 | 麦克斯帕伦 | mcsparran
迪卢基奥 | 迪卢乔 | diluchio
米克尔约恩 | 米克尔约翰 | meiklejohn
普劳富特 | 普劳德富特 | proudfoot
韦格索 | 维格索 | vegso
维拉雷尔 | 维拉里尔 | villarreal
伊格莱维奇 | 伊格尔维奇 | iglewicz
洛西安 | 洛西恩 | lowthian
科米杰 | 康马杰 | commager
克拉布里 | 克拉布特里 | crabtree
维斯洛斯基 | 维斯克洛斯基 | visclosky
普朗 | 弗朗 | pfrang
切切尔斯基 | 切赫尔斯基 | cehelsky
达尔斯特龙 | 达尔斯特伦 | dahlstrom
利西摩尔 | 利西莫尔 | lissimore
德拉夫施泰特 | 德拉格施泰特 | dragstedt
彻尔尼 | 彻尼 | tscherny
杰普萨 | 杰普撒 | jeptha
塞迪亚 | 切迪亚 | ceddia
利伯恩 | 莱伯恩 | laybourne
马奥恩 | 马洪 | mahone
斯克里伯 | 斯克赖伯 | scriber
查斯 | 蔡斯 | chayes
施莱 | 施利 | schlie
塞金格 | 塞金杰 | seckinger
泽费雷利 | 泽菲雷利 | zeffirelli
亚历克西斯 | 亚历克西丝 | alexys
雷伊 | 雷 | rhae
孔施尼克 | 康施尼克 | konschnik
马尔克斯 | 马尔库斯 | malkus
曼恩 | 曼 | mann
厄尔里克 | 乌尔里克 | ullrich
埃尔坎 | 埃尔肯 | elkan
普钦斯基 | 普辛斯基 | pucinski
基米特 | 金米特 | kimmitt
克罗斯芒 | 克罗斯蒙 | croasmun
乔登斯 | 乔丹斯 | jordans
赫宁伯格 | 赫宁堡 | heningburg
福伊耶谢格 | 福伊尔齐格 | feuerzeig
马拉赫 | 马拉克 | malach
布兰达斯 | 布兰德法斯 | brandfas
吉尔鲍德 | 吉尔博 | guillebaud
伊萨科 | 伊萨科夫 | isakow
尼莎 | 尼萨 | neysa
戈特瓦尔斯 | 戈特沃尔斯 | gotwals
汉奇 | 汉格 | hange
贝特鲁普 | 贝格特鲁普 | begtrup
乌利克 | 尤利克 | ulick
安贝达卡 | 安贝德卡 | ambedkar
柯蒂斯 | 柯蒂兹 | curtiz
阿姆休茨 | 阿姆谢维茨 | amshewitz
西里 | 蒂里 | thierry
阿斯芬 | 阿斯普登 | aspden
森塞尼克 | 森塞尼奇 | sensenich
舍内曼 | 舍尼曼 | schoeneman
韦尼斯 | 维内斯 | veness
冈齐利 | 贡希利 | goonhilly
亚伯格 | 亚伯勒 | yarburgh
萨克斯 | 萨克斯比 | saxbe
尼纳基斯 | 尼奥纳基斯 | nionakis
西厄尔 | 休厄尔 | sewall
克利兰 | 克莱兰 | cleland
弗赖赖克 | 弗赖雷克 | freireich
萨吉里厄斯 | 萨吉泰里厄斯 | sagittarius
福斯 | 富斯 | fuoss
特怀德尔 | 特威德尔 | twidell
耶格 | 耶格尔 | yager
希曼娜 | 希曼纳 | sheemanna
布卢顿 | 布勒顿 | blurton
德马斯托 | 德马尔托 | desmarteau
迪伯斯坦 | 杜伯斯坦 | duberstein
戴维斯 | 戴维兹 | davids
克洛德纳 | 科洛德纳 | kolodner
科尔菲亚托 | 科菲亚托 | corfiato
法斯尔 | 法塞尔 | fascell
沃拉尼厄斯 | 瓦拉尼厄斯 | waranius
赫马尼克 | 赫马纽克 | hermaniuk
维思 | 韦思 | vaeth
拉齐 | 拉津 | razeen
古夫 | 高夫 | gough
巴塔格尔 | 巴塔杰尔 | battagel
富西洛 | 富奇洛 | fuccillo
内内曼 | 南尼曼 | nenneman
赫巴尔德 | 赫博尔德 | hebald
杜纳利 | 达纳利 | dunalley
惠伦 | 惠兰 | whelan
迪奥 | 德奥 | deo
拉思 | 雷思 | rathe
斯通纳 | 斯托纳 | stoner
布奇 | 布谢 | bouchey
斯莫尔佩斯 | 斯莫尔皮斯 | smallpeice
埃克伦茨 | 厄克伦茨 | ercklentz
埃尔库斯 | 埃尔克斯 | elkus
弗朗斯 | 弗朗西斯 | fraunces
希尔茨 | 希尔兹 | shields
皮克普 | 皮卡普 | pickup
科克斯 | 考克斯 | coxe
施温德曼 | 施文德曼 | schwendeman
霍金 | 霍奇金 | hodgkin
贾洛雷齐 | 贾洛伦齐 | giallorenzi
特穆多 | 塞穆多 | themudo
博索思沃思 | 博索姆沃思 | bosomworth
兹韦德林 | 兹沃德林 | zwerdling
麦克斯托芬 | 麦克斯蒂奥芬 | macstiofain
梅特罗普尔斯 | 梅特罗波利斯 | metropolis
兰塔克 | 兰加托克 | llangattock
贝拉尼娅 | 贝拉尼亚 | berania
利宁 | 莱宁 | leining
赫纳亨 | 赫纳汉 | henahan
杰里什 | 格里什 | gerrish
卡斯特莱恩 | 卡斯特兰 | castellain
埃夫达德 | 埃瓦德 | evvard
加弗 | 盖弗 | gaver
麦克马廷 | 麦克马丁 | macmartin
考斯利 | 库斯利 | cousley
普波 | 波波 | poepoe
乔德 | 乔德尔 | jordre
马尔文农 | 马尔韦农 | mulvenon
科菲恩 | 科芬 | coffeen
斯凯姆 | 斯基姆 | skym
格瓦尔托斯基 | 格瓦尔托夫斯基 | gewartowski
布思利 | 布思莱 | buthlay
盖切特 | 加切特 | gatschet
吉林 | 格林 | girling
伊弗利 | 伊夫利 | evelegh
贝尔基 | 贝尔克 | behlke
于里安 | 尤里安 | urien
萨森 | 萨瑟恩 | southern
奥尔博 | 阿尔博 | allbaugh
德利吉戈斯 | 德利乔治斯 | deligiorgis
哈巴赫 | 哈巴克 | harbach
米德拉尔斯基 | 米德拉斯基 | midlarsky
瑟弗 | 瑟维耶 | surveyer
奥莱夫 | 奥拉夫 | olave
莫菲 | 莫夫 | maufe
艾亚拉 | 阿亚拉 | ayala
戈歇尔 | 戈查尔 | gotshal
利克曼 | 莱克曼 | likeman
沙帕 | 沙帕尔 | shapar
科德尔 | 科格德尔 | cogdell
特里布瓦瑟 | 特里布沃瑟 | triebwasser
卡利斯尔 | 卡莱尔 | carlisle
威德尔 | 韦德尔 | weddle
拜萨特 | 比萨特 | bisat
皮尔特尼 | 普尔特尼 | pulteney
波兰 | 波伦 | pollan
