哈格森 | 哈根森 | haagensen
皮内 | 皮奈 | pinay
米尔黑德 | 缪尔黑德 | muirhead
舒普 | 肖普 | shoupp
普安 | 普汉 | puhan
科尔伦 | 科尔雷因 | coleraine
哈兹利特 | 黑兹利特 | hazlitt
布盖兹 | 布尔盖兹 | bourgaize
布龙海姆 | 布朗海姆 | bronheim
沃伊蒂克 | 沃伊蒂奇 | woytych
玛吉 | 马吉 | magi
维尔迪斯科 | 弗迪斯科 | verdisco
斯塔姆斯 | 斯泰姆斯 | stames
黑泽尔 | 黑兹尔 | hazell
勒罗伊德 | 利罗伊德 | learoyd
奥尔文厄姆 | 阿尔文厄姆 | alvingham
沙德伯格 | 谢德伯格 | schadeberg
祖格 | 佐格 | zeug
麦金泰尔 | 麦金太尔 | mcintire
切普林斯基 | 西普林斯基 | cieplinski
布鲁赫豪森 | 布鲁克豪森 | bruchhausen
贾姆森 | 詹姆森 | jameson
贝德纳斯基 | 贝德纳尔斯基 | bednarski
海因斯 | 海恩斯 | hains
沃格斯塔夫 | 瓦格斯塔夫 | wagstaffe
黑特姆 | 哈特姆 | hatem
斯彭塞 | 斯潘塞 | spenser
贝尔兹 | 比尔兹 | beards
菲尔金斯 | 弗金斯 | firkins
芭布 | 巴布 | baab
贝莱沃 | 贝尔维 | bellevue
布劳恩 | 布朗 | braun
赫卡尼克 | 赫雷查尼克 | hrechanyk
肖沃尔顿 | 肖维尔顿 | shovelton
阿迪 | 埃迪 | adye
凯蒂亚 | 凯蒂娅 | katia
阿拉蒙 | 阿拉芒 | allamong
尼迪 | 内迪 | neddy
勒尔克 | 罗尔克 | roelker
保斯 | 波斯 | paus
蒂里克 | 泰里克 | tyriq
索恩伯格 | 索恩伯勒 | thornburgh
尤迪切洛 | 尤迪塞洛 | iudicello
麦金纳尼 | 麦基纳尼 | macinerney
韦尔纳 | 沃尔纳 | woellner
布拉德劳 | 布拉德洛 | bradlaugh
尼斯克恩 | 尼斯肯 | kniskern
库劳 | 库罗 | courau
扎纳 | 策纳 | zaehner
特佩凯 | 特佩卡 | tepaika
金泽特 | 金瑟特 | gensert
杜瓦克斯 | 杜阿克斯 | duax
盖尔特纳 | 盖特纳 | gaertner
索锡 | 索西 | southee
阿莱维 | 阿利维 | alevey
塞达 | 西达 | theda
布拉夫 | 布洛 | bullough
安格尔 | 安杰尔 | angel
斯拉克 | 斯莱克 | slack
莫尔菲 | 莫菲 | morfee
舍恩巴克 | 舍恩巴赫 | schoenbach
恩德烈尼 | 恩德雷尼 | endrenyi
斯托沃尔 | 斯托瓦尔 | stovall
怀曼 | 威曼 | wiman
马诺赫 | 马诺克 | marnoch
勒温克龙 | 洛温克伦 | lowenkron
西特龙 | 西特伦 | citron
利弗塞奇 | 利弗西奇 | liverseidge
塞弗里 | 萨弗里 | savery
奥西 | 奥齐 | orczy
阿查博尔 | 阿查巴尔 | archabal
迪伯曼 | 杜伯曼 | duberman
迪本 | 德本 | deben
法斯纳赫特 | 法斯纳克特 | fasnacht
佩奇 | 皮奇 | pechey
沙普尔斯 | 沙普利斯 | sharpless
弗西瓦尔 | 费西瓦尔 | fercival
戴维 | 达维 | davee
克拉丽达 | 克拉里达 | clarida
梅耶森 | 迈耶森 | mayerson
克拉恩 | 克拉汉 | crahan
马辛库斯 | 马辛克斯 | marcinkus
沃基特 | 瓦克特 | wackett
罗巴蒂斯 | 罗巴茨 | robartes
斯蒂格利茨 | 施蒂格利茨 | stiglitz
麦凯肯 | 麦凯琴 | maceachen
格里贝诺 | 格里布诺 | griebenow
缪里诺 | 穆里诺 | murino
布里斯 | 布赖斯 | brise
瓦斯默 | 沃斯默 | wasmer
梅约斯 | 梅杰斯 | majors
埃金 | 伊金 | eking
格雷博 | 格里博 | grebow
沃拉克 | 沃勒克 | wallack
胡迪尼 | 霍迪尼 | houdini
坦嫩鲍姆 | 特南鲍姆 | tennenbaum
托比特 | 托贝特 | torbett
泰雷尔 | 蒂雷尔 | tyrell
卡尔戈 | 卡戈 | cargo
斯坦布勒 | 斯坦伯勒 | stanbrough
安德琳 | 安德林 | andelin
伯杰文 | 伯格文 | bergevin
曼丘西 | 曼库西 | mancusi
希史密斯 | 希尔史密斯 | shearsmith
赫尔斯滕 | 赫尔斯特恩 | hellstern
金格 | 金奇 | kynge
迪海 | 德海 | dehay
克里斯坦 | 克里斯廷 | kristine
布拉米尔斯 | 布拉迈尔斯 | blamires
雅科布斯坦 | 雅各布斯坦 | jacobstein
赫金斯 | 哈金斯 | hugghins
恩斯拉德 | 恩斯鲁德 | ensrud
英奇金 | 英奇昆 | inchiquin
基尔里 | 基里 | kearey
布贾克 | 布亚克 | bujake
斯坦拉克 | 斯坦莱克 | stanlake
温切尔西亚 | 温切尔西 | winchelsea
德尔菲 | 德菲 | durfee
毛尔 | 莫尔 | maule
施威默 | 施维默 | schwimmer
科德 | 科尔德 | coard
尼迪 | 内迪 | neddie
弗雷德丽卡 | 弗雷德里卡 | fredrica
加利亚多 | 加利亚尔多 | galiardo
诺托尔 | 纳托尔 | nuttall
库达希 | 卡达希 | cudahy
吉尔休利 | 吉尔胡利 | gilhuly
莱因斯 | 莱恩斯 | lines
约基尔森 | 约克尔森 | yochelson
米尔德万 | 米尔德文 | mildvan
泰泽 | 泰瑟 | tysser
巴里克 | 巴威克 | barwick
桑比 | 桑德比 | saundby
费多基克 | 费多奇克 | fedochik
耶曼斯 | 伊曼斯 | yeamans
克利安德 | 克林德 | cleander
苏里纳 | 苏雷纳 | surena
甘博厄 | 甘博亚 | gamboa
阿夫伯里 | 埃夫伯里 | avebury
图伊希 | 图伊 | tuohey
弗朗岑 | 弗兰岑 | frantzen
马加法恩 | 马加芬 | magafan
汤姆兰 | 汤姆林 | tomline
贝尔里 | 比尔里 | beary
达姆勒 | 杜姆勒 | dumler
佩洛贝特 | 佩卢贝特 | peloubet
豪恩谢尔 | 霍恩谢尔 | hounshell
班顿 | 贝恩顿 | baynton
沃伊格特 | 沃伊特 | voigt
伍尔斯泰特 | 沃尔斯泰特 | wohlstetter
瑟娜 | 塞尔纳 | serna
杰瑟里克 | 杰塞里克 | jeserich
克利姆克 | 克利姆基 | klimcke
凯斯 | 基斯 | keys
勒福恩 | 勒方 | lefaune
奥钦克洛斯 | 奥金克洛斯 | auchincloss
埃尔 | 埃尔勒 | ehrle
范迪维耶 | 范迪维尔 | vandivier
登帕萨 | 登帕西 | dempasay
奈斯利 | 尼斯利 | knisely
吉格雷 | 吉格尔 | giguere
阿加西亚 | 阿加西娅 | agacia
克里茨 | 克赖茨 | crites
坦迪恩 | 坦丁 | tandien
萨尔特 | 索尔特 | salter
索瑟登 | 萨瑟登 | southerden
沃泰姆 | 沃特海姆 | wertheim
亨萨克 | 亨塞克 | hunsaker
齐默 | 泽默 | zemmer
斯托尔兹弗格 | 斯托尔兹伯格 | stolzberg
海尔凯 | 海尔基 | heilkay
贝奥利 | 比利 | beoley
耶登 | 伊登 | yeadon
阿巴斯特尼亚 | 阿巴斯蒂尼亚 | abastenia
丹尼斯 | 德尼斯 | deneys
纽伯勒 | 纽伯格 | newburgh
博特塞特 | 博塞特 | botset
海尔兹 | 希尔兹 | hilds
万诺伊 | 范诺伊 | vannoy
道恩 | 杜恩 | doune
德黑斯 | 德海斯 | dehayes
伊尔森 | 艾尔森 | eielson
凯西米尔 | 卡西米尔 | kasimir
辛皮克 | 辛皮奇 | simpich
赞布鲁姆 | 赞布勒姆 | zambrum
韦德伍德 | 韦奇伍德 | wedgwood
格里弗尔 | 格里费尔 | griffel
布卢梅菲尔德 | 布卢姆菲尔德 | blumefield
布金 | 布尔金 | bourgin
兰迈德 | 兰梅德 | langmaid
基珀 | 凯珀 | kuiper
斯特兰格 | 斯特兰杰 | stranger
施纳克 | 施努克 | schnuck
佩金 | 帕金 | pagin
贾拉特 | 贾勒特 | jarratt
伯娜 | 伯纳 | berna
派约特 | 派奥特 | pyott
塞勒斯 | 塞拉斯 | sellars
卡斯特尔伯里 | 卡斯尔伯里 | castelberry
凯格 | 基格 | keig
菲阿尔卡 | 菲亚尔卡 | fialka
米尼奥 | 米内奥 | mineo
布勒宁 | 布罗宁 | broening
普尔特 | 波尔特 | poulter
斯图扎 | 斯图尔扎 | stoorza
杰格尔 | 杰格 | jeger
古利克森 | 格利克森 | gulliksen
贝勒 | 贝利 | behle
洛伦曾 | 洛伦岑 | lorenzen
阿莱格拉 | 阿利格拉 | allegra
赖克沃特 | 里克沃特 | rykwert
卢宁 | 吕宁 | luening
格尔纳 | 盖尔纳 | gellner
亨尼卡特 | 亨尼克特 | hunnicutt
费尔马纳 | 费尔曼纳 | fairmaner
里迪福 | 里迪福德 | riddiford
特雷西 | 特蕾西 | tracey
库蒂斯 | 柯蒂斯 | kurtis
乌斯勒 | 奥斯勒 | oursler
杰舒阿 | 杰舒亚 | jeshua
麦克尼拉奇 | 麦克尼利奇 | macneilage
施雷尔 | 施赖尔 | schreyer
斯迈思 | 史密斯 | smyth
奥尔弗森 | 阿尔弗森 | alverson
坎普沙罗 | 坎普施罗尔 | kampschror
海内曼 | 海涅曼 | heinemann
特里斯特伦 | 特里斯特雷姆 | tristrem
奥琳达 | 奥林达 | orinda
里维特 | 里韦特 | rivet
哈尔巴克 | 哈尔巴赫 | halbach
戈德温 | 戈尔德温 | goldwyn
特罗蒂埃 | 特罗蒂尔 | trottier
鲍厄尔斯 | 鲍威尔斯 | powels
扎赫曼 | 扎克曼 | zachmann
海斯洛普 | 希斯洛普 | hyslop
希尼 | 赫尼 | henie
里夫尔 | 里弗尔 | riffle
格里甘蒂 | 格雷甘蒂 | greganti
梅迪森 | 麦迪逊 | madison
莱恩斯 | 莱昂斯 | lyons
哈森富斯 | 哈森弗斯 | hasenfus
加托夫 | 加特霍夫 | garthoff
卡萨桑特 | 卡萨森特 | casasent
布兰肯巴克 | 布兰肯贝克 | blankenbaker
达什曼 | 杜什曼 | dushman
基西 | 凯西 | kesey
莫纳 | 莫娜 | mona
特鲁赫特 | 特鲁哈特 | trueheart
巴齐莱 | 巴尔齐莱 | barzilay
福内斯 | 福尼斯 | forness
鲍杜因 | 鲍德温 | bauduin
珀森 | 皮尔逊 | pirsson
康诺米 | 科诺米 | conomy
德赖克 | 德里克 | driker
麦吉恩蒂 | 麦金蒂 | mcguinty
斯温伯勒 | 斯旺伯勒 | swanborough
阿文代尔 | 埃文代尔 | avondale
德保 | 德波 | depauw
罗斯布鲁 | 罗斯伯勒 | rosebrough
格劳尔 | 格罗尔 | grower
米伯勒 | 迈伯勒 | myburgh
马马杜克 | 马默杜克 | marmaduke
克伦 | 克兰 | kerlan
埃查德 | 伊查德 | eachard
平杰 | 平格 | pinger
贝德尔 | 比德尔 | bedel
塞夫尔 | 萨维尔 | savele
沃梅利 | 沃姆利 | wormeley
米道 | 米多 | middaugh
米尔 | 缪尔 | muille
梅维蒂 | 马维蒂 | mavity
阿加斯 | 阿加丝 | agase
杰雷迈亚 | 杰里迈亚 | jeremiah
卡尔卡诺 | 卡尔卡尼奥 | calcagno
洛格 | 洛奇 | lorge
格林肖 | 格里诺 | greenhow
萨韦尔 | 萨维尔 | savelle
奥利夫 | 奥利芙 | olive
厄彻博尔德 | 厄奇博尔德 | erchebald
弗德里 | 维德里 | verdery
希伯德 | 希巴德 | hibbard
埃道斯 | 埃多斯 | eddowes
埃博罗尔 | 埃博拉尔 | eborall
卡德瓦拉杰 | 卡德瓦拉德 | cadwaladyr
赖德尔 | 里迪尔 | rideal
汉利 | 汉布利 | hambley
坦克蕾托 | 坦克雷托 | tancreto
盖滕拜因 | 盖滕宾 | gaitenbein
