布雷金里奇 | 布雷肯里奇 | breckinridge
玛莉 | 马利 | maly
阿西尼加 | 阿西涅加 | arciniega
法莱恩 | 法兰 | farlane
胡普特 | 豪普特 | houpt
西恩 | 西根 | seaghan
斯特拉思汉 | 斯特拉森 | strathearn
派珀特 | 佩珀特 | peipert
皮内 | 皮奈 | pinay
梅雷斯曼 | 米尔斯曼 | meresman
弗兰宗 | 弗兰曾 | franzon
伊兹比基 | 伊兹比茨基 | izbicky
埃卡维斯特 | 埃沙韦斯特 | echaveste
费尔伯恩 | 费尔贝恩 | fairbairn
迈尔黑德 | 缪尔黑德 | muirhead
舒普 | 肖普 | shoupp
普安 | 普汉 | puhan
沃塞尔 | 瓦塞尔 | wassell
亨巴克 | 亨巴赫 | heimbach
基布勒 | 库布勒 | kuebler
纳尔迪 | 纳迪 | nardi
杰米马 | 杰迈玛 | jemima
莫杜特 | 莫德维 | mauduit
惠塔克 | 惠特克 | whitacre
艾特 | 艾厄特 | eyet
约德利 | 亚德利 | yeardley
博比 | 鲍比 | bobbie
迪普斯 | 杜普斯 | dupes
麦基尔文纳 | 麦基尔温纳 | macilvenna
赖因斯 | 赖恩斯 | rines
麦克费伦 | 麦克弗伦 | mcpherren
埃德尔霍赫 | 埃德尔霍克 | edelhoch
博特扎尔 | 博索尔 | botsal
科克拉姆 | 科克勒姆 | cockrum
韦格尼 | 韦恩 | wagne
多特曼 | 多伊特曼 | deutermann
厄德曼 | 厄尔德曼 | erdman
戈伦贝斯基 | 戈伦别夫斯基 | golembiewski
夏尔迪 | 恰尔迪 | ciardi
格雷戈伊尔 | 格雷瓜尔 | gregoire
米卡亚 | 迈凯亚 | micajah
科姆萨罗夫 | 科梅萨罗夫 | komesaroff
雷梅克斯 | 拉马克斯 | raemakers
皮凯弗 | 皮卡弗 | piccaver
苏布林 | 萨布林 | subrin
斯克拉顿 | 斯克鲁顿 | scrutton
津南 | 津宁 | zinnen
费登 | 法登 | faden
布尔盖斯 | 布尔盖兹 | bourgaize
佩莱蒂埃 | 佩尔蒂埃 | pelletier
帕塞尔 | 帕斯尔 | parcel
霍诺里 | 霍诺丽 | honori
艾梅施 | 伊梅施 | imesch
埃尔滕黑德 | 埃尔顿黑德 | eltonhead
西明顿 | 赛明顿 | symington
布龙海姆 | 布朗海姆 | bronheim
马霍尔特 | 玛奥 | mahault
法克 | 菲克 | fike
奥德斯 | 奥杜斯 | audus
加布尔 | 加伯 | gabbour
瓦克特尔 | 瓦赫特尔 | wachtel
塔利亚德罗罗 | 塔利亚费罗 | tagliaferro
舒格 | 沙格 | shugg
夏维尔 | 希维尔 | shivell
梅基宁 | 马基嫩 | makinen
拉凯斯 | 拉雪兹 | lachaise
达维格多 | 达维多尔 | d'avigdor
曼纳韦 | 马纳韦 | mannaway
迈恩 | 米恩 | meighen
托马 | 托伊马 | teuma
奥夫 | 奥 | ough
阿福蒂 | 阿富尔蒂特 | affourtit
米萨尔 | 米赛尔 | misael
赫默里赫 | 亨默里克 | hemmerich
詹宁斯 | 杰宁斯 | jenyns
斯塔姆斯 | 斯泰姆斯 | stames
文恩 | 维恩 | venn
安瓦里庞 | 安瓦里普尔 | anvaripour
比比 | 毕比 | beebe
凯斯勒 | 基斯勒 | keisler
考尔德尔 | 考德尔 | caldell
博查特 | 博哈特 | borchardt
卡明 | 卡迈恩 | carmine
巴特伦 | 巴特拉姆 | bartram
派尔 | 皮尔 | peile
麦康 | 麦肯 | mccon
舒克伯格 | 舒克伯勒 | schuckburgh
麦卡里 | 麦凯里 | mccarey
阿米利奥 | 阿梅利奥 | amelio
英芬特 | 因方特 | infant
杰罗尔 | 杰拉尔 | gerall
亨内肯斯 | 亨尼肯斯 | hennekens
贾弗 | 贾埃弗 | giaever
贾米 | 杰米 | jamie
斯特吉斯 | 斯特奇斯 | sturges
莫克萨姆 | 莫克塞姆 | moxam
夏尔曼 | 沙伊尔曼 | shireman
梅索利 | 梅索伊 | meszoly
埃森斯 | 埃森丝 | essence
格沃思米 | 格瓦思米 | gwathmey
巴比罗利 | 巴尔比罗利 | barbirolli
利布 | 利比 | luebbe
哈泽尔 | 黑兹尔 | hazell
施蒂宁 | 斯蒂宁 | stiening
克莱农 | 克勒农 | clernon
金德雷德 | 金德里德 | kindred
纳索尔 | 纳托尔 | nuthall
佐扎 | 佐尔扎 | zorza
戴格 | 戴伊 | daigh
伊坦 | 埃泰恩 | etain
德尔里戈 | 德尔列戈 | delriego
巴策 | 巴策尔 | batzer
廷肯 | 廷康 | tinkon
德弗雷茨 | 迪弗雷特斯 | defrates
尤拉姆 | 乌拉姆 | ulam
梅里迪思 | 梅雷迪思 | meredith
沙德伯格 | 谢德伯格 | schadeberg
迪多 | 德多 | dedow
米恩斯 | 默恩斯 | mearns
格罗布 | 格罗比 | grobe
塔塔利亚诺 | 塔尔塔利诺 | tartaglino
兰姆 | 拉姆 | lambe
卡德韦尔 | 考德威尔 | caldwell
利多尔 | 利德尔 | liddall
希利 | 赫利 | helie
坎特伯里 | 坎特伯雷 | canterbury
斯蒂克 | 斯特克 | stirk
塔肯 | 泰肯 | tacon
古特穆特 | 古特穆思 | gutermuth
弗森 | 费尔森 | ferson
托皮 | 托毕 | torpey
洛多维克 | 洛多威克 | lodowicke
梅拉尼 | 梅拉妮 | melanie
泰奇曼 | 泰克曼 | teichmann
普鲁德姆 | 普鲁多姆 | prudhomme
基斯特纳米 | 基斯特纳萨米 | kistnasamy
齐格 | 佐格 | zeug
坎比 | 坎贝 | cumbey
赫姆尔 | 赫姆利 | hermle
蒙根 | 蒙贡 | mongon
亨佩尔 | 亨普尔 | hempel
艾罗 | 艾罗尔特 | ayrault
赖蒂娜 | 赖蒂纳 | rytina
雷亚 | 雷 | rea
布雷登索尔 | 布赖登塔尔 | breidenthal
德卢吉 | 德路易吉 | deluigi
科切雷斯 | 科克里斯 | cocheres
巴姆菲尔德 | 班菲尔德 | bamfield
鲁亚德 | 鲁阿兹 | ruadh
克拉伯 | 克莱伯 | klaber
格里特黑德 | 格雷特黑德 | greathead
巴斯凯特 | 巴斯克特 | baskette
马尔特比 | 莫尔特比 | maltby
埃塞雷达 | 埃塞丽达 | ethelreda
迪娜 | 迪恩纳 | dienna
博里尔 | 博雷尔 | boreel
布雷恩 | 布里恩 | brehon
吉尔 | 圭尔 | guire
坦尼肯 | 滕尼肯 | tennican
勒文 | 莱文 | levene
朱林科 | 祖林科 | dzurinko
林利思霍 | 林利思戈 | linlithgow
奇普林斯基 | 西普林斯基 | cieplinski
索伊纳 | 索杰纳 | sojourner
布鲁赫森 | 布鲁克豪森 | bruchhausen
纽贝尔 | 努贝尔 | knubel
卡诺肯 | 卡诺坎 | carnochan
罗克辛 | 罗克西娜 | roxinne
伊登斯 | 埃登斯 | edens
贾米森 | 詹姆森 | jameson
比哈里尔 | 贝哈里尔 | beharriell
朗彻普 | 朗香 | longchamp
库特鲁费洛 | 卡特鲁费洛 | cutrufello
舒尔金德 | 舒尔坎德 | schulkind
佩奇 | 佩什 | peche
洛伦兹 | 洛伦茨 | lorenz
特普尔 | 蒂普尔 | tepoel
吉莫 | 贾伊莫 | giaimo
库尔吉安 | 库尔金 | kuljian
哈米利恩 | 哈米里恩 | hamilyon
基尔库塞 | 基尔科西 | kilcoursie
里森诺弗 | 里曾诺弗 | reasonover
查恩 | 查康 | chacon
雷布萨门 | 里布萨门 | rebsamen
托菲琴 | 托菲肯 | torphichen
布利肯德瑟 | 布利肯斯德弗 | blickensderfer
哈尔基特 | 霍尔基特 | halkett
戈萨尔斯 | 戈瑟尔斯 | goethals
瓜尔蒂里 | 瓜尔蒂耶里 | gualtieri
泽兰 | 齐伦 | zeran
比贝尔 | 比布尔 | biebel
奥尔德斯特尔 | 奥尔德斯泰尔 | oldstyle
西门斯 | 西门子 | siemens
特普西奇 | 特普西克 | tepsic
普利本 | 普利邦 | plybon
佩耶夫 | 帕耶夫 | payeff
斯温斯勒德 | 斯温斯拉德 | swensrud
比希纳 | 比克纳 | beichner
恩戈姆 | 恩格霍姆 | engholm
惠特洛 | 怀特洛 | whytlaw
兰内伯格 | 兰恩伯格 | ranneberger
桑德威克 | 桑威克 | sandwick
怀思 | 韦思 | wyeth
施魏柴尔德 | 施韦柴尔德 | schweichild
斯坦霍普 | 斯坦诺普 | stanhope
英沃尔斯塔德 | 英沃斯塔德 | ingvoldstad
森霍尔 | 桑戈尔 | senghor
布里豪斯 | 布里格豪斯 | brighouse
克伦布哈尔 | 克伦巴尔 | krumbhaar
莫拉尔 | 莫勒 | morar
弗里利 | 弗赖利 | friley
赖兰斯 | 赖伦斯 | rylance
赫斯莱普 | 赫斯利普 | heslep
鲍特尔 | 鲍塔尔 | boutall
斯帕延 | 斯佩因 | spayin
哈勒尔 | 哈拉尔 | harral
马谢特 | 马希特 | mushet
杜切斯 | 达切斯 | dutchess
布鲁姆利 | 布伦利 | brumley
比尔特 | 伯特 | birt
菲格雷斯 | 菲格斯 | figures
埃加尔 | 埃加 | eggar
特库姆什 | 特库姆塞 | tecumseh
伊万杰莉塔 | 埃万杰利斯塔 | evangelista
韦布利 | 韦伯利 | webley
帕门蒂尔 | 帕尔芒捷 | parmentier
迪金利斯 | 迪安杰利斯 | deangelis
格里诺瓦尔特 | 格里纳沃尔特 | greenawalt
麦格拉斯里奇 | 麦格拉斯里克 | macglasrich
索恩顿 | 桑顿 | thornton
巴洛克 | 巴洛赫 | balloch
切尔内斯基 | 切尔涅斯基 | chernesky
贝勒夫 | 贝尔维 | bellevue
西博恩 | 西伯恩 | seaborn
凯肖恩 | 基肖恩 | keyshawn
布劳恩 | 布朗 | braun
拉德姆 | 拉德勒姆 | rudderham
特里利文 | 特里莱文 | treleaven
肖韦尔顿 | 肖维尔顿 | shovelton
比斯内尔 | 比尤内尔 | buesnel
阿迪 | 埃迪 | adye
哈格迈耶 | 哈格迈尔 | hagemeyer
凯希亚 | 凯蒂娅 | katia
阿拉蒙 | 阿拉芒 | allamong
西米恩 | 西明 | siemien
罗恩德 | 罗安德 | rowand
普里亚尔 | 普赖尔 | prial
布利萨克 | 布利萨茨 | blisac
马尼斯 | 马内斯 | maness
阿博德 | 阿布德 | abboud
拜兹 | 比德兹 | bidez
艾威尔 | 厄维尔 | irwil
威尔梅特 | 薇尔梅特 | wilmett
纳拉乔 | 纳兰霍 | naranjo
布雷兰 | 布里兰 | breland
奥钦达基 | 奥金达基 | auchindachie
卡尔 | 卡利 | karle
阿德莉娜 | 阿德利娜 | adelina
斯特尔特 | 斯泰尔特 | stelter
明韦尔 | 米恩韦尔 | meanwell
沙克伯格 | 沙克伯勒 | shuckburgh
特雷富西斯 | 特里富西斯 | trefusis
亚历克森森 | 亚历山德森 | alexanderson
朱皮特 | 丘辟特 | jupiter
多特里希 | 多伊特里希 | deutrich
托厄里 | 托尔里 | towery
马德林 | 马德琳 | madlin
威舍 | 维舍 | wischer
戴加德 | 迪格 | dygard
伍里斯特 | 沃里斯特 | woreester
西克雷斯特 | 西克里斯特 | secrest
拉扎 | 拉扎尔 | lazar
麦高恩 | 麦古恩 | macgoun
佩茨 | 皮特斯 | petes
皮克斯 | 皮尔克斯 | pearkes
费尔哈文 | 费尔黑文 | fairhaven
特里德加 | 特里迪加 | tredegar
佩洛 | 佩洛特 | pelot
阿莉 | 阿利 | alli
阿蒂加尔 | 阿蒂格尔 | attygalle
马西娅 | 玛西娅 | mathea
费布勒 | 法布勒 | fabler
彼得鲁斯卡 | 彼特鲁斯卡 | petruska
弗恩 | 维恩 | verne
尤迪切洛 | 尤迪塞洛 | iudicello
韦姆 | 瓦伊姆 | waim
鲁埃兰 | 鲁伦 | ruellan
拉赫特 | 拉克特 | lachter
拉哈布 | 雷哈布 | rahab
麦金纳尼 | 麦基纳尼 | macinerney
埃根 | 伊根 | egan
斯蒂格勒 | 施蒂格勒 | stigler
特威宁 | 特文宁 | twining
西达罗斯 | 西达劳斯 | sidarouss
弗洛杜迪 | 弗劳尔迪 | flowerdew
盖兰 | 格兰 | gellan
吉梅尼斯 | 希门尼斯 | jimenez
威尔纳 | 沃尔纳 | woellner
杜因特 | 德温特 | dewint
尼斯克恩 | 尼斯肯 | kniskern
布鲁因 | 布勒因 | bruyn
瓦尔斯特龙 | 沃尔斯特龙 | walstrom
库劳 | 库罗 | courau
迪米奥 | 迪梅奥 | dimeo
麦格雷瑟 | 麦格鲁瑟 | macgreuther
柯特尼厄斯 | 柯特纽斯 | curtenius
赫利娜 | 赫莉娜 | helina
伊蒂拉格 | 伊泰拉格 | itteilag
斯特龙奇 | 斯特朗 | stronge
埃沃伊 | 伊沃伊 | evoy
迪伦富思 | 迪伦弗思 | dyhrenfurth
麦肯纳尔蒂 | 麦克纳尔蒂 | macenulty
坦吉 | 坦圭 | tanguay
拉斯布里格 | 拉斯布里杰 | rusbridger
沃塞斯 | 沃西斯 | wathes
杜布拉斯 | 杜布拉 | dubras
亚兹明 | 亚斯明 | yazmin
劳德代尔 | 劳德戴尔 | lauderdale
奥尔德温 | 阿尔德温 | aldwin
伯贝奇 | 伯比奇 | burbage
哈斯卢普 | 哈斯勒普 | haslup
泽纳 | 策纳 | zaehner
科尔尼特 | 科尔内特 | collnette
波洛斯 | 普洛斯 | poulos
莱万多 | 柳安多 | lewando
查莱诺 | 查利诺 | challenor
博姆 | 鲍姆 | baume
克莱恩 | 克莱因 | clyne
休林斯 | 赫林斯 | hulings
梅尔德丽姆 | 梅尔德里姆 | meldrim
弗里岑 | 弗里曾 | fritzen
比纳吉奥 | 比纳乔 | binaggio
金塞特 | 金瑟特 | gensert
麦凯尔 | 麦考尔 | mackal
阿利曼 | 阿利芒 | allemang
赛奇 | 赛什 | saich
皮奥特罗夫斯基 | 彼得罗夫斯基 | piotrowski
贾恩 | 扬 | jahn
康加尔顿 | 康高尔顿 | congalton
戴森霍费尔 | 戴森霍弗 | deisenhofer
沙滕克 | 沙滕柯克 | schattenkerk
格里纳特 | 格林赫特 | greenhut
法隆 | 法伦 | falloon
奥斯威 | 奥斯威尤 | oswiu
兰德威西 | 兰德沃西 | landwirthy
索锡 | 索西 | southee
米隆 | 米伦 | millon
艾利 | 艾莉 | eily
埃克恩 | 伊肯 | ekern
菲利恩 | 菲利翁 | filion
苏申 | 舒尚 | shooshan
莫佩斯 | 莫皮斯 | moppes
菲茨米蒙斯 | 菲齐蒙斯 | fitzimons
阿勒维 | 阿利维 | alevey
帕塞尔 | 帕斯尔 | parcell
泰博尔特 | 蒂博尔特 | tybalt
索尔 | 苏尔 | soul
德黛奥 | 戴德奥 | dedeo
麦克雷思 | 麦克勒思 | mackereth
奥瑟 | 奥泽 | orser
帕珀马斯特 | 佩珀马斯特 | papermaster
贝伦德斯 | 贝伦兹 | berendes
杜布尔迪 | 道布尔迪 | doubleday
埃拉齐姆 | 伊拉齐姆 | erazim
施雷德 | 施拉德 | schrade
伯克 | 比尔克 | birck
巴托尔森 | 巴托尔松 | bartholdson
查努廷 | 查纽廷 | chanutin
埃塞克 | 伊塞克 | esek
梅尔霍弗 | 迈尔霍费尔 | maierhofer
安加拉拉 | 安加罗拉 | angarola
马伦普尔 | 马伦普雷 | malempre
多奇 | 德奇 | doetsch
阿雷顿 | 阿里顿 | arreton
贝哈 | 贝亚 | beha
法尔布伦斯 | 法尔布兰斯 | firebrance
富洛姆 | 富勒姆 | fullom
博尔多 | 波尔多 | bordeaux
德西德里厄斯 | 德西迪里厄斯 | desiderius
撒尔戈特 | 索尔戈特 | thalgott
舍恩巴克 | 舍恩巴赫 | schoenbach
马尼尔 | 马尼耶 | magnier
阿尔特林厄姆 | 奥特林厄姆 | altrincham
艾纳姆 | 埃努姆 | aernum
麦基尔雷维 | 麦基雷维 | macilrevie
默丁斯 | 默廷斯 | merttins
科卡姆 | 科克姆 | corkum
努特森 | 纳特森 | nutson
哈夫纳 | 哈文纳 | havenner
多尔兹 | 德尔兹 | doelz
格威卡德斯 | 格威查德斯 | gwychardus
埃维兹 | 阿维兹 | avids
莫布斯比 | 莫布兹比 | mobsby
恩迪 | 农迪 | nundy
凯尔斯 | 西尔斯 | cyres
西加尔 | 西格尔 | seegal
阿奎约 | 阿夸约 | aquayo
弗雷林休森 | 弗里林海森 | frelinghuysen
麦克鲁登 | 麦克拉登 | mccrudden
帕杰利斯 | 帕盖利斯 | pargellis
布雷斯洛夫斯基 | 布雷斯拉夫斯基 | breslawsky
达夫尼 | 达夫妮 | daphne
恩德伦吉 | 恩德雷尼 | endrenyi
麦克莱夫 | 麦克拉夫 | mcclave
罗曾塔尔斯 | 罗森塔尔斯 | rozentals
麦康基 | 麦康希 | macconchy
桑德姆 | 桑达姆 | sandham
马宁 | 曼宁 | maning
布莱赫特 | 布拉胡特 | blachut
赫明 | 亨明 | hemming
特文加德姆 | 蒂文加杜姆 | tirvengadum
马米 | 玛米 | mami
杰纳罗 | 吉尼罗 | genero
比斯特 | 比伊斯特 | buist
拉拉莫尔 | 拉腊莫尔 | laramore
哈克 | 黑克 | hake
谢弗德 | 谢泼德 | shepherd
哈沙根 | 哈舍根 | hashagen
赖尔斯 | 赖亚尔斯 | ryalls
特里梅因 | 特里曼 | tremain
梅伦 | 默龙 | merron
安克鲁姆 | 安克拉姆 | ancrum
鲁伊斯 | 吕埃 | ruez
欧斯莱格 | 奥恩斯莱格 | oenslager
哈加丁 | 哈格丁 | hargadine
利克姆 | 利克希姆 | leikhim
沃茨哈弗 | 沃特沙夫特 | wirtschafter
艾默斯 | 伊穆斯 | imus
托赫 | 托克 | toch
杜温特 | 德温特 | dewenter
哈雷尔 | 哈勒尔 | harrel
斯普勒 | 施普勒 | spuhler
马诺赫 | 马诺克 | marnoch
阿马尼 | 阿尔马尼 | armani
弗莱布 | 弗莱比 | flebbe
汤布斯 | 图姆斯 | tombs
达夫隆 | 杜弗隆 | duflon
贝恩 | 本 | benn
梅纳厄姆 | 梅纳汉 | menaham
麦基利肯 | 麦基利坎 | mackillican
多里 | 多丽 | dorrie
法尼夫 | 法纳夫 | faneuf
罗伯斯顿 | 罗伯茨顿 | robertston
科尔克拉瑟 | 科尔克拉泽 | colclaser
罗赫 | 罗奇 | roch
多勒 | 多拉夫 | dorough
巴尔尼尔 | 巴尼尔 | balniel
菲林 | 法尔林 | firing
克莱姆 | 克莱米 | klemme
费尔 | 费雷 | ferre
安娜贝尔 | 安娜贝勒 | annabelle
福伊西 | 福西 | feusi
曾伯格 | 宗伯格 | zumberg
萨加 | 塞格尔 | sagar
恩格兰 | 英格兰 | england
利弗塞奇 | 利弗西奇 | liverseidge
西拉森 | 西劳森 | cilawson
艾德斯莫 | 艾兹莫 | eidsmoe
阿布 | 阿贝 | abbe
麦卡哈蒂 | 麦克哈蒂 | mccahearty
麦克芒 | 麦克蒙 | mcmunn
迪波特 | 杜波特 | duport
韦斯特摩兰 | 威斯特摩兰 | westmoreland
伯格哈德 | 伯格哈特 | burghard
埃尔普 | 厄普 | earp
蒙多尔 | 蒙多 | mondor
施赖纳 | 施里纳 | shriner
斯塔布尔菲尔德 | 斯塔布菲尔德 | stubblefield
弗皮利奥 | 韦皮勒 | verpilleux
汤南德 | 汤恩德 | townend
艾内斯 | 伊内兹 | inez
杰普伦 | 杰波恩 | jepoen
伯肯霍尔茨 | 伯肯霍尔兹 | birkenholtz
默蒂斯 | 默特斯 | mertes
拉基特 | 勒基特 | luckett
斯普尔 | 斯珀尔 | spurr
伊德 | 伊德尔 | eader
维诺格拉德 | 维诺格勒 | vinograd
安纳莫尔 | 安纳克莫尔 | annaghmore
斯特德曼 | 斯蒂德曼 | studeman
莱莱恩 | 勒林 | lelean
布里森 | 布赖森 | bridson
里森 | 里斯滕 | wristen
皮里斯廷 | 皮里斯坦 | pearistine
马哈维奇 | 马达维赫 | mhadavikh
戈勒布 | 戈卢布 | golub
达拉克 | 杜拉奇 | dullach
贝德尔 | 比德尔 | bedell
杜普卡克 | 杜普恰克 | dupcak
布拉登 | 布拉顿 | bradon
贝姆 | 巴姆 | bame
莱西 | 利西 | leisy
普利马尔 | 普莱梅尔 | plymale
布罗梅特 | 布罗米特 | bromet
皮科威亚克 | 皮乔维亚克 | piechowiak
埃米西翁 | 埃米申 | emission
阿恰巴尔 | 阿查巴尔 | archabal
惠特伯格 | 惠特伯勒 | whitburgh
霍莫尔卡 | 霍穆尔卡 | homolka
海斯伯格 | 海斯堡 | heisborg
费尔德布里尔 | 费德布里尔 | feldbrill
杰农 | 热农 | gernon
斯顿特 | 斯坦特 | stunt
埃利斯 | 埃莉丝 | elyse
克勒勒 | 克雷勒 | kroehler
谢米宁 | 切米宁特 | cheminint
克丽扎 | 克里扎 | kryza
沃林 | 瓦林 | wahlin
布根 | 巴根 | bugan
施瓦姆 | 施万布 | schwamb
奥里 | 奥赖 | ory
艾尔弗里克 | 阿尔弗里克 | aelfric
艾尔加 | 艾尔格 | eylgar
索内曼 | 索恩曼 | sonnemann
奥赞娜 | 奥赞 | ozanne
德汉 | 德哈恩 | dehaan
雷诺 | 雷纳 | raynor
松塔格 | 桑塔格 | sontag
麦克尔赫农 | 麦克尔哈农 | mcelhanon
塔利奥 | 图利奥 | tullio
伦威尔 | 勒威尔 | lerwill
麦康 | 梅肯 | macon
戴维 | 达维 | davee
戈希 | 戈伊 | gohey
克莱弗 | 克拉弗 | claver
莱亚尔 | 莱尔 | lyal
桑萨姆 | 桑森 | sansum
吉吉 | 吉盖 | giggey
达科姆 | 戴科姆 | dacombe
邦廷 | 邦坦 | bontein
多本 | 多宾 | doben
阿尔芬 | 阿夫肯 | arfken
泰恩什 | 坦什 | tainsh
克雷斯皮尼 | 克雷皮尼 | crespigny
赫梅尔辛 | 休梅尔辛 | humelsine
马夸里 | 麦夸里 | maquarie
比尔基 | 伯基 | buerki
巴贝尔 | 贝布尔 | babell
克拉丽达 | 克拉里达 | clarida
博德温 | 博德瓦恩 | bordwine
布朗塔斯 | 布龙塔斯 | brountas
梅耶森 | 迈耶森 | mayerson
德雷沃尔加拉 | 德沃尔吉拉 | drevorguilla
奥弗拉海蒂 | 奥弗莱厄蒂 | o'flahertie
塞维 | 西维 | sevey
鲍沃 | 鲍尔 | bouwer
博克尔 | 博克 | boker
埃休 | 埃舒 | eshoo
佩雷兹 | 佩雷斯 | perez
维佐 | 维佐尔 | vizor
蒂利 | 蒂莉 | tillie
赖格 | 里格 | riger
道德 | 多德 | dowd
阿利森 | 艾莉森 | alyson
德雷塞尔 | 德雷斯尔 | dressel
朱利 | 朱莉 | julie
希克 | 舍克 | shirk
马休兰 | 马胡兰 | mahuran
派耶 | 派尔 | peyer
波兰 | 普兰 | poulain
西尔瓦纳斯 | 西尔维纳斯 | silvanus
埃克斯坦斯 | 埃克斯滕斯 | exstance
艾恩斯 | 安斯 | aines
普萨特里 | 普萨泰里 | pusateri
尼亨 | 奈恩 | nyhen
霍拉修斯 | 霍雷修斯 | horatius
克利瑟 | 克莱瑟 | cleather
罗巴蒂斯 | 罗巴茨 | robartes
阿格内洛 | 阿涅洛 | agnello
格拉齐亚多 | 格拉齐亚迪奥 | graziadio
伊莱 | 艾莱 | ilay
内蒂厄 | 纳休 | nathiew
休达克 | 赫达克 | hudak
麦凯尔弗里什 | 麦克尔弗里什 | macelfrish
斯蒂格利茨 | 施蒂格利茨 | stiglitz
塞西利厄斯 | 塞西莉厄斯 | cecilius
纳登 | 内登 | naden
哈姆斯 | 黑姆斯 | hammes
查格尔斯 | 查格利斯 | chagles
甘纳吉安 | 加南吉扬 | ganangiyan
古拉德 | 戈拉德 | goulard
考沃特 | 科沃特 | cowart
布里斯 | 布赖斯 | brise
惠塞特 | 惠特西特 | whitsett
赫德克 | 赫德基 | hedke
布雷纳安 | 布雷斯纳汉 | bresnahan
波 | 鲍 | pow
拉克歇尔 | 拉克斯尔 | wraxhall
曼柳斯 | 曼利厄斯 | manlius
莱托克 | 勒托克 | letocq
内格尔 | 尼格尔 | negel
乔弗里翁 | 乔夫里翁 | joffrion
伯恩 | 贝尼 | boehne
德沃拉克 | 德沃夏克 | dvorak
塔吉 | 塔姬 | taggy
麦科克 | 麦科奇 | mccoch
巴克纳 | 巴赫纳 | bachner
塔德霍 | 塔杜 | tudhoe
蒂格雷特 | 泰格雷特 | tigrett
埃金 | 伊金 | eking
托莱斯特拉普 | 托尔斯特拉普 | tollestrup
纳蒂 | 克努蒂 | knutti
凯嫩 | 凯南 | kainen
德普特克 | 德普塔克 | deptuck
格尔 | 吉尔 | gehl
迪斯特伯格 | 杜斯特伯格 | duesterberg
利德福 | 利德福德 | lydford
希彻尔 | 希切尔 | hitchell
拜尔克 | 贝尔克 | beilke
菲恩 | 费恩 | feane
科奈因 | 科奈恩 | conein
巴尔诺 | 巴诺 | barno
格雷博 | 格里博 | grebow
弗里斯 | 弗雷斯 | frece
朗莱因 | 朗莱恩 | longhlein
卡马科 | 卡马乔 | camacho
埃尔斯 | 埃利斯 | elles
德斯巴拉茨 | 德巴拉茨 | desbarats
沃拉克 | 沃勒克 | wallack
卡尼尼 | 卡奈尔尼 | carnearney
坦嫩鲍姆 | 特南鲍姆 | tennenbaum
霍奇根 | 霍根 | hodgan
卡基亚 | 卡夏 | cachia
莫尔桑 | 莫桑 | morsan
阿杰里斯 | 阿吉里斯 | argeris
明内特 | 明妮特 | minnette
斯坦卡德 | 斯顿卡德 | stunkard
里哈尔 | 雷哈尔 | rehal
安斯帕克 | 安斯帕赫尔 | anspacher
贾西诺夫斯基 | 贾西诺斯基 | jasinowski
克雷弗 | 克里弗 | crever
沃尔索夫 | 瓦尔塞奥夫 | waltheof
拉帕诺 | 拉普阿诺 | rapuano
托比特 | 托贝特 | torbett
泰雷尔 | 蒂雷尔 | tyrell
安德雷斯 | 安德烈斯 | andress
埃尔斯皮 | 伊丽莎白 | elspie
卡特林沙克 | 卡特林萨克 | katrinsak
托普尔 | 托佩尔 | topple
塞姆斯 | 泰晤士 | thames
斯维克 | 斯韦克 | svec
斯坦布罗 | 斯坦伯勒 | stanbrough
肯奈尔德 | 肯奈德 | kennaird
莱克拉斯 | 勒克拉 | lecras
斯普雷尔 | 斯普雷耶 | spreyer
艾克纳 | 艾希纳 | eichner
费拉罗 | 费劳 | ferrao
奥弗拉赫蒂 | 奥弗莱厄蒂 | o'flaherty
克里恩 | 克林 | crean
萨马罗 | 萨马鲁 | samaroo
皮克 | 珀基 | pyrke
恩布林 | 恩布琳 | emblin
鲍根 | 鲍恩 | baughan
吉尔德豪姆 | 吉尔多姆 | guildhaume
埃夫尤 | 埃维尤 | evjue
法纽伊尔 | 法纳尔 | faneuil
雷塔 | 里塔 | rheta
伯尼特 | 伯内特 | burnett
里查特 | 理查特 | richart
朗尼格 | 朗内加 | runnegar
夸尔 | 奎尔 | quayle
麦克莱恩 | 麦克林 | mcclean
扬格尔 | 扬格 | younger
多尔杰 | 德尔格 | dolger
赫贝斯特里特 | 赫布斯特雷特 | herbestreit
赫尔斯滕 | 赫尔斯特恩 | hellstern
克拉姆 | 克鲁姆 | krumm
普尔斯顿 | 普利斯顿 | puleston
埃杰曼 | 埃格曼 | egerman
迪林 | 迪尔林 | deerlin
埃尔韦斯 | 埃尔威斯 | elwes
塔弗 | 塔沃尔 | tavor
韦赫 | 韦伊尔 | weiher
韦特 | 维特尔 | vetter
赫米恩 | 赫米奥娜 | hermione
斯维尔 | 斯维沃 | svewar
约翰森 | 约翰逊 | johnson
杭德里奇 | 杭德里克 | honderich
利伯坦 | 利伯蒂娜 | libertine
达利佩齐 | 达莱佩泽 | dallepezze
梅尔斯特拉普 | 迈尔斯特勒普 | meilstrup
朗斯莱特斯 | 朗斯利特斯 | launceletus
埃德利 | 埃德尔 | ederle
科莫尼亚克 | 科莫尼亚雷克 | komoniarek
格恩斯巴克 | 根斯巴克 | gernsback
马茨卢夫 | 马兹卢夫 | marzluf
比尔 | 伯尔 | birr
邓坎森 | 邓肯森 | duncanson
高迪安 | 高迪恩 | gaudian
迪尔 | 代尔 | diel
菲茨瓦伦 | 菲茨沃伦 | fitzwarren
迪思里奇 | 迪特里希 | diethrich
马斯凯坦 | 马斯卡廷 | muscatine
唐蒂 | 当齐 | dauntsey
沃索 | 瓦索 | wasow
列昂铁耶夫 | 列昂季耶夫 | leontiev
贾尔迪 | 吉亚尔迪 | ghiardi
阿勒姆 | 奥勒姆 | allam
博迪科姆 | 博迪库姆 | bodycombe
施韦尔布 | 施韦布 | schwelb
伊泽诺 | 艾泽努尔 | izenour
特雷里斯 | 特里赖斯 | trerise
帕尼特 | 帕内特 | panet
罗恩 | 龙尼 | ronne
平肖特 | 平肖 | pinchot
范热 | 范格特 | fanget
伊尔格 | 伊尔克 | ilg
查森 | 蔡森 | chasen
埃斯波索蒂 | 埃斯波西托 | esposito
科佩拉 | 科皮拉 | coppela
茹拉布基安 | 朱拉布奇安 | joorabchian
斯拉特里 | 斯莱特里 | slattery
埃尔马思 | 厄马思 | earmarth
希拉克 | 希莱克 | shillaker
梅约 | 梅奥 | mayo
安泰维尔 | 安特维尔 | antevil
里辛 | 赖辛 | rising
杜纳文特 | 杜纳万特 | dunavant
库珀斯 | 凯珀斯 | kuipers
梅因多尔德 | 梅因唐纳德 | maindonald
麦卡勒里 | 麦卡利里 | mcalery
黑兹尔廷 | 黑兹尔坦 | hazeltine
斯拉茨 | 斯卢茨 | slutz
迈希尔 | 迈伊尔 | mighill
赫曼 | 希曼 | heman
布罗瑟 | 布拉泽 | brother
辛尼 | 锡恩 | thynne
弗里斯 | 弗里亚斯 | freas
皮尼 | 派尼 | piney
布里安 | 布赖恩 | brian
勒滕德尔 | 勒滕德 | letendre
杰斯 | 杰西 | jesse
格温福 | 格温弗 | gwynfor
莱韦斯库 | 莱韦斯克 | levesque
奥德里 | 奥德丽 | audrey
约瓦诺维奇 | 约万诺维奇 | yovanovitch
皮伊什 | 皮尤什 | piyush
丹尼罗 | 达尼罗 | daniero
英奇金 | 英奇昆 | inchiquin
勒彭内克 | 勒佩内克 | lepennec
津巴尔多 | 津巴多 | zimbardo
多嫩菲尔德 | 多宁费尔德 | donenfeld
沃尔德雷普 | 沃尔德里普 | waldrep
德马西奥 | 德马肖 | demascio
穆科夫斯基 | 穆科斯基 | mukowski
泽凯拉 | 泽克拉 | zechella
卡莉 | 凯莉 | kallie
斯凯特 | 斯卡特 | skate
麦吉尔弗 | 麦吉尔伍尔 | macgillvoor
布古尔德 | 布古尔 | bougourd
塞文 | 西文 | sevin
欣 | 希恩 | shinn
庞纳佩拉马 | 庞南佩鲁马 | ponnamperuma
米曾 | 迈曾 | mizen
洛梅尔 | 隆梅尔 | lommel
格林娜 | 格林 | glynne
马赫 | 马奇 | much
甘尼弗 | 珍妮弗 | gennifer
查萨涅斯 | 沙萨涅 | chassagnes
艾托 | 阿尤托 | aiuto
鲍格罗德 | 鲍赫鲁德 | boughrood
吉隆 | 吉伦 | gillon
基尔里 | 基里 | kearey
瓦克 | 瓦克尔 | wacker
洛易 | 路易祖 | louizou
弗兰兹 | 弗朗兹 | franz
米泽尔 | 米泽勒 | mizelle
托雷斯 | 托里斯 | torres
沃尔本 | 沃莱本 | wohlleben
普尔茨格拉夫 | 法尔茨格拉夫 | pfaltzgraff
马丽恩 | 马里恩 | maryon
华申科 | 瓦申科 | washenko
博尼特 | 博内特 | bonett
伊利特 | 艾利特 | ilett
马库斯 | 马库塞 | marcuse
伊明格 | 艾尔明格 | irminger
阿伦 | 艾伦 | allen
布贾克 | 布亚克 | bujake
约塔姆 | 乔撒姆 | jotham
温切尔塞 | 温切尔西 | winchelsea
古卡斯 | 古奥卡斯 | guokas
科萨塔 | 科苏塔 | cossutta
迪特 | 迪泰特 | dittert
费滕 | 法滕 | phaten
杜尔菲 | 德菲 | durfee
克里维利 | 克里韦利 | crivelli
邦特林 | 邦特兰 | buntline
菲茨凯因 | 菲茨艾尔温 | fitzailwyn
埃迪生 | 埃迪森 | eddison
希金博瑟姆 | 希金博特姆 | higinbotham
登宁 | 丹宁 | denning
比柳 | 比利厄 | bilyeu
马杰 | 马季 | marj
布加斯 | 巴加斯 | bugas
凯 | 基 | key
林德斯滕 | 林斯滕 | lindsten
本内特 | 贝内特 | bennete
贝罗尔 | 伯罗尔 | berall
图里基恩 | 图雷基安 | turekian
凯特伦 | 卡特伦 | catron
斯威特基 | 斯威凯 | switkay
多本斯特克 | 多本斯佩克 | daubenspeck
兹巴斯基 | 兹巴尔斯基 | zbarskiy
贝勒 | 贝尔 | beighle
梅奥 | 梅约 | maio
麦卡利基西 | 麦卡利克西 | mcaliksey
思利尔 | 特威利尔 | thuillier
弗里达 | 弗雷达 | freda
科德 | 科尔德 | coard
德加拉布里安 | 德加拉贝迪安 | dergarabedian
戈特杰卢 | 戈特格特鲁 | gottgetereu
诺萨顿 | 诺桑普顿 | northampton
布罗厄斯 | 布罗斯 | broas
妮迪 | 内迪 | neddie
赫伦布兰德 | 海伦布兰德 | hellenbrand
埃布 | 厄尔布 | erb
格瓦特金 | 格沃特金 | gwatkin
鲍尔丹齐 | 巴尔丹齐 | baldanzi
茜茜 | 锡西 | cissie
莱兰 | 利兰 | lelland
弗雷德丽卡 | 弗雷德里卡 | fredrica
温泽尔 | 温策尔 | wenzel
杜格 | 杜奇 | dooge
巴蒙特 | 贝蒙特 | bamont
奥德哈泽 | 奥尔迪泽 | aldhizer
卡洛格罗 | 卡洛杰罗 | calogero
姆利纳希克 | 姆利纳奇克 | mlinarchik
道兹韦尔 | 多德斯韦尔 | dowdeswell
米齐 | 梅齐 | meazey
尤特 | 尤思 | uthe
格鲁肖 | 格劳乔 | groucho
纳特尔 | 纳托尔 | nuttall
戴伦富思 | 迪伦弗思 | dhyrenfurth
扬克威奇 | 扬克维奇 | yankwich
萨格曼 | 塞奇曼 | sageman
库达希 | 卡达希 | cudahy
克尔奇维尔 | 克切维尔 | kercheville
施韦德 | 施韦蒂德 | schwetid
德西里 | 德西蕾 | desiree
基利 | 丘利 | kewley
德波米尔 | 德波米耶 | depommier
比恩 | 拜昂 | bion
加哈根 | 加黑根 | gahagen
麦金图夫 | 麦金塔夫 | mcinturff
莫苏德 | 莫维兹 | morfudd
桑克利 | 尚克利 | sankley
罗梅因 | 罗曼 | romaine
萨马拉 | 赛马拉 | saemala
怀斯坦 | 威斯坦 | wystan
博德温 | 鲍德温 | bodwine
勒斯 | 卢斯 | luss
欧斯 | 奥恩斯 | owns
鲍科姆 | 鲍库姆 | bawcombe
莱瑟夫 | 勒瑟夫 | lesurf
查伦格 | 查林杰 | challenger
塞特 | 撒特 | thaete
约基尔森 | 约克尔森 | yochelson
赛赫 | 西赫 | sih
阿博戈斯特 | 阿博加斯特 | arbogast
弗朗西娅 | 弗朗西亚 | francia
亨特雷斯 | 亨特里斯 | huntress
图苏森 | 蒂乌萨宁 | tiusanen
特里布 | 特赖布 | tribe
米尔德万 | 米尔德文 | mildvan
金凯尔尼 | 金凯尼 | kincairney
阿尼尼 | 阿内尼 | aneny
马斯曼 | 穆斯曼 | mussman
克龙 | 克罗姆 | cromb
蒙塔文 | 蒙塔冯 | montavon
萨奇 | 萨特杰 | satge
杰伦 | 吉伦 | gearon
贾尼斯 | 贾尼西 | janisse
迪西 | 达西 | duthie
加汉 | 加恩 | gahan
德拉波 | 德拉珀 | drapeau
霍奇格特 | 霍贾特 | hodgart
桑比 | 桑德比 | saundby
德博伊斯 | 德布瓦 | desbois
斯韦布 | 斯韦比 | swaebe
格拉巴尔 | 格拉巴 | grabar
弗鲁伊特 | 弗鲁特 | fruit
伊利恩 | 伊尔伦 | illearn
阿布洛姆 | 阿布隆 | ablom
博尔加塔 | 博加塔 | borgatta
埃斯梅尔 | 伊斯梅尔 | esmail
沃滕伯格 | 瓦滕伯格 | wattenberg
瓦利克 | 瓦莱克 | valek
阿迪内特 | 阿迪尼特 | adinet
吉尔克雷斯特 | 吉尔克里斯特 | gilchrest
迪克 | 迪克尔 | dicker
彼特金 | 彼得金 | peterkin
霍耶贝莱克 | 胡尔贝克 | houiellebecq
布希 | 布舍 | busche
卡梅尔福德 | 卡姆尔福德 | camelford
勒金比尔 | 卢金比尔 | lukingbeal
布吕恩 | 布鲁恩 | bruene
拜伊 | 布伊 | buie
埃斯特黑 | 埃斯特海 | esterhai
马尔欣 | 马尔夏恩 | mulshine
埃莱克拉 | 伊莱克特拉 | electra
查费茨 | 查菲茨 | chafetz
瑟米厄斯 | 瑟缪斯 | sermeus
安杰尔斯 | 安杰利斯 | angeles
艾肯 | 伊坎 | icahn
勒伊尔 | 鲁埃尔 | reuel
苏恩 | 图恩 | thun
泰瑟 | 特瑟 | tether
克利安德 | 克林德 | cleander
海森 | 希森 | hyson
沃姆索尔 | 沃姆泽 | wormsor
吉诺尔 | 格瑙尔 | genauer
克莱夫 | 克拉夫 | clave
蒙东纳 | 蒙顿纳 | montonna
卡莎 | 卡沙 | kasha
利多姆 | 利德姆 | leedom
马拉布尔 | 梅拉伯 | malabre
苏里纳 | 苏雷纳 | surena
利希特沃特 | 利希特瓦尔特 | lichtwardt
加恩斯 | 加农斯 | garnons
奥弗罗尔 | 奥费拉尔 | o'ferrall
马琴 | 梅琴 | machen
希登 | 黑登 | headon
塔谢罗 | 塔什罗 | taschereau
埃廷杰 | 埃廷格 | ettinger
福尔维 | 法尔维 | falvey
查蓬 | 沙蓬 | chapone
林迪 | 琳迪 | lynndie
多诺夫莫尔 | 多诺莫尔 | donoughmore
奇德尔 | 切德尔 | chedell
甘博阿 | 甘博亚 | gamboa
康伯 | 库默 | comber
赫施 | 胡希 | husch
阿克利 | 埃克利 | akeley
尤泽 | 尤伊泽 | ueyser
奥拉 | 奥尔拉 | orla
西拉 | 赛拉 | thyra
卡丹 | 卡登 | kadane
金格莱克 | 金莱克 | kinglake
阿弗伯里 | 埃夫伯里 | avebury
比拉洛博斯 | 比利亚洛沃斯 | villalobos
迪达姆 | 迪德姆 | deedham
纳尔 | 诺尔 | nall
古特沃思 | 格特沃思 | gutwirth
杜克迈尼尔 | 杜克米尼尔 | dukeminier
阿布雷 | 阿布里 | abrey
格维茨 | 格威茨 | gurwitz
德梅特 | 德梅特尔 | demaitre
贝尔里 | 比尔里 | beary
塞格温 | 塞金 | seguin
达姆勒 | 杜姆勒 | dumler
海因菲尔德 | 汉费尔德 | hainfeld
沃拉 | 瓦拉 | walla
埃德尔德姆 | 埃尔德姆 | ealdhelm
斯塔内克 | 斯托尔内克 | stalnecker
马杰里 | 马格丽 | margery
贝尔沃尔德 | 贝瓦尔德 | baerwald
盖伊 | 贾伊 | ghey
赖姆斯 | 里姆斯 | rheims
布鲁斯 | 布劳斯 | brous
普拉格 | 普拉奇 | plugge
基乔 | 凯乔 | kejoa
博斯顿 | 波士顿 | boston
费克图特基 | 费克特库蒂 | feketekuty
赫芬 | 赫法恩 | huffine
瑟希 | 塞希 | sershey
埃诺 | 伊诺 | eno
塞利格曼 | 塞利希曼 | seligmann
廷吉 | 廷盖 | tingay
加韦德 | 加维德 | gaved
斯特雷姆劳 | 斯特里姆劳 | stremlau
佩洛贝特 | 佩卢贝特 | peloubet
拜尔 | 贝耶尔 | beier
瑟瓦克 | 瑟瓦奇 | serwach
阿菲 | 埃菲 | afee
西德博特姆 | 赛德博特姆 | sidebotham
格德 | 格尔德 | gerd
埃克洛夫 | 埃克勒夫 | eklof
博格哈特 | 博格蒂尔 | boghatyr
芬格勒 | 芬勒 | fengler
伊奥因 | 约恩 | eoin
索 | 托 | thau
图里曼 | 图尔曼 | tureman
茹伊特 | 朱厄特 | jouett
班顿 | 贝恩顿 | baynton
约克威廉斯 | 约克威廉 | yorkwilliams
弗拉利克 | 弗雷利克 | fralick
塞尔娜 | 塞尔纳 | serna
伦宁 | 伦南 | lennen
罗格特 | 罗热 | roget
弗雷伊 | 弗雷 | frej
阿伯恩 | 阿本 | abern
伊登 | 艾登 | idden
希格内特 | 希格尼特 | hignett
沙夫特伯里 | 沙夫茨伯里 | shaftesbury
杜庞 | 杜邦 | dupont
克利姆克 | 克利姆基 | klimcke
赫尔布尔 | 赫布尔 | helble
比尔布鲁 | 比尔伯勒 | bilbrough
伦弗罗 | 伦德弗罗 | rendfrow
昂布赖特 | 昂布里特 | umbreit
布劳恩 | 布朗 | browne
凯加 | 凯加鲁 | caegarw
赫沃斯 | 休沃斯 | huvos
莱热 | 利热 | leasure
萨姆斯特格 | 扎姆斯塔格 | samstag
麦克纳尔 | 麦克诺尔 | mcnaugher
贾格斯 | 贾格尔斯 | jaggers
格伦巴克 | 格伦巴赫 | grumbach
凯斯 | 基斯 | keys
萨基纳 | 萨金娜 | sakinah
勒福恩 | 勒方 | lefaune
拉夫雄 | 拉夫肖恩 | rafshoon
贝曼 | 比曼 | beman
西弗特 | 索伊弗特 | seufert
斯特里文斯 | 斯特雷文斯 | strevens
斯坦纳姆 | 斯塔纳姆 | stanham
阿克西翁 | 埃克申 | action
马因沙因 | 梅恩沙因 | maienschein
齐梅尔曼 | 齐梅曼 | zimmeman
桑兹 | 桑德斯 | sondes
法奇 | 富奇 | fudge
穆普森 | 马普森 | mupson
埃尔 | 埃尔勒 | ehrle
勒克赫斯特 | 卢克赫斯特 | luckhurst
卡罗尔 | 卡萝尔 | carole
埃丁杰 | 埃丁格 | edinger
德维尔 | 德韦尔 | deveulle
麦高兰 | 麦戈兰 | mcgauran
登帕赛 | 登帕西 | dempasay
巴尔达扎 | 巴尔丹扎 | baldanza
马格尼 | 马格内 | magnay
法尔肯布里奇 | 福尔肯布里奇 | falconbridge
格林斯特德 | 格林斯蒂德 | grinstead
莱因德斯 | 莱因德尼斯 | rhindness
克纳夫 | 纳夫 | knaff
米多斯 | 梅多斯 | meadows
帕德西 | 帕齐 | pudsey
罗尔夫斯 | 罗卢夫斯 | rolufs
塞尔诺维奇 | 切尔诺维奇 | cernovitch
奈斯利 | 尼斯利 | knisely
莱加特 | 莱格特 | legatt
尼古莱迪斯 | 尼古拉迪斯 | nikolaidis
贝特拉 | 伯特拉 | bertera
戈利特利 | 戈莱特利 | golightly
本廷 | 本辛 | benthin
芒尼克森 | 芒尼克海森 | munnikhuysen
奇尔德 | 蔡尔德 | child
朱尔科威茨 | 尤尔科维茨 | jurkowitz
鲁宾斯坦 | 鲁本斯坦 | rubenstein
休伊 | 舍韦 | schewe
麦昆金 | 麦克琼金 | mcjunkin
吉格雷 | 吉格尔 | giguere
麦克法迪安 | 麦克法迪恩 | mcfadyean
卢尼德 | 莉内德 | luned
乔莫 | 肖莫 | chomeau
科克兰 | 科克伦 | cochrane
莫尔霍尔特 | 莫霍尔特 | molholt
阿加西亚 | 阿加西娅 | agacia
梅佩尔 | 马佩尔 | mapel
西克斯 | 赛克斯 | sikes
奥瑟顿 | 奥尔瑟顿 | altherton
布兰特里 | 布伦特里 | braintree
钱伯尔辛 | 钱伯辛 | chamberlsin
格青格 | 格青杰 | getsinger
艾韦特 | 艾尔薇特 | irvette
艾舍伍德 | 伊舍伍德 | isherwood
德尼奥 | 迪奈欧 | denio
基尔 | 基利 | kille
奥思尼尔 | 奥塞内尔 | othenel
坦迪恩 | 坦丁 | tandien
马尼奥利亚 | 马格诺利娅 | magnolia
埃莱斯米尔 | 埃尔斯米尔 | ellesmere
戴西 | 黛西 | daisy
沃塞姆 | 沃特海姆 | wertheim
蒙泰罗 | 蒙蒂罗 | monteiro
克里斯特高 | 克里斯戈 | christgau
奥科因 | 奥库安 | aucoin
彼特罗 | 佩特罗 | petro
亨萨克 | 亨塞克 | hunsaker
诺库伊 | 诺基 | norquoy
马凯姆 | 梅卡姆 | makeham
拉尼恩 | 鲁尼恩 | runyon
斯特拉布里奇 | 斯特劳布里奇 | strawbridge
希肯洛弗 | 希肯卢珀 | hickenlooper
巴尔塔瑟 | 巴尔塔泽 | baltassar
杜克 | 杜凯 | duque
海尔凯 | 海尔基 | heilkay
弗利金格 | 弗利金杰 | flickinger
泽比纳 | 泽拜纳 | zebina
麦卡尼尼 | 麦卡内尼 | mcaneney
布拉夫 | 布劳 | blough
格拉斯戈 | 格拉斯哥 | glasgow
赫钦格 | 赫金杰 | hechinger
哈尼迪 | 哈内迪 | harnedy
斯梅杰 | 斯梅奇 | smaje
布伦金普普 | 布伦金索普 | blenkinsop
奥利文特 | 奥利万特 | ollivant
戈洛文科 | 戈洛夫琴科 | golovchenko
麦克莱莫尔 | 麦克勒莫尔 | mclemore
德布勒勒 | 德布鲁勒 | debruler
麦克费德兰 | 麦克费德伦 | macphedran
奥迪吉尔 | 奥迪吉耶 | audigier
赫蒙 | 哈蒙 | hummon
伯特胡德 | 伯绍德 | berthoud
阿尔卡尔德 | 阿尔卡德 | alcalde
帕克特 | 帕赫特 | pachter
比奥利 | 比利 | beoley
戴恩 | 丁 | din
比塔 | 比塔尔 | bitar
耶登 | 伊登 | yeadon
达尔维奇 | 达利奇 | dulwich
格罗斯蒂斯特 | 格罗斯泰特 | grosseteste
施蒂布林 | 斯蒂贝林 | stiebeling
洛克希尔 | 洛希尔 | lochiel
弗雷尔 | 弗雷耶 | freyere
斯康菲尔德 | 舍恩菲尔德 | schonfield
斯托尔普曼 | 施托尔普曼 | stolpman
弗兰普廷 | 弗兰普申 | framption
博雷特 | 博里特 | borrett
迈克尔约翰 | 米克尔约翰 | meiklejohn
菲彻姆 | 费克姆 | feachem
拉卡帕涅 | 拉康帕涅 | lacampagne
索瓦奇 | 索瓦热 | sauvage
赫曼 | 赫尔曼 | herman
科帕德 | 科珀德 | coppard
埃尔齐 | 埃尔扎伊 | elzay
巴思 | 巴特 | barthe
埃斯科菲 | 伊斯科菲 | escoffey
吉勒姆 | 吉列姆 | gilliam
皮尔 | 皮埃尔 | pierre
博施威茨 | 博希威茨 | boschwitz
哈德格雷 | 哈迪格里 | hardegree
皮尔 | 珀尔 | pearl
维拉雷尔 | 维拉里尔 | villarreal
伊格列维奇 | 伊格尔维奇 | iglewicz
洛西安 | 洛西恩 | lowthian
多姆詹 | 多米扬 | domjan
阿巴斯蒂尼娅 | 阿巴斯蒂尼亚 | abastenia
阿利斯 | 阿莱斯 | allies
海泽 | 哈伊泽 | huyser
卡拉佩蒂安 | 卡拉佩琴 | carapetyan
布里宁 | 布赖宁 | bryning
格利多尔 | 格利德尔 | gleadall
麦凯恩 | 麦克钦 | mccheane
克拉布里特 | 克拉布特里 | crabtree
特洛 | 特略 | tello
纽伯勒 | 纽伯格 | newburgh
托尔梅奇 | 塔尔梅奇 | tallmadge
威克斯蒂德 | 威克斯第德 | wicksteed
维斯科尔斯基 | 维斯克洛斯基 | visclosky
斯科格伦 | 斯科格隆 | skoglund
海尔兹 | 希尔兹 | hilds
温塔尔 | 温特尔 | weintal
贾夫 | 贾菲 | jaffe
斯塔姆 | 施塔姆 | stamm
法扎 | 法扎尔 | fazar
多恩 | 杜恩 | doune
马塞尔 | 玛塞勒 | marcelle
尤因斯 | 尤温斯 | uwins
切谢尔斯基 | 切赫尔斯基 | cehelsky
托勒马什 | 托尔马什 | tollemache
尤利维奇 | 乌莱维奇 | ulevich
达尔斯特龙 | 达尔斯特伦 | dahlstrom
德黑斯 | 德海斯 | dehayes
马顿 | 梅顿 | maton
希拉 | 夏伊拉 | shyla
法尔肯海姆 | 福尔肯海姆 | falkenheim
洛恩 | 洛温 | lowen
德弗勒 | 德夫勒 | doerfler
贝默赛德 | 比默赛德 | bemersyde
米姆诺 | 明诺 | mimno
罗明 | 罗梅因 | romeyn
扬古斯本德 | 扬哈斯本 | younghusband
夏皮 | 沙比 | sharpey
莱萨奇 | 勒萨热 | lesage
杰普萨 | 杰普撒 | jeptha
巴布利斯 | 布勃利斯 | bublys
伯特霍尔夫 | 伯索夫 | bertholf
西迪亚 | 切迪亚 | ceddia
舒特利夫 | 舒特莱夫 | shurtleff
斯波特德 | 斯波蒂德 | spotted
乔齐 | 乔茜 | jozy
利伯恩 | 莱伯恩 | laybourne
迪安 | 戴安 | dian
马霍恩 | 马洪 | mahone
考尔特 | 库尔特 | coult
劳克胡夫 | 劳卡夫 | laukhuff
米尔希 | 米尔海 | milhy
卡德根 | 卡杜根 | cadwgan
博希尔 | 博舍尔 | boshier
斯克里伯 | 斯克赖伯 | scriber
博维 | 博韦 | bovee
赫克顿 | 赫克通 | hektoen
莱维 | 利瓦伊 | levi
查斯 | 蔡斯 | chayes
内撒内尔 | 纳撒内尔 | nathanael
克里 | 克雷 | crea
乔尔万 | 朱尔万 | joulwan
卡佐克拉 | 库佐克雷亚 | cuzzocrea
克拉茨 | 克卢茨 | clutz
阿德基森 | 阿基森 | adkisson
施莱 | 施利 | schlie
艾菲涅 | 伊菲吉妮 | iphigene
塞金格 | 塞金杰 | seckinger
泰菲恩 | 泰维恩 | teifion
亚历克西斯 | 亚历克西丝 | alexys
本贾明 | 本杰明 | benjamin
拉罗姆 | 拉勒姆 | larom
坎帕因 | 坎佩恩 | campaigne
古茨怀勒 | 古茨维勒 | gutzwiller
马奎斯 | 马克斯 | marques
斯特芬斯 | 斯蒂芬斯 | steffens
勒金 | 勒德金 | ludgin
阿尔皮娜 | 阿尔皮纳 | alpina
韦勒尔 | 沃雷尔 | werrell
福尔兹 | 福尔茨 | folz
德福德 | 德福特 | deford
齐尔尼科 | 齐尔尼基 | ziernicki
图尔 | 特尔 | tourle
图利特 | 塔利特 | tulett
斯塔克 | 斯图克 | stucke
尚伯格 | 舍恩伯格 | schonberger
兰贝利特 | 兰伯利特 | lambelet
吉 | 贾伊 | gye
利希特斯坦 | 利克滕斯坦 | liechtenstein
安德鲁斯基奇 | 安德鲁斯克维奇 | andruskevich
布金 | 布尔金 | bourgin
泰林厄姆 | 蒂林厄姆 | tyringham
比尤 | 布埃 | bue
阿维斯 | 阿维丝 | aveis
黑吉斯 | 海吉斯 | haigis
基珀 | 凯珀 | kuiper
阿伦 | 阿龙 | aaron
马尔克斯 | 马尔库斯 | malkus
齐恩 | 蔡恩 | zion
格尔巴克 | 盖尔博 | gelbach
卢夫特 | 勒夫特 | luft
布雷克兰 | 布里克兰 | brekland
布阿拉 | 布阿哈拉 | buachalla
沃尔克 | 沃克 | walke
考特尼 | 考特妮 | kourtney
基尔 | 屈尔 | kuehl
麦克雷迪 | 麦克拉迪 | mccrady
比利尔 | 比埃 | billiere
埃尔杰 | 埃尔格 | elger
曼恩 | 曼 | mann
普钦斯基 | 普辛斯基 | pucinski
佩金 | 帕金 | pagin
贾拉特 | 贾勒特 | jarratt
尼科莱 | 尼古拉 | nicolay
威尔茜 | 威尔西 | willsie
弗雷塔格 | 弗赖塔格 | freytag
撒尔肯 | 萨尔肯 | thalken
基米特 | 金米特 | kimmitt
赖津 | 里津 | ryzin
维迈耶 | 威迈耶 | wiemeyer
库德韦尔 | 库尔德韦尔 | couldwell
伯娜 | 伯纳 | berna
索利兹 | 索莱 | saulez
斯坦齐克 | 斯坦奇克 | stanczyk
布莱希登 | 布莱钦登 | blechynden
巴托尔缪 | 巴托洛缪 | bartholemeu
塔尼亚 | 塔妮娅 | tania
西克 | 瑟克 | cirker
恩德科特 | 恩迪科特 | endecott
阿尔文 | 阿尔温 | alwin
拉索姆 | 莱瑟姆 | lathom
豪伊塞尔 | 休塞尔 | heusel
莱弗勒 | 莱弗拉尔 | leflar
罗莎佩普 | 罗萨皮普 | rosapepe
赫宁伯格 | 赫宁堡 | heningburg
盖泽 | 盖瑟 | gaisser
巴萨德 | 巴萨德雷 | basadre
派约特 | 派奥特 | pyott
康纳尔 | 科纳尔 | conall
塞勒斯 | 塞拉斯 | sellars
梅卢普斯 | 梅拉普斯 | mellups
马拉赫 | 马拉克 | malach
德莱肖 | 德莱西奥 | delessio
鲍尔西格 | 巴尔西杰 | balsiger
希拉伯 | 希莱伯 | shillaber
斯特夫斯 | 斯特弗斯 | steffes
卡斯特伯里 | 卡斯尔伯里 | castelberry
吉尔鲍德 | 吉尔博 | guillebaud
贝切特 | 贝谢 | bechet
梅利奥 | 梅莉奥尔 | melior
拉马塞特 | 罗马塞特 | roumasset
克尔切弗 | 克切弗 | kerchever
比阿特丽沙 | 比阿特丽西娅 | beatricia
福法尔 | 福法 | forfar
梅努欣 | 梅纽因 | menuhin
凯格 | 基格 | keig
菲阿尔卡 | 菲亚尔卡 | fialka
赫米 | 赫姆斯 | hemmes
伊萨科 | 伊萨科夫 | isakow
兹沃 | 兹瓦尔 | zwar
克伦西克 | 赫伦奇克 | chrencik
尼莎 | 尼萨 | neysa
彭沃尔特 | 佩恩沃尔特 | pennwalt
库塞维茨基 | 科乌谢维茨基 | koussevitzky
米尼奥 | 米内奥 | mineo
布勒宁 | 布罗宁 | broening
伊尔特德 | 伊尔蒂德 | illtud
弗罗伊斯 | 弗勒泽 | froese
阿什利 | 阿什莉 | ashleigh
斯图扎 | 斯图尔扎 | stoorza
切内里 | 切纳里 | chenery
弗拉赫蒂 | 弗莱厄蒂 | flaherty
诺克斯 | 努克斯 | nokes
恰鲁奇 | 基亚鲁奇 | chiarucci
休尔默 | 瑟默 | thuermer
汉奇 | 汉格 | hange
舍戈尔斯 | 舍加尔斯 | shergals
安贝卡尔 | 安贝德卡 | ambedkar
杜克诺伊 | 迪克努瓦 | duquenoy
托里乔斯 | 托里霍斯 | torrijos
柯彻 | 基尔舍 | kircher
斯托尔曾巴赫 | 斯托曾巴赫 | stolzenbach
柯蒂斯 | 柯蒂兹 | curtiz
杰杰 | 杰格 | jeger
马德里德 | 马德里 | madrid
唐恩 | 唐 | donn
凯特尔比 | 基特尔比 | ketelbey
怀金特 | 威甘特 | wygant
博弗里 | 博韦里 | boverie
贝勒 | 贝利 | behle
阿莱格拉 | 阿利格拉 | allegra
阿姆肖维茨 | 阿姆谢维茨 | amshewitz
赖克沃特 | 里克沃特 | rykwert
奥法雷尔 | 奥法雷 | o'farrell
利宁 | 吕宁 | luening
特金 | 图尔金 | turkin
西里 | 蒂里 | thierry
乔西 | 约瑟 | josee
施赖伯 | 施里伯 | shriber
迈斯兰 | 迈斯拉恩 | meislahn
德拜尔 | 德比尔 | derbyl
森塞尼克 | 森塞尼奇 | sensenich
塞克肖尔 | 塞克索尔 | sexauer
高因 | 高英 | gowing
亨尼卡特 | 亨尼克特 | hunnicutt
本尼 | 贝恩 | benne
科斯 | 库斯 | coes
舍内曼 | 舍尼曼 | schoeneman
维尼斯 | 维内斯 | veness
穆斯 | 缪斯 | muse
哈威克斯克罗克 | 哈维克斯布罗克 | hawixbrock
古恩希利 | 贡希利 | goonhilly
霍尔蒂格纳格 | 霍尔蒂万格 | haltiwanger
哈里尔 | 哈丽尔 | harriel
塞塞尔 | 塞斯尔 | sessel
费尔马纳 | 费尔曼纳 | fairmaner
霍金森 | 霍奇金森 | hodgkinson
阿尔奇夫龙 | 阿尔西弗龙 | alciphron
达纳根 | 杜纳根 | dunagan
特雷西 | 特蕾西 | tracey
朱丘 | 吉奥克 | giauque
埃尼德 | 伊妮德 | enid
萨金特 | 瑟金特 | searjeant
拉金 | 莱金 | laging
尚伯格 | 舍恩伯格 | schonberg
米特塞夫 | 米采夫 | mitseff
范格 | 范杰 | fanger
杰什瓦 | 杰舒亚 | jeshua
布兰肯 | 布兰昌 | blanchan
霍尔迪曼德 | 哈尔迪曼德 | haldimand
吉列姆斯 | 吉利亚姆 | guilliams
多奇 | 道奇 | dodge
米莉娅 | 米利亚 | melia
斯威恩 | 斯温 | sween
弗赖赖希 | 弗赖雷克 | freireich
菲克 | 费克 | feake
戈米普拉塔 | 戈梅斯普拉塔 | gomezplata
布古伊斯 | 布儒瓦 | bourgeois
安东尼奥 | 安东尼乌 | antoniou
罗伊巴尔 | 罗伊鲍尔 | roybal
布什夫夫 | 布舒夫 | bushueff
萨吉特里厄斯 | 萨吉泰里厄斯 | sagittarius
比克 | 贝克 | beek
雷诺瓦德 | 伦瓦尔 | renouard
希拉斯 | 希勒斯 | heelas
卡尔德拉夫 | 考尔德克拉夫 | caldcleugh
克拉格 | 克莱格 | clague
贾西娜 | 杰西纳 | jacyna
切希尔 | 切斯希尔 | chesshyre
朗斯伯格 | 劳恩斯伯格 | lounsburg
布雷欣 | 布里金 | brechin
古德勒姆 | 古德哈姆 | gooderham
亚格 | 耶格尔 | yager
巴恩 | 鲍恩 | balne
赫普 | 霍伊普 | heup
博尔苏克 | 博苏克 | borsook
阿德查尼奇 | 阿德查尼克 | ardcharnich
贝迪利恩 | 贝迪利翁 | bedillion
里道特 | 赖德奥特 | rideout
麦考斯兰 | 麦考斯伦 | mcauslan
皮阿特罗斯 | 皮特罗斯 | peatross
布卢顿 | 布勒顿 | blurton
马蒂奥 | 马泰奥 | matteo
多罗西 | 多萝西 | dorothy
斯塔宾 | 斯图宾 | stubbing
奥尔弗森 | 阿尔弗森 | alverson
索洛特斯 | 索尔特斯 | solotesz
坎普斯弗勒 | 坎普施罗尔 | kampschror
布姆斯特德 | 巴姆斯特德 | bumstead
伦 | 莱恩 | len
德马特豪 | 德马尔托 | desmarteau
谢尔普 | 谢普 | shairp
格赖德 | 格雷德 | greider
伯泽尔 | 伯塞尔 | birdsell
索恩代克 | 桑代克 | thorndike
马沙姆 | 马香 | marsham
奥伯尔曼 | 奥伯黑尔曼 | oberhelman
帕特里亚克 | 佩特里亚克 | patriach
莱斯 | 莱什 | leisz
海内曼 | 海涅曼 | heinemann
里查兹 | 理查兹 | richards
艾奇森 | 艾奇逊 | eytchison
布里安特 | 布赖恩特 | briant
科尔法亚托 | 科菲亚托 | corfiato
丹罗思 | 丹罗伊特 | dannreuther
法斯尔 | 法塞尔 | fascell
巴恩比 | 巴恩贝 | barnebey
梅林达 | 梅琳达 | melinda
弗伦泽 | 弗伦策 | frenzer
康西尔 | 康斯尔 | council
沙因鲍姆 | 欣鲍姆 | sheinbaum
赞顿 | 桑顿 | szanton
戈尔德伯勒 | 戈德伯勒 | goldborough
沃拉尼厄斯 | 瓦拉尼厄斯 | waranius
赫马尼克 | 赫马纽克 | hermaniuk
埃尔万 | 埃尔温 | elwane
巴塔格尔 | 巴塔杰尔 | battagel
厄尔韦克 | 埃厄克 | earwaker
格林达尔 | 格林德尔 | grindal
科罗斯基尔 | 科罗西尔 | koroscil
塞弗林豪斯 | 塞夫林豪斯 | sevringhaus
贾科特 | 贾科泰 | jacottet
富乔洛 | 富奇洛 | fuccillo
布雷利 | 布里厄利 | brealey
麦科斯琴格 | 麦科尚奈格 | maco'shannaig
麦克廷格 | 马赫廷格 | machtinger
特里斯特勒姆 | 特里斯特雷姆 | tristrem
内内曼 | 南尼曼 | nenneman
康杰 | 康格 | conger
马米特 | 马梅特 | mamet
卡特尔 | 卡瑟尔 | cuthell
迪尤斯 | 德威斯 | dewees
桑达姆 | 桑德姆 | sandum
基茨哈伯 | 基察伯 | kitzhaber
布雷齐尔 | 布雷热 | brazier
斯米亚拉克 | 斯米亚利克 | smialek
芬尼 | 菲尼 | phinney
里维特 | 里韦特 | rivet
奥尔迪 | 阿尔迪 | alday
阿曼德斯 | 阿曼达斯 | amandus
赛纳 | 西纳尔 | synar
康科拉尔 | 康科勒 | concholar
德莱奥 | 德利奥 | deleo
斯库勒 | 朔伊勒 | scheuler
特鲁曼 | 杜鲁门 | truman
惠伦 | 惠兰 | whelan
拉思 | 雷思 | rathe
哈尔巴克 | 哈尔巴赫 | halbach
戈德温 | 戈尔德温 | goldwyn
鲁特 | 鲁尔特 | rurt
赫利 | 赫尔利 | hurleigh
克罗嫩贝格 | 克罗嫩伯格 | kronenberg
克里克顿 | 克赖顿 | crichton
格威内德 | 格威内思 | gwynedd
凯利 | 基利 | kealy
纳特尔 | 纳塔尔 | natal
鲍奇 | 布谢 | bouchey
鲍厄尔斯 | 鲍威尔斯 | powels
罗雷姆 | 罗勒姆 | rorem
沃蒂埃 | 沃捷 | vautier
安德里奥 | 安德里厄 | andrieux
阿莱恩 | 阿林 | alleine
贝克 | 贝克尔 | becker
怀索基 | 维索茨基 | wysocki
杰普普 | 杰瑟普 | jesup
埃里希 | 埃里格 | ehrig
扎奇曼 | 扎克曼 | zachmann
斯马尔皮斯 | 斯莫尔皮斯 | smallpeice
诺伦 | 诺伦德 | norlund
唐西娅 | 唐西亚 | donsia
达克罗 | 迪克罗 | ducrow
沃尔克 | 沃克 | walk
沃尔克 | 沃克 | walker
斯坦达洛夫特 | 斯坦德洛夫特 | standaloft
德沃查克 | 德沃夏克 | dvorchak
科赫伦 | 库格伦 | coughran
多克特 | 多克托 | docktor
法伦 | 法林 | filene
希尔茨 | 希尔兹 | shields
皮克普 | 皮卡普 | pickup
塞门扎 | 西门扎 | semenza
夏尼 | 夏恩 | cheyenne
彼得龙 | 佩特龙 | petrone
科克斯 | 考克斯 | coxe
格里桑蒂 | 格里桑迪 | grisanti
梅尔斯 | 马雷斯 | mares
阿奈林 | 阿内林 | aneirin
冈利 | 高恩利 | gownley
布兰肯巴克 | 布兰肯贝克 | blankenbaker
拉拉比 | 拉勒比 | larabee
埃斯卡达里安 | 伊斯坎达里安 | eskandarian
盖格 | 盖杰 | gager
特穆多 | 塞穆多 | themudo
科尔奎特 | 科尔基特 | colquitt
蒙莫尼耶 | 蒙莫尼尔 | monmonier
比蒙多 | 比顿多 | bitondo
贝松 | 贝森 | bessone
撒勒 | 塞勒 | thaler
塞科夫斯基 | 赛科夫斯基 | saikowski
塞格雷夫 | 西格雷夫 | segrave
休尔代尔 | 舍代尔 | suirdale
凯夫纳 | 卡夫纳 | cavenagh
哈莫尔 | 哈默 | hamor
博索思沃思 | 博索姆沃思 | bosomworth
普普 | 普珀 | puppe
施米德 | 施密德 | schmid
塔姆格尔 | 塔穆格尔 | tarmugl
黑尔 | 海尔 | haire
哈克威尔 | 黑克威尔 | hakewill
冈扎莱斯 | 冈萨雷斯 | gonzalez
莫纳 | 莫娜 | mona
格兰尼 | 格兰妮 | grainne
兹韦林 | 兹沃德林 | zwerdling
特鲁赫特 | 特鲁哈特 | trueheart
麦克斯特奥文 | 麦克斯蒂奥芬 | macstiofain
亚里莫维奇 | 雅里莫维奇 | yarymovych
登尼斯顿 | 丹尼斯顿 | denniston
塞尼奥尔 | 西尼尔 | senior
哈特赛德 | 哈齐德 | hartsid
博伊斯拉贡 | 博勒根 | boisragon
里伯特 | 雷巴特 | rebut
梅特罗利斯 | 梅特罗波利斯 | metropolis
索热 | 索热尔 | saussure
费里比 | 费尔比 | ferebee
科克森 | 考克森 | coxon
斯克鲁塔托 | 斯克鲁泰特 | scrutator
格里泽 | 格赖泽 | griser
许尔霍尔兹 | 许霍尔茨 | schuerholz
肖凯尔 | 肖基尔 | showkeir
威克泽 | 威克瑟 | wichser
科尔希普 | 科尔黑普 | kohlhepp
鲁奥科 | 罗科 | ruocco
加诺尔 | 加诺 | ganor
鲍尔兹韦勒 | 巴尔德施维勒 | baldeschwieler
斯洛尼姆 | 斯洛宁 | slonim
马撒 | 玛莎 | martha
卡斯特莱恩 | 卡斯特兰 | castellain
珀塞克 | 佩塞克 | perseck
维伦 | 瓦伊伦 | viron
珀尔逊 | 皮尔逊 | pirsson
索尔茨 | 肖尔茨 | soults
奇瑟姆 | 奇塔姆 | cheatham
乔西亚斯 | 乔赛亚斯 | josias
埃弗德 | 埃瓦德 | evvard
杰鲁尔德 | 杰罗尔德 | gerould
杰尔 | 耶格 | jaegher
赫里肖夫 | 赫雷斯霍夫 | herreshoff
瑟金 | 西尔金 | sirkin
瓦伦布拉 | 巴伦苏埃拉 | valenzuela
肖尔斯 | 肖沃斯 | showers
阿格伍 | 阿古 | agwu
弗卢克斯 | 弗勒克斯 | flux
考斯利 | 库斯利 | cousley
阿达曼 | 阿达姆南 | adamnan
林恩 | 林 | linn
德赖克 | 德里克 | driker
里查德 | 理查德 | richard
利夫奥克 | 莱夫奥克 | liveoak
范德霍夫 | 范德胡夫 | vanderhoof
普鲁斯曼 | 普拉斯曼 | prusman
吉恩 | 吉亨 | gehan
施努克恩 | 施努克内 | schnukne
马格 | 马杰 | mager
阿加尔 | 阿高尔 | argall
温纳斯特伦 | 温纳斯特鲁姆 | wennerstrum
勒德克 | 利迪克 | luedecke
乔德雷 | 乔德尔 | jordre
普卢内克 | 普伦尼克 | pluenneke
赫希特里特 | 赫什特里特 | hirschtritt
贝拉德 | 贝拉尔 | berard
马尔夫农 | 马尔韦农 | mulvenon
道宁 | 唐宁 | downing
巴特伦 | 巴特拉姆 | battram
麦吉恩蒂 | 麦金蒂 | mcguinty
皮珀 | 派珀 | piper
卡莉什 | 卡利什 | kalish
格丽索治尼娅 | 格丽索戈尼娅 | grisogonia
科菲恩 | 科芬 | coffeen
阿特尔西 | 阿特莱西 | attlesey
加格尼宾 | 加涅班 | gagnebin
霍 | 豪 | howe
布莱什米特 | 布莱希施米特 | blechschmidt
赫维茨 | 赫威茨 | herwitz
布卢克 | 布劳克 | blouke
德雷斯克 | 德赖斯克 | dreiske
普赖尔 | 普里尔 | preil
奎伦 | 奎林 | quillen
贝思 | 贝丝 | beth
比霍尔特 | 伯霍尔特 | byrholdt
普罗文切尔 | 普罗文彻 | provencher
约赫 | 约埃 | yohe
亚特伦 | 亚特隆 | yatron
布思利 | 布思莱 | buthlay
安杰莉娜 | 安杰利娜 | angelina
鲁阿塔 | 里乌塔 | riutta
普伦蒂 | 普朗蒂 | prunty
平杰 | 平格 | pinger
奥洛克林 | 奥劳克林 | o'laughlin
梅约拉斯 | 马约拉斯 | mayoras
伊弗利 | 伊夫利 | evelegh
维西 | 维齐 | veysey
巴斯曼 | 贝斯曼 | baseman
沃斯坦克拉夫特 | 沃斯通克拉夫特 | wollstonecraft
阿曼 | 阿尔曼 | arman
贝德尔 | 比德尔 | bedel
阿德尼 | 埃德尼 | adney
比多 | 贝多 | bedau
莫利诺尔 | 莫勒瑙尔 | mollenauer
斯凯尔斯 | 斯基尔斯 | skiles
芬维西 | 芬韦西 | fenvessy
帕奇 | 帕克 | pach
盖尔德 | 格尔德 | gelder
巴查尔 | 巴卡尔 | bachar
奥尔博 | 阿尔博 | allbaugh
加米特 | 加梅特 | gamet
凯尼斯 | 基尼斯 | kiness
雷蒂 | 雷图 | rettew
德利乔吉斯 | 德利乔治斯 | deligiorgis
加雷尔 | 加勒尔 | garel
奥尔 | 奥利 | ole
巴德温 | 布德温 | budwine
迪奥 | 戴奥 | dio
布罗尔施 | 布勒尔施 | broelsch
塞维尔 | 萨维尔 | savele
莱维 | 利维 | levie
格龙基 | 格朗茨基 | groncki
加康 | 加肯 | garcon
沃梅利 | 沃姆利 | wormeley
戴姆里克 | 德姆里克 | daemmrich
肖尔德勒 | 斯科德勒 | scholderer
杜比 | 达比 | duby
拜尔比 | 比尔比 | beilby
博斯金德 | 博斯坎德 | boskind
瑟维尔 | 瑟维耶 | surveyer
米尔 | 缪尔 | muille
阿尼斯 | 安妮斯 | anis
阿布林 | 埃布林 | ablin
班德 | 班德尔 | bander
罗索尔 | 罗塞尔 | rossall
谢德 | 沙德 | shad
埃奇逊 | 艾奇逊 | etcheson
福塞特 | 福西特 | fawssett
奥拉芙 | 奥拉夫 | olave
梅维蒂 | 马维蒂 | mavity
阿泰耶 | 阿提耶 | atiyeh
伦芬特 | 朗方 | lenfant
尤夫罗因 | 尤弗罗西尼 | euphrosyne
里奥赫 | 里奥克 | reoch
艾娅拉 | 阿亚拉 | ayala
梅因林 | 梅因沃林 | mainwaring
佩特里兹 | 佩特里迪斯 | petrides
科德尔 | 科德 | corder
罗赞娜 | 罗珊 | rozanne
洛格 | 洛奇 | lorge
格利莫尔 | 格利穆尔 | glymour
埃莱娜 | 埃琳娜 | elena
布雷德 | 布里德 | breder
利班 | 莱班 | leban
穆拉尔特 | 缪拉尔持 | muralt
萨洛梅 | 萨洛米 | salome
利克曼 | 莱克曼 | likeman
玛丽萨 | 马里萨 | marisa
帕德福德 | 帕德尔福德 | padelford
沙帕 | 沙帕尔 | shapar
尤金尼亚 | 尤金妮亚 | eugenia
斯普里尔 | 斯珀里尔 | spurrier
梅德沃夫斯基 | 梅德瓦多夫斯基 | medwadowski
希厄特 | 海厄特 | hieatt
特里布瓦瑟 | 特里布沃瑟 | triebwasser
惠奇利夫 | 惠特克利夫 | whitchliffe
怀森 | 威森 | wison
德彻特 | 德克特 | dechert
德夫尼 | 迪夫尼 | deveney
海姆索特 | 海姆塞特 | heimsoth
弗德里 | 维德里 | verdery
希伯德 | 希巴德 | hibbard
塔利亚弗罗 | 托利弗 | taliaferro
莱塞特 | 莱西特 | lycett
莱贡 | 利根 | lygon
奥莱克西 | 奥莱克休 | oleksiw
阿莱斯 | 阿莱 | allez
卡德瓦代尔 | 卡德瓦拉德 | cadwaladyr
萨尔温 | 西尔温 | sulwen
法迪安 | 法迪恩 | fadyean
伯克隆 | 伯克伦 | berklund
德雷南 | 德雷宁 | drennen
德彻 | 德谢尔 | decher
巴特伦 | 巴特拉姆 | buttram
特鲁齐 | 特拉齐 | truzzi
阿布迪安 | 阿布迪恩 | abdian
蒙特莫尔诺 | 蒙特莫雷诺 | montemoreno
托里 | 托丽 | tori
卡里洛 | 卡里略 | carrillo
比比 | 毕比 | beeby
马太娜 | 马塞纳 | marthena
凯莉 | 卡利 | cali
波兰 | 波伦 | pollan
