布雷金里奇 | 布雷肯里奇 | breckinridge
塞德 | 切德 | cedd
玛莉 | 马利 | maly
阿西尼加 | 阿西涅加 | arciniega
法莱恩 | 法兰 | farlane
斯特拉思恩 | 斯特拉森 | strathearn
派珀特 | 佩珀特 | peipert
皮内 | 皮奈 | pinay
梅雷斯曼 | 米尔斯曼 | meresman
弗兰岑 | 弗兰曾 | franzon
伊兹比基 | 伊兹比茨基 | izbicky
埃卡韦斯特 | 埃沙韦斯特 | echaveste
迈尔黑德 | 缪尔黑德 | muirhead
普安 | 普汉 | puhan
沃塞尔 | 瓦塞尔 | wassell
瑟金特 | 萨金特 | seargent
亨巴克 | 亨巴赫 | heimbach
纳尔迪 | 纳迪 | nardi
杰米马 | 杰迈玛 | jemima
莫杜伊特 | 莫德维 | mauduit
艾特 | 艾厄特 | eyet
耶德利 | 亚德利 | yeardley
博比 | 鲍比 | bobbie
麦基尔文娜 | 麦基尔温纳 | macilvenna
拉焦 | 拉乔 | raggio
赖因斯 | 赖恩斯 | rines
麦克费伦 | 麦克弗伦 | mcpherren
埃德霍克 | 埃德尔霍克 | edelhoch
博查尔 | 博索尔 | botsal
瓦格尼 | 韦恩 | wagne
厄德曼 | 厄尔德曼 | erdman
戈伦比夫斯基 | 戈伦别夫斯基 | golembiewski
布罗赖因 | 布罗林 | brorein
格雷戈伊尔 | 格雷瓜尔 | gregoire
劳温 | 雷温 | raewyn
雷梅克斯 | 拉马克斯 | raemakers
皮凯弗 | 皮卡弗 | piccaver
苏布林 | 萨布林 | subrin
费尔本 | 费尔伯恩 | fairburn
津嫩 | 津宁 | zinnen
费登 | 法登 | faden
佩勒蒂耶 | 佩尔蒂埃 | pelletier
帕塞尔 | 帕斯尔 | parcel
霍诺里 | 霍诺丽 | honori
艾梅施 | 伊梅施 | imesch
西明顿 | 赛明顿 | symington
特鲁普 | 思鲁普 | throop
布龙海姆 | 布朗海姆 | bronheim
马霍 | 玛奥 | mahault
法克 | 菲克 | fike
奥德斯 | 奥杜斯 | audus
沃克特尔 | 瓦赫特尔 | wachtel
奥康奈 | 奥康奈尔 | o'connell
拉凯斯 | 拉雪兹 | lachaise
麦科诺希 | 麦康瑙希 | mcconaughy
达维格多 | 达维多尔 | d'avigdor
加莱夫 | 加利夫 | galef
玛吉 | 马吉 | magi
达尔文 | 达温 | darwen
哈巴德 | 哈伯德 | hubbard
曼纳韦 | 马纳韦 | mannaway
图马 | 托伊马 | teuma
奥赫 | 奥 | ough
阿福蒂特 | 阿富尔蒂特 | affourtit
米萨尔 | 米赛尔 | misael
赫默里克 | 亨默里克 | hemmerich
海伍德 | 希伍德 | heawood
詹宁斯 | 杰宁斯 | jenyns
斯坦斯 | 斯泰姆斯 | stames
文恩 | 维恩 | venn
安瓦尔珀尔 | 安瓦里普尔 | anvaripour
莱伯恩 | 利伯恩 | liburn
比比 | 毕比 | beebe
博查特 | 博哈特 | borchardt
卡明 | 卡迈恩 | carmine
巴特伦 | 巴特拉姆 | bartram
佩尔 | 皮尔 | peile
麦康 | 麦肯 | mccon
舒克伯格 | 舒克伯勒 | schuckburgh
麦卡里 | 麦凯里 | mccarey
英芬特 | 因方特 | infant
卡尔赫 | 卡尔 | karrh
杰罗尔 | 杰拉尔 | gerall
亨内肯斯 | 亨尼肯斯 | hennekens
吉弗 | 贾埃弗 | giaever
贾米 | 杰米 | jamie
鲍尔霍恩 | 巴尔霍恩 | ballhorn
斯特格斯 | 斯特奇斯 | sturges
莫克萨姆 | 莫克塞姆 | moxam
阿什唐 | 阿什当 | ashdown
卡姆 | 卡尔姆 | culme
希尔曼 | 沙伊尔曼 | shireman
梅索利 | 梅索伊 | meszoly
格尔德 | 盖尔德 | geld
埃森斯 | 埃森丝 | essence
格沃思米 | 格瓦思米 | gwathmey
巴比罗利 | 巴尔比罗利 | barbirolli
利布 | 利比 | luebbe
哈泽尔 | 黑兹尔 | hazell
施蒂宁 | 斯蒂宁 | stiening
克莱农 | 克勒农 | clernon
金德雷德 | 金德里德 | kindred
纳索尔 | 纳托尔 | nuthall
佐扎 | 佐尔扎 | zorza
戴格 | 戴伊 | daigh
埃廷 | 埃泰恩 | etain
勒罗伊德 | 利罗伊德 | learoyd
巴策 | 巴策尔 | batzer
德弗雷茨 | 迪弗雷特斯 | defrates
尤拉姆 | 乌拉姆 | ulam
达劳 | 达罗 | darraugh
沙德伯格 | 谢德伯格 | schadeberg
迪多 | 德多 | dedow
米恩斯 | 默恩斯 | mearns
格罗布 | 格罗比 | grobe
塔塔利诺 | 塔尔塔利诺 | tartaglino
亚历山大 | 达历山大 | d'alexander
兰姆 | 拉姆 | lambe
考德韦尔 | 考德威尔 | caldwell
利多尔 | 利德尔 | liddall
泽米娜 | 泽米纳 | zemina
希利 | 赫利 | helie
坎特伯里 | 坎特伯雷 | canterbury
斯蒂克 | 斯特克 | stirk
塔肯 | 泰肯 | tacon
古特穆特 | 古特穆思 | gutermuth
弗森 | 费尔森 | ferson
托皮 | 托毕 | torpey
洛多维克 | 洛多威克 | lodowicke
泰奇曼 | 泰克曼 | teichmann
普鲁达姆 | 普鲁多姆 | prudhomme
坎比 | 坎贝 | cumbey
赫姆尔 | 赫姆利 | hermle
奥凯尔 | 奥基尔 | okyle
蒙冈 | 蒙贡 | mongon
亨佩尔 | 亨普尔 | hempel
艾罗 | 艾罗尔特 | ayrault
布赖登索尔 | 布赖登塔尔 | breidenthal
德卢伊吉 | 德路易吉 | deluigi
鲁阿德 | 鲁阿兹 | ruadh
克拉伯 | 克莱伯 | klaber
格里塞德 | 格雷特黑德 | greathead
埃塞雷达 | 埃塞丽达 | ethelreda
博里尔 | 博雷尔 | boreel
布雷恩 | 布里恩 | brehon
久尔 | 圭尔 | guire
厄丘克 | 尤尔丘克 | yurchuck
坦尼肯 | 滕尼肯 | tennican
麦金泰尔 | 麦金太尔 | mcintire
利文 | 莱文 | levene
克拉里斯 | 克拉雷斯 | clares
朱林科 | 祖林科 | dzurinko
切普林斯基 | 西普林斯基 | cieplinski
索乔纳 | 索杰纳 | sojourner
纽贝尔 | 努贝尔 | knubel
卡诺肯 | 卡诺坎 | carnochan
吉内诺 | 吉赫诺 | giheno
罗克辛 | 罗克西娜 | roxinne
伦斯莱尔 | 伦塞勒 | rensselaer
伊登斯 | 埃登斯 | edens
比哈里尔 | 贝哈里尔 | beharriell
朗坎普 | 朗香 | longchamp
贝德纳斯基 | 贝德纳尔斯基 | bednarski
舒尔金德 | 舒尔坎德 | schulkind
皮什 | 佩什 | peche
威尔希特 | 威尔海特 | willhite
洛伦兹 | 洛伦茨 | lorenz
特波尔 | 蒂普尔 | tepoel
贾莫 | 贾伊莫 | giaimo
库尔吉安 | 库尔金 | kuljian
吉耶 | 吉利特 | guillet
哈米利恩 | 哈米里恩 | hamilyon
基尔库西 | 基尔科西 | kilcoursie
里森诺弗 | 里曾诺弗 | reasonover
查肯 | 查康 | chacon
雷布萨门 | 里布萨门 | rebsamen
托菲琴 | 托菲肯 | torphichen
戈特尔斯 | 戈瑟尔斯 | goethals
黑特姆 | 哈特姆 | hatem
瓜尔蒂里 | 瓜尔蒂耶里 | gualtieri
泽兰 | 齐伦 | zeran
比贝尔 | 比布尔 | biebel
奥德斯泰尔 | 奥尔德斯泰尔 | oldstyle
西门斯 | 西门子 | siemens
普利本 | 普利邦 | plybon
斯温斯特拉德 | 斯温斯拉德 | swensrud
贝克纳 | 比克纳 | beichner
恩戈姆 | 恩格霍姆 | engholm
兰内伯格 | 兰恩伯格 | ranneberger
桑德威克 | 桑威克 | sandwick
怀思 | 韦思 | wyeth
施韦希尔德 | 施韦柴尔德 | schweichild
斯坦霍普 | 斯坦诺普 | stanhope
英沃尔兹塔德 | 英沃斯塔德 | ingvoldstad
森格霍 | 桑戈尔 | senghor
布赖豪斯 | 布里格豪斯 | brighouse
克伦布哈尔 | 克伦巴尔 | krumbhaar
斯彭塞 | 斯潘塞 | spenser
拜伯 | 比伯 | biber
莫拉尔 | 莫勒 | morar
弗里利 | 弗赖利 | friley
赖兰斯 | 赖伦斯 | rylance
哈扎德 | 哈泽德 | hazard
穆谢特 | 马希特 | mushet
杜切斯 | 达切斯 | dutchess
布拉姆利 | 布伦利 | brumley
比尔特 | 伯特 | birt
明 | 米恩 | min
法格雷斯 | 菲格斯 | figures
埃加尔 | 埃加 | eggar
特库姆 | 特库姆塞 | tecumseh
伊万杰利斯塔 | 埃万杰利斯塔 | evangelista
韦布利 | 韦伯利 | webley
帕门蒂耶 | 帕尔芒捷 | parmentier
丹格利斯 | 迪安杰利斯 | deangelis
格里诺尔特 | 格里纳沃尔特 | greenawalt
麦格拉斯里奇 | 麦格拉斯里克 | macglasrich
索恩顿 | 桑顿 | thornton
巴洛克 | 巴洛赫 | balloch
切尔内斯基 | 切尔涅斯基 | chernesky
贝利弗 | 贝尔维 | bellevue
赫雷哈尼克 | 赫雷查尼克 | hrechanyk
特里利文 | 特里莱文 | treleaven
比内尔 | 比尤内尔 | buesnel
阿迪 | 埃迪 | adye
哈格迈耶 | 哈格迈尔 | hagemeyer
阿拉蒙 | 阿拉芒 | allamong
西米恩 | 西明 | siemien
普里亚尔 | 普赖尔 | prial
布利萨克 | 布利萨茨 | blisac
拜德斯 | 比德兹 | bidez
伊尔威尔 | 厄维尔 | irwil
威尔梅特 | 薇尔梅特 | wilmett
纳拉乔 | 纳兰霍 | naranjo
布雷兰 | 布里兰 | breland
卡尔 | 卡利 | karle
阿德莉娜 | 阿德利娜 | adelina
斯特尔特 | 斯泰尔特 | stelter
门韦尔 | 米恩韦尔 | meanwell
沙克伯格 | 沙克伯勒 | shuckburgh
亚历山森 | 亚历山德森 | alexanderson
朱皮特 | 丘辟特 | jupiter
德尤特里奇 | 多伊特里希 | deutrich
托厄里 | 托尔里 | towery
马德林 | 马德琳 | madlin
威舍 | 维舍 | wischer
弗劳 | 弗劳德 | furlaud
戴加德 | 迪格 | dygard
巴利克 | 巴利奇 | balich
卡比特 | 丘比特 | cubitt
福尔迪西 | 福尔德西 | foldessy
西克雷斯特 | 西克里斯特 | secrest
拉扎 | 拉扎尔 | lazar
蒂里克 | 泰里克 | tyriq
佩茨 | 皮特斯 | petes
皮克斯 | 皮尔克斯 | pearkes
费尔哈文 | 费尔黑文 | fairhaven
索恩伯格 | 索恩伯勒 | thornburgh
特雷德格 | 特里迪加 | tredegar
佩洛 | 佩洛特 | pelot
埃瑟 | 阿瑟 | acer
阿蒂加尔 | 阿蒂格尔 | attygalle
马泰 | 玛西娅 | mathea
彼得拉斯卡 | 彼特鲁斯卡 | petruska
弗恩 | 维恩 | verne
尤迪切洛 | 尤迪塞洛 | iudicello
韦姆 | 瓦伊姆 | waim
鲁兰 | 鲁伦 | ruellan
拉赫特 | 拉克特 | lachter
拉哈布 | 雷哈布 | rahab
斯蒂格勒 | 施蒂格勒 | stigler
特威宁 | 特文宁 | twining
西达罗斯 | 西达劳斯 | sidarouss
弗洛尔德休 | 弗劳尔迪 | flowerdew
盖兰 | 格兰 | gellan
吉梅尼兹 | 希门尼斯 | jimenez
普勒 | 普拉 | pullar
韦尔纳 | 沃尔纳 | woellner
杜因特 | 德温特 | dewint
斯威特曼 | 斯韦特曼 | sweatman
加米齐 | 加梅齐 | garmezy
布拉德劳 | 布拉德洛 | bradlaugh
尼斯克恩 | 尼斯肯 | kniskern
布鲁因 | 布勒因 | bruyn
塔米赫尔 | 塔米希尔 | tamihere
库劳 | 库罗 | courau
贝内迪卡斯 | 贝内迪克斯 | benedicus
麦格罗瑟 | 麦格鲁瑟 | macgreuther
柯特尼厄斯 | 柯特纽斯 | curtenius
阿斯奎斯 | 阿斯奎思 | asquith
赫利娜 | 赫莉娜 | helina
帕策尔 | 普策尔 | putzel
伊蒂拉格 | 伊泰拉格 | itteilag
斯特朗奇 | 斯特朗 | stronge
埃沃伊 | 伊沃伊 | evoy
迪尔富思 | 迪伦弗思 | dyhrenfurth
特鲁塞尔 | 特拉塞尔 | trussel
坦盖 | 坦圭 | tanguay
拉斯布里奇 | 拉斯布里杰 | rusbridger
杜布拉斯 | 杜布拉 | dubras
亚兹明 | 亚斯明 | yazmin
劳德代尔 | 劳德戴尔 | lauderdale
伯贝奇 | 伯比奇 | burbage
伊贝林 | 埃贝林 | ebeling
哈斯卢普 | 哈斯勒普 | haslup
科尔尼特 | 科尔内特 | collnette
波洛斯 | 普洛斯 | poulos
卢万多 | 柳安多 | lewando
麦克沃尼什 | 麦克瓦尼什 | macvarnish
韦德勒 | 维德勒 | vedeler
金泽特 | 金瑟特 | gensert
麦卡尔 | 麦考尔 | mackal
奥利曼 | 阿利芒 | allemang
赛奇 | 赛什 | saich
皮奥特罗夫斯基 | 彼得罗夫斯基 | piotrowski
贾恩 | 扬 | jahn
康加尔顿 | 康高尔顿 | congalton
杜瓦 | 杜阿克斯 | duax
戴森霍费尔 | 戴森霍弗 | deisenhofer
迪布林 | 杜布林 | dubrin
沙滕克 | 沙滕柯克 | schattenkerk
加特纳 | 盖特纳 | gaertner
法隆 | 法伦 | falloon
克莱本 | 克莱伯恩 | clyburn
奥斯威 | 奥斯威尤 | oswiu
兰德威西 | 兰德沃西 | landwirthy
索锡 | 索西 | southee
米隆 | 米伦 | millon
艾利 | 艾莉 | eily
埃克恩 | 伊肯 | ekern
菲利恩 | 菲利翁 | filion
赞皮略 | 赞皮耶洛 | zampiello
绍尚 | 舒尚 | shooshan
莫普斯 | 莫皮斯 | moppes
阿尔维 | 阿利维 | alevey
帕塞尔 | 帕斯尔 | parcell
泰博尔特 | 蒂博尔特 | tybalt
索尔 | 苏尔 | soul
迪迪奥 | 戴德奥 | dedeo
麦克雷思 | 麦克勒思 | mackereth
伯勒 | 布洛 | bullough
博奈哈迪 | 博尼哈迪 | bonyhadi
帕珀马斯特 | 佩珀马斯特 | papermaster
贝伦德斯 | 贝伦兹 | berendes
杜布尔迪 | 道布尔迪 | doubleday
埃拉齐姆 | 伊拉齐姆 | erazim
施雷德 | 施拉德 | schrade
伯克 | 比尔克 | birck
巴特霍尔森 | 巴托尔松 | bartholdson
英格林 | 英林 | yingling
库普里尔 | 卡普里尔 | cuprill
沙努廷 | 查纽廷 | chanutin
埃塞克 | 伊塞克 | esek
梅尔霍弗 | 迈尔霍费尔 | maierhofer
马伦普尔 | 马伦普雷 | malempre
斯拉克 | 斯莱克 | slack
多奇 | 德奇 | doetsch
阿尔顿 | 阿里顿 | arreton
贝哈 | 贝亚 | beha
安嫩贝格 | 安嫩伯格 | annenberg
博尔多 | 波尔多 | bordeaux
德西德里厄斯 | 德西迪里厄斯 | desiderius
撒尔戈特 | 索尔戈特 | thalgott
舍恩巴克 | 舍恩巴赫 | schoenbach
奥尔特林查姆 | 奥特林厄姆 | altrincham
厄纳姆 | 埃努姆 | aernum
拉万 | 拉文 | lavan
麦基尔维 | 麦基雷维 | macilrevie
默特廷斯 | 默廷斯 | merttins
莱夫勒 | 莱弗勒 | leffler
科卡姆 | 科克姆 | corkum
拉文 | 雷文 | raven
哈夫纳 | 哈文纳 | havenner
莫布斯比 | 莫布兹比 | mobsby
阿奎约 | 阿夸约 | aquayo
弗雷林休森 | 弗里林海森 | frelinghuysen
麦克鲁登 | 麦克拉登 | mccrudden
帕杰利斯 | 帕盖利斯 | pargellis
莱波尔 | 勒普尔 | lepoer
奥尔施塔特 | 阿尔斯塔特 | alstadt
达夫尼 | 达夫妮 | daphne
里加利亚 | 雷加利亚 | regalia
麦克莱夫 | 麦克拉夫 | mcclave
罗曾塔尔斯 | 罗森塔尔斯 | rozentals
麦康基 | 麦康希 | macconchy
桑德姆 | 桑达姆 | sandham
马宁 | 曼宁 | maning
布莱胡特 | 布拉胡特 | blachut
赫明 | 亨明 | hemming
蒂文加姆 | 蒂文加杜姆 | tirvengadum
马米 | 玛米 | mami
吉内罗 | 吉尼罗 | genero
比斯特 | 比伊斯特 | buist
龙特里 | 朗特里 | rowntree
拉拉莫尔 | 拉腊莫尔 | laramore
哈沙根 | 哈舍根 | hashagen
赖尔斯 | 赖亚尔斯 | ryalls
梅伦 | 默龙 | merron
安克勒姆 | 安克拉姆 | ancrum
鲁兹 | 吕埃 | ruez
怀曼 | 威曼 | wiman
拉德布罗克 | 拉德布鲁克 | ladbroke
卢伊斯蒂格 | 卢斯蒂格 | luistig
恩斯莱格 | 奥恩斯莱格 | oenslager
沃查特 | 沃特沙夫特 | wirtschafter
伊默斯 | 伊穆斯 | imus
托赫 | 托克 | toch
杜温特 | 德温特 | dewenter
佩得菲尔德 | 彼得菲尔德 | peterfield
加瓦尔特 | 加沃尔特 | gawalt
哈雷尔 | 哈勒尔 | harrel
斯普勒 | 施普勒 | spuhler
阿马尼 | 阿尔马尼 | armani
弗莱布 | 弗莱比 | flebbe
汤布斯 | 图姆斯 | tombs
达夫隆 | 杜弗隆 | duflon
谢里克 | 谢雷克 | sherek
哈纳 | 哈娜 | hana
本恩 | 本 | benn
莫伊塞威奇 | 莫伊塞维奇 | moiseiwitsch
多里 | 多丽 | dorrie
法尼夫 | 法纳夫 | faneuf
罗伯斯顿 | 罗伯茨顿 | robertston
科尔克拉瑟 | 科尔克拉泽 | colclaser
多勒 | 多拉夫 | dorough
巴尔尼尔 | 巴尼尔 | balniel
菲林 | 法尔林 | firing
克利姆 | 克莱米 | klemme
费尔 | 费雷 | ferre
安娜贝尔 | 安娜贝勒 | annabelle
贝伊文 | 博伊文 | boivin
福伊 | 福西 | feusi
曾伯格 | 宗伯格 | zumberg
萨加 | 塞格尔 | sagar
恩格兰 | 英格兰 | england
利弗塞奇 | 利弗西奇 | liverseidge
艾德斯莫 | 艾兹莫 | eidsmoe
阿布 | 阿贝 | abbe
博伊斯方塔恩 | 博伊斯方丹 | boisfontaine
麦卡赫蒂 | 麦克哈蒂 | mccahearty
威斯特摩伦 | 威斯特摩兰 | westmoreland
伯格哈德 | 伯格哈特 | burghard
厄尔普 | 厄普 | earp
斯塔布尔菲尔德 | 斯塔布菲尔德 | stubblefield
弗皮洛克 | 韦皮勒 | verpilleux
汤南德 | 汤恩德 | townend
伊内丝 | 伊内兹 | inez
杰庞 | 杰波恩 | jepoen
伯肯霍尔茨 | 伯肯霍尔兹 | birkenholtz
默蒂斯 | 默特斯 | mertes
勒克特 | 勒基特 | luckett
伊德 | 伊德尔 | eader
维诺格拉德 | 维诺格勒 | vinograd
安娜格莫尔 | 安纳克莫尔 | annaghmore
斯图德曼 | 斯蒂德曼 | studeman
利利恩 | 勒林 | lelean
布里森 | 布赖森 | bridson
蒂林厄斯特 | 蒂林哈斯特 | tillinghast
扎克利 | 朱克利 | zuckley
苏姆 | 萨姆 | sum
达尔夫 | 达雷夫 | dareff
皮里斯廷 | 皮里斯坦 | pearistine
马达维克 | 马达维赫 | mhadavikh
戈勒布 | 戈卢布 | golub
杜拉克 | 杜拉奇 | dullach
肖尔德 | 索尔德 | szold
杜普卡克 | 杜普恰克 | dupcak
布拉登 | 布拉顿 | bradon
奥基 | 奥齐 | orczy
贝姆 | 巴姆 | bame
普利梅尔 | 普莱梅尔 | plymale
布罗梅特 | 布罗米特 | bromet
皮霍维亚克 | 皮乔维亚克 | piechowiak
惠特伯 | 惠特伯勒 | whitburgh
西比尔 | 塞比尔 | sebire
法勒 | 法伊勒 | pfeiler
斯凯尔特 | 舒尔特 | schulte
霍莫尔卡 | 霍穆尔卡 | homolka
海斯伯格 | 海斯堡 | heisborg
费尔德布里尔 | 费德布里尔 | feldbrill
杰尔农 | 热农 | gernon
斯顿特 | 斯坦特 | stunt
埃莉斯 | 埃莉丝 | elyse
克勒勒 | 克雷勒 | kroehler
切米宁 | 切米宁特 | cheminint
迪本 | 德本 | deben
克丽扎 | 克里扎 | kryza
法斯纳赫特 | 法斯纳克特 | fasnacht
布根 | 巴根 | bugan
佩希 | 皮奇 | pechey
施瓦姆 | 施万布 | schwamb
奥里 | 奥赖 | ory
艾尔弗里克 | 阿尔弗里克 | aelfric
艾尔加 | 艾尔格 | eylgar
耶 | 伊 | yee
索内曼 | 索恩曼 | sonnemann
奥扎娜 | 奥赞 | ozanne
德汉 | 德哈恩 | dehaan
雷诺 | 雷纳 | raynor
松塔格 | 桑塔格 | sontag
麦康 | 梅肯 | macon
德拉丰斯 | 德拉方斯 | delafons
戴维 | 达维 | davee
戈希 | 戈伊 | gohey
克莱弗 | 克拉弗 | claver
麦克默尼米 | 麦克梅尼米 | mcmenemey
桑瑟姆 | 桑森 | sansum
吉吉 | 吉盖 | giggey
达科姆 | 戴科姆 | dacombe
邦廷 | 邦坦 | bontein
多本 | 多宾 | doben
杰穆思 | 格穆思 | germuth
泰恩什 | 坦什 | tainsh
克雷斯皮尼 | 克雷皮尼 | crespigny
赫梅尔辛 | 休梅尔辛 | humelsine
马夸里 | 麦夸里 | maquarie
比尔基 | 伯基 | buerki
斯瓦德什 | 斯沃德什 | swadesh
巴贝尔 | 贝布尔 | babell
克拉丽达 | 克拉里达 | clarida
布朗塔斯 | 布龙塔斯 | brountas
德雷沃尔吉拉 | 德沃尔吉拉 | drevorguilla
奥弗拉赫蒂 | 奥弗莱厄蒂 | o'flahertie
塞维 | 西维 | sevey
博克尔 | 博克 | boker
佩雷兹 | 佩雷斯 | perez
维泽 | 维佐尔 | vizor
蒂利 | 蒂莉 | tillie
赖格 | 里格 | riger
道德 | 多德 | dowd
艾利森 | 艾莉森 | alyson
德雷塞尔 | 德雷斯尔 | dressel
朱利 | 朱莉 | julie
芬格胡特 | 芬格赫特 | fingerhut
希克 | 舍克 | shirk
马休兰 | 马胡兰 | mahuran
派耶 | 派尔 | peyer
波兰 | 普兰 | poulain
西尔瓦纳斯 | 西尔维纳斯 | silvanus
埃克斯坦斯 | 埃克斯滕斯 | exstance
普萨特里 | 普萨泰里 | pusateri
尼恩 | 奈恩 | nyhen
克利瑟 | 克莱瑟 | cleather
埃迈尔 | 埃米尔 | emyr
罗巴特斯 | 罗巴茨 | robartes
阿杰内洛 | 阿涅洛 | agnello
伊莱 | 艾莱 | ilay
内修 | 纳休 | nathiew
斯蒂格利茨 | 施蒂格利茨 | stiglitz
塞西利厄斯 | 塞西莉厄斯 | cecilius
冯纳科特 | 旺纳科特 | wonnacott
哈姆斯 | 黑姆斯 | hammes
查格尔斯 | 查格利斯 | chagles
麦凯肯 | 麦凯琴 | maceachen
格里比诺 | 格里布诺 | griebenow
加南吉安 | 加南吉扬 | ganangiyan
古拉德 | 戈拉德 | goulard
考沃特 | 科沃特 | cowart
格罗杰 | 格罗格 | grogger
怀特利瑟 | 怀特莱瑟 | whiteleather
明顿 | 明特恩 | minturn
赫德克 | 赫德基 | hedke
布雷纳汉 | 布雷斯纳汉 | bresnahan
波 | 鲍 | pow
拉克歇尔 | 拉克斯尔 | wraxhall
曼柳斯 | 曼利厄斯 | manlius
谢拉 | 希拉 | shelagh
内格尔 | 尼格尔 | negel
巴吉特 | 巴杰特 | bardgett
乔弗里恩 | 乔夫里翁 | joffrion
伯恩 | 贝尼 | boehne
格鲁尔 | 格劳尔 | grouer
德沃拉克 | 德沃夏克 | dvorak
梅约斯 | 梅杰斯 | majors
塔吉 | 塔姬 | taggy
麦科克 | 麦科奇 | mccoch
蒂姆韦尔 | 泰姆韦尔 | timewell
巴克纳 | 巴赫纳 | bachner
塔德霍 | 塔杜 | tudhoe
蒂格雷特 | 泰格雷特 | tigrett
卡迪尤 | 卡迪厄 | cadieux
凯嫩 | 凯南 | kainen
格尔 | 吉尔 | gehl
迪斯特伯格 | 杜斯特伯格 | duesterberg
克雷奇马 | 克雷奇马尔 | kretchmar
利德福 | 利德福德 | lydford
菲恩 | 费恩 | feane
科奈因 | 科奈恩 | conein
巴尔诺 | 巴诺 | barno
格雷博 | 格里博 | grebow
弗里斯 | 弗雷斯 | frece
朗莱因 | 朗莱恩 | longhlein
埃勒斯 | 埃利斯 | elles
德斯巴拉茨 | 德巴拉茨 | desbarats
沃拉克 | 沃勒克 | wallack
胡迪尼 | 霍迪尼 | houdini
克里森森 | 克里斯坦森 | christanson
卡尼尔尼 | 卡奈尔尼 | carnearney
坦嫩鲍姆 | 特南鲍姆 | tennenbaum
霍金 | 霍根 | hodgan
卡奇亚 | 卡夏 | cachia
莫尔桑 | 莫桑 | morsan
阿杰里斯 | 阿吉里斯 | argeris
明内特 | 明妮特 | minnette
福尔加 | 福加 | forga
里哈尔 | 雷哈尔 | rehal
安斯帕彻 | 安斯帕赫尔 | anspacher
贾西诺夫斯基 | 贾西诺斯基 | jasinowski
克雷弗 | 克里弗 | crever
沃尔西奥夫 | 瓦尔塞奥夫 | waltheof
拉普瓦诺 | 拉普阿诺 | rapuano
托比特 | 托贝特 | torbett
泰雷尔 | 蒂雷尔 | tyrell
安德雷斯 | 安德烈斯 | andress
埃尔斯皮 | 伊丽莎白 | elspie
哈根 | 黑根 | hagan
托普尔 | 托佩尔 | topple
塔姆斯 | 泰晤士 | thames
斯维克 | 斯韦克 | svec
斯坦布勒 | 斯坦伯勒 | stanbrough
肯奈尔德 | 肯奈德 | kennaird
莱克拉斯 | 勒克拉 | lecras
斯普赖尔 | 斯普雷耶 | spreyer
艾克纳 | 艾希纳 | eichner
费拉奥 | 费劳 | ferrao
奥弗拉赫蒂 | 奥弗莱厄蒂 | o'flaherty
博尼斯蒂尔 | 博恩斯蒂尔 | bonesteel
克里恩 | 克林 | crean
萨马罗 | 萨马鲁 | samaroo
卡赫特 | 卡彻特 | kachert
滕恩博 | 特恩博 | turnbaugh
伯格万 | 伯格文 | bergevin
珀克 | 珀基 | pyrke
恩布林 | 恩布琳 | emblin
卡尔索普 | 考尔索普 | calthorpe
舍尔伍德 | 舍伍德 | sherwood
瓦利奥蒂斯 | 瓦莱奥蒂斯 | valeotis
塞森 | 特森 | thesen
吉尔德豪姆 | 吉尔多姆 | guildhaume
法尼伊尔 | 法纳尔 | faneuil
雷塔 | 里塔 | rheta
里查特 | 理查特 | richart
朗尼加 | 朗内加 | runnegar
安托尔兹 | 安索尔兹 | ahntholz
卡莎 | 卡撒 | cartha
扬格尔 | 扬格 | younger
多尔格 | 德尔格 | dolger
希史密斯 | 希尔史密斯 | shearsmith
赫伯斯特赖特 | 赫布斯特雷特 | herbestreit
赫尔斯滕 | 赫尔斯特恩 | hellstern
沙克 | 舒克 | schuck
迪林 | 迪尔林 | deerlin
埃尔韦斯 | 埃尔威斯 | elwes
塔弗 | 塔沃尔 | tavor
韦赫 | 韦伊尔 | weiher
韦特 | 维特尔 | vetter
赫米恩 | 赫米奥娜 | hermione
斯维尔 | 斯维沃 | svewar
约翰森 | 约翰逊 | johnson
杭德里奇 | 杭德里克 | honderich
利伯丁 | 利伯蒂娜 | libertine
达利佩齐 | 达莱佩泽 | dallepezze
迈尔斯特拉普 | 迈尔斯特勒普 | meilstrup
朗塞莱特斯 | 朗斯利特斯 | launceletus
埃德利 | 埃德尔 | ederle
格恩斯巴克 | 根斯巴克 | gernsback
比尔 | 伯尔 | birr
温 | 韦恩 | wain
邓坎森 | 邓肯森 | duncanson
高迪安 | 高迪恩 | gaudian
迪尔 | 代尔 | diel
维多尔 | 维多 | vidor
迪思里奇 | 迪特里希 | diethrich
布拉米尔斯 | 布拉迈尔斯 | blamires
迈斯利希 | 迈斯利奇 | meislich
马斯凯廷 | 马斯卡廷 | muscatine
当特西 | 当齐 | dauntsey
沃索 | 瓦索 | wasow
列昂捷耶夫 | 列昂季耶夫 | leontiev
贾尔迪 | 吉亚尔迪 | ghiardi
阿勒姆 | 奥勒姆 | allam
博迪科姆 | 博迪库姆 | bodycombe
施韦尔布 | 施韦布 | schwelb
伊泽诺尔 | 艾泽努尔 | izenour
拉纳夫 | 雷纳夫 | ranulph
特雷里斯 | 特里赖斯 | trerise
帕尼特 | 帕内特 | panet
龙恩 | 龙尼 | ronne
平乔特 | 平肖 | pinchot
范热 | 范格特 | fanget
伊尔格 | 伊尔克 | ilg
查森 | 蔡森 | chasen
科佩拉 | 科皮拉 | coppela
胡拉布基安 | 朱拉布奇安 | joorabchian
斯拉特里 | 斯莱特里 | slattery
埃尔马思 | 厄马思 | earmarth
希拉克 | 希莱克 | shillaker
博尔杜克 | 博尔达克 | bolduc
贝格尔曼 | 比格尔曼 | begelman
梅约 | 梅奥 | mayo
安蒂维尔 | 安特维尔 | antevil
杜纳文特 | 杜纳万特 | dunavant
基珀斯 | 凯珀斯 | kuipers
梅因多尔德 | 梅因唐纳德 | maindonald
麦卡勒里 | 麦卡利里 | mcalery
哈兹尔廷 | 黑兹尔坦 | hazeltine
迈吉尔 | 迈伊尔 | mighill
赫曼 | 希曼 | heman
恩斯特鲁德 | 恩斯鲁德 | ensrud
布罗泽 | 布拉泽 | brother
辛尼 | 锡恩 | thynne
弗里斯 | 弗里亚斯 | freas
布里安 | 布赖恩 | brian
利滕德尔 | 勒滕德 | letendre
杰斯 | 杰西 | jesse
格温福 | 格温弗 | gwynfor
利韦斯丘 | 莱韦斯克 | levesque
奥德里 | 奥德丽 | audrey
约瓦诺维奇 | 约万诺维奇 | yovanovitch
派尤什 | 皮尤什 | piyush
安德丽尔 | 安德里奥尔 | andriole
勒彭内克 | 勒佩内克 | lepennec
多嫩菲尔德 | 多宁费尔德 | donenfeld
纳诺什 | 纳诺斯 | nanos
沃尔德雷普 | 沃尔德里普 | waldrep
德马西奥 | 德马肖 | demascio
穆科夫斯基 | 穆科斯基 | mukowski
泽谢拉 | 泽克拉 | zechella
卡莉 | 凯莉 | kallie
斯凯特 | 斯卡特 | skate
麦吉尔伍勒 | 麦吉尔伍尔 | macgillvoor
布古尔德 | 布古尔 | bougourd
塞文 | 西文 | sevin
尼泽克 | 内姆泽克 | nemzek
尤曼斯基 | 乌曼斯基 | umansky
欣恩 | 希恩 | shinn
庞纳珀鲁马 | 庞南佩鲁马 | ponnamperuma
米曾 | 迈曾 | mizen
洛梅尔 | 隆梅尔 | lommel
马赫 | 马奇 | much
金尼弗 | 珍妮弗 | gennifer
查萨格尼斯 | 沙萨涅 | chassagnes
厄尔利 | 厄利 | earley
博克罗德 | 鲍赫鲁德 | boughrood
吉隆 | 吉伦 | gillon
多沃德 | 道尔德 | doward
基尔里 | 基里 | kearey
沃克 | 瓦克尔 | wacker
卢易祖 | 路易祖 | louizou
弗兰兹 | 弗朗兹 | franz
米泽尔 | 米泽勒 | mizelle
托雷斯 | 托里斯 | torres
沃利本 | 沃莱本 | wohlleben
普尔茨格拉夫 | 法尔茨格拉夫 | pfaltzgraff
沃申科 | 瓦申科 | washenko
马库斯 | 马库塞 | marcuse
欧明杰 | 艾尔明格 | irminger
阿伦 | 艾伦 | allen
布贾克 | 布亚克 | bujake
乔瑟姆 | 乔撒姆 | jotham
古卡斯 | 古奥卡斯 | guokas
迪特尔特 | 迪泰特 | dittert
费滕 | 法滕 | phaten
菲策尔温 | 菲茨艾尔温 | fitzailwyn
埃迪生 | 埃迪森 | eddison
加雷特 | 加勒特 | garret
德马奇 | 德马斯 | demarce
希金博瑟姆 | 希金博特姆 | higinbotham
玛乔 | 马季 | marj
斯蒂文顿 | 史蒂文顿 | steventon
布加斯 | 巴加斯 | bugas
埃奇达尔 | 埃奇代尔 | edgedal
凯 | 基 | key
林德斯滕 | 林斯滕 | lindsten
本内特 | 贝内特 | bennete
德克罗克 | 德克鲁克 | decroock
贝罗尔 | 伯罗尔 | berall
特雷基安 | 图雷基安 | turekian
凯特伦 | 卡特伦 | catron
斯威特基 | 斯威凯 | switkay
布里哈特 | 布里尔哈特 | brillhart
多本施佩克 | 多本斯佩克 | daubenspeck
迪克森 | 德克森 | dirksen
贝格尔 | 贝尔 | beighle
西利尔 | 特威利尔 | thuillier
戴曼特 | 迪亚曼特 | diamant
科德 | 科尔德 | coard
戈特热特 | 戈特格特鲁 | gottgetereu
诺桑顿 | 诺桑普顿 | northampton
布罗厄斯 | 布罗斯 | broas
赫伦布兰德 | 海伦布兰德 | hellenbrand
埃布 | 厄尔布 | erb
格瓦特金 | 格沃特金 | gwatkin
西茜 | 锡西 | cissie
莱兰 | 利兰 | lelland
温泽尔 | 温策尔 | wenzel
杜格 | 杜奇 | dooge
巴蒙特 | 贝蒙特 | bamont
加利亚多 | 加利亚尔多 | galiardo
奥尔德希泽 | 奥尔迪泽 | aldhizer
卡洛格罗 | 卡洛杰罗 | calogero
姆林纳基克 | 姆利纳奇克 | mlinarchik
贝格尔 | 比格尔 | begel
道德斯韦尔 | 多德斯韦尔 | dowdeswell
达尔 | 杜尔 | durr
伯里 | 贝里 | berrie
米齐 | 梅齐 | meazey
尤特 | 尤思 | uthe
格鲁乔 | 格劳乔 | groucho
斯坦纳 | 斯蒂纳 | stiner
德伦富思 | 迪伦弗思 | dhyrenfurth
扬克威奇 | 扬克维奇 | yankwich
萨格曼 | 塞奇曼 | sageman
库达希 | 卡达希 | cudahy
克尔切维尔 | 克切维尔 | kercheville
德西雷 | 德西蕾 | desiree
库利 | 丘利 | kewley
乔瑟林 | 乔斯林 | josselyn
库德拉 | 夸德拉 | cuadra
比昂 | 拜昂 | bion
加哈根 | 加黑根 | gahagen
麦金图夫 | 麦金塔夫 | mcinturff
莫福德 | 莫维兹 | morfudd
桑克利 | 尚克利 | sankley
塞马拉 | 赛马拉 | saemala
怀斯坦 | 威斯坦 | wystan
博德温 | 鲍德温 | bodwine
勒斯 | 卢斯 | luss
鲍科姆 | 鲍库姆 | bawcombe
莱瑟夫 | 勒瑟夫 | lesurf
查伦格 | 查林杰 | challenger
塞特 | 撒特 | thaete
约基尔森 | 约克尔森 | yochelson
弗兰西娅 | 弗朗西亚 | francia
亨特雷斯 | 亨特里斯 | huntress
托乌萨宁 | 蒂乌萨宁 | tiusanen
米尔德万 | 米尔德文 | mildvan
阿尼尼 | 阿内尼 | aneny
马斯曼 | 穆斯曼 | mussman
阿尔韦尔 | 奥尔韦尔 | alwell
萨特奇 | 萨特杰 | satge
贾妮斯 | 贾尼西 | janisse
比基特 | 比克特 | bicket
迪蒂 | 达西 | duthie
盖汉 | 加恩 | gahan
德拉波 | 德拉珀 | drapeau
霍杰特 | 霍贾特 | hodgart
桑比 | 桑德比 | saundby
特比特 | 特贝特 | tebet
德斯布瓦 | 德布瓦 | desbois
斯威布 | 斯韦比 | swaebe
格拉巴尔 | 格拉巴 | grabar
弗鲁伊特 | 弗鲁特 | fruit
伊利恩 | 伊尔伦 | illearn
阿布洛姆 | 阿布隆 | ablom
埃斯梅尔 | 伊斯梅尔 | esmail
沃滕伯格 | 瓦滕伯格 | wattenberg
安东尼斯 | 安图尼斯 | antunes
阿迪内 | 阿迪尼特 | adinet
吉尔克雷斯特 | 吉尔克里斯特 | gilchrest
霍耶莱贝克 | 胡尔贝克 | houiellebecq
布希 | 布舍 | busche
卡梅尔福德 | 卡姆尔福德 | camelford
布吕恩 | 布鲁恩 | bruene
比伊 | 布伊 | buie
埃斯特黑 | 埃斯特海 | esterhai
马尔沙因 | 马尔夏恩 | mulshine
埃莱克特拉 | 伊莱克特拉 | electra
多佩尔 | 德佩尔 | doepel
麦考莱 | 麦考利 | macaulay
查费茨 | 查菲茨 | chafetz
瑟米厄斯 | 瑟缪斯 | sermeus
耶曼斯 | 伊曼斯 | yeamans
艾肯 | 伊坎 | icahn
罗伊尔 | 鲁埃尔 | reuel
桑 | 图恩 | thun
海森 | 希森 | hyson
沃姆索 | 沃姆泽 | wormsor
吉瑙尔 | 格瑙尔 | genauer
蔡维格 | 查维格 | chaveg
克莱夫 | 克拉夫 | clave
蒙东纳 | 蒙顿纳 | montonna
利多姆 | 利德姆 | leedom
马拉布尔 | 梅拉伯 | malabre
利希特沃特 | 利希特瓦尔特 | lichtwardt
奥弗罗尔 | 奥费拉尔 | o'ferrall
马琴 | 梅琴 | machen
沃默 | 沃尔默 | wolmer
塔谢罗 | 塔什罗 | taschereau
埃廷杰 | 埃廷格 | ettinger
福尔维 | 法尔维 | falvey
查彭 | 沙蓬 | chapone
林迪 | 琳迪 | lynndie
卡琳 | 卡莱恩 | carline
康伯 | 库默 | comber
赫施 | 胡希 | husch
阿克利 | 埃克利 | akeley
尤泽 | 尤伊泽 | ueyser
奥拉 | 奥尔拉 | orla
宰斯曼 | 齐斯曼 | zysman
卡丹 | 卡登 | kadane
阿夫伯里 | 埃夫伯里 | avebury
维拉亚洛博斯 | 比利亚洛沃斯 | villalobos
迪达姆 | 迪德姆 | deedham
杜基米尼尔 | 杜克米尼尔 | dukeminier
斯特朗伯格 | 斯特龙伯格 | stromberg
格维茨 | 格威茨 | gurwitz
德梅特 | 德梅特尔 | demaitre
贝尔里 | 比尔里 | beary
海恩菲尔德 | 汉费尔德 | hainfeld
加勒蒂 | 加拉蒂 | garraty
沃拉 | 瓦拉 | walla
埃尔德赫姆 | 埃尔德姆 | ealdhelm
布兰达 | 布兰多 | blandau
斯塔尔内克 | 斯托尔内克 | stalnecker
马杰里 | 马格丽 | margery
贝沃尔德 | 贝瓦尔德 | baerwald
盖伊 | 贾伊 | ghey
赖姆斯 | 里姆斯 | rheims
普拉格 | 普拉奇 | plugge
基乔 | 凯乔 | kejoa
博斯顿 | 波士顿 | boston
赫芬 | 赫法恩 | huffine
瑟希 | 塞希 | sershey
拉克斯里思 | 拉克斯弗里思 | laxfrith
塞利格曼 | 塞利希曼 | seligmann
加韦德 | 加维德 | gaved
科奇尼希 | 科奇尼格 | kotschnig
斯特雷姆劳 | 斯特里姆劳 | stremlau
佩洛贝特 | 佩卢贝特 | peloubet
德朗古尔 | 德罗姆古尔 | dromgoole
盖尔曼 | 格尔曼 | gellman
拜尔 | 贝耶尔 | beier
马卡洛尼斯 | 马查洛尼斯 | marchalonis
瑟瓦克 | 瑟瓦奇 | serwach
阿塞林 | 阿斯林 | acelin
阿菲 | 埃菲 | afee
西德博特姆 | 赛德博特姆 | sidebotham
格德 | 格尔德 | gerd
埃克洛夫 | 埃克勒夫 | eklof
博格哈蒂 | 博格蒂尔 | boghatyr
芬格勒 | 芬勒 | fengler
阿利尼安 | 阿莱尼安 | alleynian
豪恩谢尔 | 霍恩谢尔 | hounshell
埃因 | 约恩 | eoin
索 | 托 | thau
西德尼 | 西妮 | sydni
图雷曼 | 图尔曼 | tureman
德西德拉塔 | 德西德蕾塔 | desiderata
茹埃特 | 朱厄特 | jouett
约克威廉斯 | 约克威廉 | yorkwilliams
弗拉利克 | 弗雷利克 | fralick
塞尔娜 | 塞尔纳 | serna
伦嫩 | 伦南 | lennen
罗吉特 | 罗热 | roget
阿伯恩 | 阿本 | abern
伊登 | 艾登 | idden
希尼特 | 希格尼特 | hignett
沙夫特斯伯里 | 沙夫茨伯里 | shaftesbury
杜庞特 | 杜邦 | dupont
克利姆克 | 克利姆基 | klimcke
赫尔布尔 | 赫布尔 | helble
比尔布勒 | 比尔伯勒 | bilbrough
昂布赖特 | 昂布里特 | umbreit
布劳恩 | 布朗 | browne
凯加 | 凯加鲁 | caegarw
赫沃斯 | 休沃斯 | huvos
勒热 | 利热 | leasure
萨姆斯特格 | 扎姆斯塔格 | samstag
贾格斯 | 贾格尔斯 | jaggers
格伦巴克 | 格伦巴赫 | grumbach
凯斯 | 基斯 | keys
萨基纳 | 萨金娜 | sakinah
勒福恩 | 勒方 | lefaune
拉丰 | 拉夫肖恩 | rafshoon
贝曼 | 比曼 | beman
西费特 | 索伊弗特 | seufert
斯特里文斯 | 斯特雷文斯 | strevens
斯坦纳姆 | 斯塔纳姆 | stanham
阿克申 | 埃克申 | action
迈因沙因 | 梅恩沙因 | maienschein
桑兹 | 桑德斯 | sondes
穆普森 | 马普森 | mupson
埃尔 | 埃尔勒 | ehrle
勒克赫斯特 | 卢克赫斯特 | luckhurst
卡罗尔 | 卡萝尔 | carole
埃丁杰 | 埃丁格 | edinger
德维尔 | 德韦尔 | deveulle
麦高兰 | 麦戈兰 | mcgauran
登帕萨 | 登帕西 | dempasay
法尔康布里奇 | 福尔肯布里奇 | falconbridge
马库斯 | 马克斯 | marcuss
格林斯特德 | 格林斯蒂德 | grinstead
内奇曼 | 纳奇曼 | nacheman
莱因德斯 | 莱因德尼斯 | rhindness
米多斯 | 梅多斯 | meadows
帕德西 | 帕齐 | pudsey
塞尔诺维奇 | 切尔诺维奇 | cernovitch
奈斯利 | 尼斯利 | knisely
尼科拉迪斯 | 尼古拉迪斯 | nikolaidis
芒尼克休森 | 芒尼克海森 | munnikhuysen
奇尔德 | 蔡尔德 | child
朱科维茨 | 尤尔科维茨 | jurkowitz
鲁宾斯坦 | 鲁本斯坦 | rubenstein
谢伊 | 舍韦 | schewe
麦金金 | 麦克琼金 | mcjunkin
拉比特 | 拉贝 | rabet
吉格雷 | 吉格尔 | giguere
麦克法迪安 | 麦克法迪恩 | mcfadyean
卢内德 | 莉内德 | luned
乔莫 | 肖莫 | chomeau
科克兰 | 科克伦 | cochrane
莫尔霍尔特 | 莫霍尔特 | molholt
阿加西亚 | 阿加西娅 | agacia
梅佩尔 | 马佩尔 | mapel
克里茨 | 克赖茨 | crites
奥瑟顿 | 奥尔瑟顿 | altherton
布兰特里 | 布伦特里 | braintree
钱伯尔辛 | 钱伯辛 | chamberlsin
格青格 | 格青杰 | getsinger
欧耶特 | 艾尔薇特 | irvette
艾舍伍德 | 伊舍伍德 | isherwood
德尼奥 | 迪奈欧 | denio
基尔 | 基利 | kille
奥西内尔 | 奥塞内尔 | othenel
坦迪恩 | 坦丁 | tandien
马尼奥利亚 | 马格诺利娅 | magnolia
埃莱斯米尔 | 埃尔斯米尔 | ellesmere
戴西 | 黛西 | daisy
戈迪夫 | 戈德夫 | godefe
沃塞姆 | 沃特海姆 | wertheim
蒙泰罗 | 蒙蒂罗 | monteiro
克里斯特高 | 克里斯戈 | christgau
奥科因 | 奥库安 | aucoin
休尔塔 | 许尔塔 | huerta
彼得罗 | 佩特罗 | petro
诺阔伊 | 诺基 | norquoy
马克厄姆 | 梅卡姆 | makeham
希肯洛普 | 希肯卢珀 | hickenlooper
巴尔塔萨 | 巴尔塔泽 | baltassar
杜克 | 杜凯 | duque
安弗丽德 | 安弗里德 | amfrid
弗利金格 | 弗利金杰 | flickinger
泽比纳 | 泽拜纳 | zebina
布拉 | 布劳 | blough
格拉斯戈 | 格拉斯哥 | glasgow
赫钦格 | 赫金杰 | hechinger
斯梅 | 斯梅奇 | smaje
奥利文特 | 奥利万特 | ollivant
戈洛文科克 | 戈洛夫琴科 | golovchenko
布利肯施塔夫 | 布利肯斯塔夫 | blickenstaff
麦克莱莫尔 | 麦克勒莫尔 | mclemore
德布勒勒 | 德布鲁勒 | debruler
麦克费德兰 | 麦克费德伦 | macphedran
奥迪吉尔 | 奥迪吉耶 | audigier
赫蒙 | 哈蒙 | hummon
伯特胡德 | 伯绍德 | berthoud
阿尔卡尔德 | 阿尔卡德 | alcalde
比奥利 | 比利 | beoley
古比托希 | 古比托西 | gubitoshi
达尔维奇 | 达利奇 | dulwich
格罗塞特 | 格罗斯泰特 | grosseteste
弗雷尔 | 弗雷耶 | freyere
斯康菲尔德 | 舍恩菲尔德 | schonfield
斯托尔夫曼 | 施托尔普曼 | stolpman
米丁 | 梅丁 | medin
弗兰普欣 | 弗兰普申 | framption
博雷特 | 博里特 | borrett
迈克尔约翰 | 米克尔约翰 | meiklejohn
拉肯米耶 | 拉肯米尔 | lackenmier
菲奇姆 | 费克姆 | feachem
拉坎帕涅 | 拉康帕涅 | lacampagne
索维奇 | 索瓦热 | sauvage
赫曼 | 赫尔曼 | herman
古布尔曼 | 古贝尔曼 | gubelmann
科帕德 | 科珀德 | coppard
斯塔尔斯 | 斯泰尔斯 | stares
埃尔齐 | 埃尔扎伊 | elzay
韦格索 | 维格索 | vegso
索尔韦因 | 索尔温 | sauerwein
巴思 | 巴特 | barthe
埃斯科菲 | 伊斯科菲 | escoffey
吉利亚姆 | 吉列姆 | gilliam
皮埃雷 | 皮埃尔 | pierre
博施威茨 | 博希威茨 | boschwitz
哈德格里 | 哈迪格里 | hardegree
弗利特拉夫特 | 弗利特克拉夫特 | flitcraft
皮尔 | 珀尔 | pearl
洛西安 | 洛西恩 | lowthian
多姆詹 | 多米扬 | domjan
阿巴斯特尼亚 | 阿巴斯蒂尼亚 | abastenia
阿利斯 | 阿莱斯 | allies
海泽 | 哈伊泽 | huyser
科米格 | 康马杰 | commager
卡拉佩蒂安 | 卡拉佩琴 | carapetyan
布里宁 | 布赖宁 | bryning
格利多尔 | 格利德尔 | gleadall
麦基恩 | 麦克钦 | mccheane
克拉布里 | 克拉布特里 | crabtree
埃里特 | 埃雷特 | ehret
特洛 | 特略 | tello
博特塞特 | 博塞特 | botset
托尔梅奇 | 塔尔梅奇 | tallmadge
威克斯蒂德 | 威克斯第德 | wicksteed
斯科格伦 | 斯科格隆 | skoglund
温塔尔 | 温特尔 | weintal
杰夫 | 贾菲 | jaffe
斯塔姆 | 施塔姆 | stamm
法扎 | 法扎尔 | fazar
萨西妮 | 萨西尼 | sassienie
马塞尔 | 玛塞勒 | marcelle
尤因斯 | 尤温斯 | uwins
海利 | 希利 | hiley
乌列维奇 | 乌莱维奇 | ulevich
康尼利 | 康奈利 | conneally
勒肯 | 卢肯 | lukken
马顿 | 梅顿 | maton
希拉 | 夏伊拉 | shyla
比恩 | 比汉 | beehan
法尔肯海姆 | 福尔肯海姆 | falkenheim
雷金纳 | 雷金纳德 | reginald
巴特斯 | 巴特雷斯 | batres
厄普沙尔特 | 厄普舒尔特 | upschulte
洛恩 | 洛温 | lowen
贝默赛德 | 比默赛德 | bemersyde
米姆诺 | 明诺 | mimno
布平达 | 布平达尔 | bhupindar
罗明 | 罗梅因 | romeyn
扬古斯班德 | 扬哈斯本 | younghusband
夏皮 | 沙比 | sharpey
莱西奇 | 勒萨热 | lesage
杰普瑟 | 杰普撒 | jeptha
巴布利斯 | 布勃利斯 | bublys
辛皮克 | 辛皮奇 | simpich
塞德福 | 塞德福德 | thedford
伯特霍夫 | 伯索夫 | bertholf
舒特尔夫 | 舒特莱夫 | shurtleff
斯波特德 | 斯波蒂德 | spotted
乔齐 | 乔茜 | jozy
黛安 | 戴安 | dian
莱齐尔 | 拉齐尔 | lazear
夏尼耶 | 钱尼尔 | channier
劳克霍夫 | 劳卡夫 | laukhuff
米尔希 | 米尔海 | milhy
卡德根 | 卡杜根 | cadwgan
博希尔 | 博舍尔 | boshier
博维 | 博韦 | bovee
赫克顿 | 赫克通 | hektoen
莱维 | 利瓦伊 | levi
纳撒奈尔 | 纳撒内尔 | nathanael
克里 | 克雷 | crea
乔尔万 | 朱尔万 | joulwan
卡佐克雷亚 | 库佐克雷亚 | cuzzocrea
克拉茨 | 克卢茨 | clutz
阿德基森 | 阿基森 | adkisson
施莱 | 施利 | schlie
伊菲根 | 伊菲吉妮 | iphigene
泰菲恩 | 泰维恩 | teifion
亚历克西斯 | 亚历克西丝 | alexys
本亚明 | 本杰明 | benjamin
拉罗姆 | 拉勒姆 | larom
坎帕恩 | 坎佩恩 | campaigne
古茨怀勒 | 古茨维勒 | gutzwiller
勒金 | 勒德金 | ludgin
阿尔皮娜 | 阿尔皮纳 | alpina
韦雷尔 | 沃雷尔 | werrell
福尔兹 | 福尔茨 | folz
德福德 | 德福特 | deford
博比萨德 | 博比苏德 | bobisud
图尔 | 特尔 | tourle
图利特 | 塔利特 | tulett
斯塔克 | 斯图克 | stucke
尚伯格 | 舍恩伯格 | schonberger
兰贝利特 | 兰伯利特 | lambelet
盖 | 贾伊 | gye
利奇滕斯坦 | 利克滕斯坦 | liechtenstein
安德鲁斯凯维奇 | 安德鲁斯克维奇 | andruskevich
托德雷斯 | 托德雷亚斯 | todreas
比 | 布埃 | bue
奥尔钦 | 阿尔钦 | alchin
阿维斯 | 阿维丝 | aveis
黑吉斯 | 海吉斯 | haigis
斯卡珀罗 | 斯卡佩罗 | scarpero
阿伦 | 阿龙 | aaron
马克斯 | 马尔库斯 | malkus
齐昂 | 蔡恩 | zion
格尔巴赫 | 盖尔博 | gelbach
卢夫特 | 勒夫特 | luft
布雷克兰 | 布里克兰 | brekland
布瓦拉 | 布阿哈拉 | buachalla
沃尔克 | 沃克 | walke
考特尼 | 考特妮 | kourtney
凯尔 | 屈尔 | kuehl
麦克雷迪 | 麦克拉迪 | mccrady
比利埃 | 比埃 | billiere
埃尔杰 | 埃尔格 | elger
曼恩 | 曼 | mann
施纳克 | 施努克 | schnuck
普钦斯基 | 普辛斯基 | pucinski
赛奇 | 西奇 | sich
尼科利 | 尼古拉 | nicolay
塔图利斯 | 塔图尔斯 | tatooles
威尔茜 | 威尔西 | willsie
弗雷塔格 | 弗赖塔格 | freytag
撒尔肯 | 萨尔肯 | thalken
基米特 | 金米特 | kimmitt
赖津 | 里津 | ryzin
库德韦尔 | 库尔德韦尔 | couldwell
伯娜 | 伯纳 | berna
索利兹 | 索莱 | saulez
斯坦齐克 | 斯坦奇克 | stanczyk
布莱琴登 | 布莱钦登 | blechynden
巴托尔缪 | 巴托洛缪 | bartholemeu
西克 | 瑟克 | cirker
恩德科特 | 恩迪科特 | endecott
阿尔文 | 阿尔温 | alwin
拉索姆 | 莱瑟姆 | lathom
霍伊塞尔 | 休塞尔 | heusel
莱夫勒 | 莱弗拉尔 | leflar
罗萨佩普 | 罗萨皮普 | rosapepe
赫宁伯格 | 赫宁堡 | heningburg
盖泽 | 盖瑟 | gaisser
巴萨德 | 巴萨德雷 | basadre
福伊尔泽格 | 福伊尔齐格 | feuerzeig
派约特 | 派奥特 | pyott
塞勒斯 | 塞拉斯 | sellars
梅勒普斯 | 梅拉普斯 | mellups
马拉赫 | 马拉克 | malach
巴尔西格 | 巴尔西杰 | balsiger
希拉伯 | 希莱伯 | shillaber
胡马森 | 赫马森 | humason
斯特费斯 | 斯特弗斯 | steffes
卡斯特尔伯里 | 卡斯尔伯里 | castelberry
吉尔鲍 | 吉尔博 | guillebaud
贝谢特 | 贝谢 | bechet
梅利奥尔 | 梅莉奥尔 | melior
鲁马塞特 | 罗马塞特 | roumasset
克奇弗 | 克切弗 | kerchever
卡迪内尔 | 卡迪纳尔 | cardinale
比阿特丽夏 | 比阿特丽西娅 | beatricia
福弗 | 福法 | forfar
梅纽欣 | 梅纽因 | menuhin
菲阿尔卡 | 菲亚尔卡 | fialka
伊萨科 | 伊萨科夫 | isakow
克伦西克 | 赫伦奇克 | chrencik
彭沃尔特 | 佩恩沃尔特 | pennwalt
库塞维茨基 | 科乌谢维茨基 | koussevitzky
米尼奥 | 米内奥 | mineo
布勒宁 | 布罗宁 | broening
伊尔特德 | 伊尔蒂德 | illtud
弗罗伊斯 | 弗勒泽 | froese
阿什利 | 阿什莉 | ashleigh
弗拉赫蒂 | 弗莱厄蒂 | flaherty
诺克斯 | 努克斯 | nokes
恰鲁奇 | 基亚鲁奇 | chiarucci
图尔默 | 瑟默 | thuermer
汉奇 | 汉格 | hange
舍格尔斯 | 舍加尔斯 | shergals
安贝卡 | 安贝德卡 | ambedkar
杜克诺伊 | 迪克努瓦 | duquenoy
斯托齐 | 斯托西 | stosy
托里约斯 | 托里霍斯 | torrijos
柯克 | 基尔舍 | kircher
斯托岑巴赫 | 斯托曾巴赫 | stolzenbach
马德里德 | 马德里 | madrid
唐恩 | 唐 | donn
凯特尔比 | 基特尔比 | ketelbey
怀甘特 | 威甘特 | wygant
博弗里 | 博韦里 | boverie
洛伦曾 | 洛伦岑 | lorenzen
阿莱格拉 | 阿利格拉 | allegra
阿姆谢伊茨 | 阿姆谢维茨 | amshewitz
赖克沃特 | 里克沃特 | rykwert
奥法雷尔 | 奥法雷 | o'farrell
卢宁 | 吕宁 | luening
特金 | 图尔金 | turkin
西尔里 | 蒂里 | thierry
乔西 | 约瑟 | josee
施赖伯 | 施里伯 | shriber
迈斯兰 | 迈斯拉恩 | meislahn
利昂内尔 | 莱昂内尔 | lionel
高因 | 高英 | gowing
亨尼卡特 | 亨尼克特 | hunnicutt
本尼 | 贝恩 | benne
科斯 | 库斯 | coes
维尼斯 | 维内斯 | veness
哈希克布罗克 | 哈维克斯布罗克 | hawixbrock
冈希利 | 贡希利 | goonhilly
哈里尔 | 哈丽尔 | harriel
奎恩 | 奎因 | queen
塞塞尔 | 塞斯尔 | sessel
阿尔西夫龙 | 阿尔西弗龙 | alciphron
达纳根 | 杜纳根 | dunagan
特雷西 | 特蕾西 | tracey
若克 | 吉奥克 | giauque
库蒂斯 | 柯蒂斯 | kurtis
埃尼德 | 伊妮德 | enid
萨金特 | 瑟金特 | searjeant
拉金 | 莱金 | laging
尚伯格 | 舍恩伯格 | schonberg
米特塞夫 | 米采夫 | mitseff
范格 | 范杰 | fanger
布兰肯 | 布兰昌 | blanchan
霍尔迪曼德 | 哈尔迪曼德 | haldimand
吉利亚姆斯 | 吉利亚姆 | guilliams
多奇 | 道奇 | dodge
米莉娅 | 米利亚 | melia
斯威恩 | 斯温 | sween
弗赖赖克 | 弗赖雷克 | freireich
菲克 | 费克 | feake
戈梅兹普拉塔 | 戈梅斯普拉塔 | gomezplata
布尔热奥斯 | 布儒瓦 | bourgeois
安东尼奥 | 安东尼乌 | antoniou
奥利瓦雷兹 | 奥利瓦雷斯 | olivarez
罗伊巴尔 | 罗伊鲍尔 | roybal
布什休夫 | 布舒夫 | bushueff
萨吉特里厄斯 | 萨吉泰里厄斯 | sagittarius
比克 | 贝克 | beek
雷诺尔德 | 伦瓦尔 | renouard
希拉斯 | 希勒斯 | heelas
卡尔德克卢 | 考尔德克拉夫 | caldcleugh
克拉格 | 克莱格 | clague
贾西纳 | 杰西纳 | jacyna
切希尔 | 切斯希尔 | chesshyre
朗斯伯格 | 劳恩斯伯格 | lounsburg
布雷钦 | 布里金 | brechin
古德拉姆 | 古德哈姆 | gooderham
巴尔恩 | 鲍恩 | balne
希普 | 霍伊普 | heup
博尔苏克 | 博苏克 | borsook
希曼娜 | 希曼纳 | sheemanna
阿德查尼奇 | 阿德查尼克 | ardcharnich
贝迪利恩 | 贝迪利翁 | bedillion
史密思 | 史密斯 | smyth
赖道特 | 赖德奥特 | rideout
麦考斯兰 | 麦考斯伦 | mcauslan
尼思代尔 | 尼斯代尔 | nithsdale
布卢顿 | 布勒顿 | blurton
马蒂奥 | 马泰奥 | matteo
多罗西 | 多萝西 | dorothy
斯塔宾 | 斯图宾 | stubbing
奥尔弗森 | 阿尔弗森 | alverson
索洛泰斯 | 索尔特斯 | solotesz
坎普施勒 | 坎普施罗尔 | kampschror
布姆斯特德 | 巴姆斯特德 | bumstead
伦 | 莱恩 | len
德马特奥 | 德马尔托 | desmarteau
谢尔普 | 谢普 | shairp
伯兹尔 | 伯塞尔 | birdsell
索恩代克 | 桑代克 | thorndike
马沙姆 | 马香 | marsham
奥伯赫尔曼 | 奥伯黑尔曼 | oberhelman
帕特里亚赫 | 佩特里亚克 | patriach
海内曼 | 海涅曼 | heinemann
里查兹 | 理查兹 | richards
艾奇森 | 艾奇逊 | eytchison
布里安特 | 布赖恩特 | briant
丹纳伊瑟 | 丹罗伊特 | dannreuther
巴恩比 | 巴恩贝 | barnebey
梅林达 | 梅琳达 | melinda
弗伦泽 | 弗伦策 | frenzer
康西尔 | 康斯尔 | council
沙因鲍姆 | 欣鲍姆 | sheinbaum
泰雷 | 泰里 | tyree
尚顿 | 桑顿 | szanton
费布里克 | 法布里克 | fabrick
戈尔德伯勒 | 戈德伯勒 | goldborough
克罗齐尔 | 克罗泽 | crozier
沃雷尼厄斯 | 瓦拉尼厄斯 | waranius
赫马尼厄克 | 赫马纽克 | hermaniuk
埃尔万 | 埃尔温 | elwane
巴塔格尔 | 巴塔杰尔 | battagel
埃尔沃克 | 埃厄克 | earwaker
格林达尔 | 格林德尔 | grindal
科罗希尔 | 科罗西尔 | koroscil
西弗林豪斯 | 塞夫林豪斯 | sevringhaus
雅科特 | 贾科泰 | jacottet
富奇略 | 富奇洛 | fuccillo
布里利 | 布里厄利 | brealey
麦考谢奈格 | 麦科尚奈格 | maco'shannaig
费西克 | 法西克 | fasick
麦克廷格 | 马赫廷格 | machtinger
内内曼 | 南尼曼 | nenneman
希博尔德 | 赫博尔德 | hebald
梅比 | 梅布 | mabe
马米特 | 马梅特 | mamet
卡塞尔 | 卡瑟尔 | cuthell
迪尤斯 | 德威斯 | dewees
基茨哈伯 | 基察伯 | kitzhaber
布雷齐尔 | 布雷热 | brazier
斯密亚利克 | 斯米亚利克 | smialek
芬尼 | 菲尼 | phinney
奥尔迪 | 阿尔迪 | alday
阿曼德斯 | 阿曼达斯 | amandus
哈洛兰 | 哈洛伦 | halloran
赛纳 | 西纳尔 | synar
康乔拉尔 | 康科勒 | concholar
卢娜 | 卢纳 | luna
德莱奥 | 德利奥 | deleo
朔勒 | 朔伊勒 | scheuler
特鲁曼 | 杜鲁门 | truman
惠伦 | 惠兰 | whelan
达奇 | 达基 | dachi
拉思 | 雷思 | rathe
哈尔巴克 | 哈尔巴赫 | halbach
鲁特 | 鲁尔特 | rurt
赫利 | 赫尔利 | hurleigh
克罗嫩贝格 | 克罗嫩伯格 | kronenberg
乌斯顿 | 奥斯顿 | ouston
克里奇顿 | 克赖顿 | crichton
格威内德 | 格威内思 | gwynedd
布奇 | 布谢 | bouchey
鲍厄尔斯 | 鲍威尔斯 | powels
罗雷姆 | 罗勒姆 | rorem
沃蒂尔 | 沃捷 | vautier
安德里欧 | 安德里厄 | andrieux
阿莱恩 | 阿林 | alleine
怀索茨基 | 维索茨基 | wysocki
杰萨普 | 杰瑟普 | jesup
比弗 | 贝弗 | bever
扎奇曼 | 扎克曼 | zachmann
海斯洛普 | 希斯洛普 | hyslop
斯马尔皮斯 | 斯莫尔皮斯 | smallpeice
希尼 | 赫尼 | henie
唐西娅 | 唐西亚 | donsia
杜克罗 | 迪克罗 | ducrow
沃尔克 | 沃克 | walk
沃尔克 | 沃克 | walker
麦迪森 | 麦迪逊 | madison
麦科拉姆 | 麦科勒姆 | mccollam
斯坦达洛夫特 | 斯坦德洛夫特 | standaloft
德沃查克 | 德沃夏克 | dvorchak
科克伦 | 库格伦 | coughran
多克特 | 多克托 | docktor
弗朗斯 | 弗朗西斯 | fraunces
法伊恩 | 法林 | filene
巴戈 | 巴戈特 | bagot
希尔茨 | 希尔兹 | shields
塞门扎 | 西门扎 | semenza
哈森富斯 | 哈森弗斯 | hasenfus
彼得龙 | 佩特龙 | petrone
格里桑蒂 | 格里桑迪 | grisanti
梅尔斯 | 马雷斯 | mares
阿尼林 | 阿内林 | aneirin
冈利 | 高恩利 | gownley
阿图鲁斯 | 阿图罗斯 | arturous
布兰肯巴克 | 布兰肯贝克 | blankenbaker
阿迪莫拉 | 阿德莫拉 | ademola
拉拉比 | 拉勒比 | larabee
埃斯坎达里安 | 伊斯坎达里安 | eskandarian
贾洛雷齐 | 贾洛伦齐 | giallorenzi
特穆多 | 塞穆多 | themudo
科尔奎特 | 科尔基特 | colquitt
蒙莫尼耶 | 蒙莫尼尔 | monmonier
贝松 | 贝森 | bessone
塞科夫斯基 | 赛科夫斯基 | saikowski
塞格雷夫 | 西格雷夫 | segrave
休德代尔 | 舍代尔 | suirdale
哈莫尔 | 哈默 | hamor
博索沃思 | 博索姆沃思 | bosomworth
普佩 | 普珀 | puppe
施米德 | 施密德 | schmid
黑尔 | 海尔 | haire
哈克威尔 | 黑克威尔 | hakewill
冈萨莱兹 | 冈萨雷斯 | gonzalez
莫纳 | 莫娜 | mona
格雷恩 | 格兰妮 | grainne
布拉兹特里特 | 布拉德斯特里特 | bradstreet
库米什 | 卡米什 | cumish
麦克斯蒂芬 | 麦克斯蒂奥芬 | macstiofain
亚里莫维奇 | 雅里莫维奇 | yarymovych
塞尼奥尔 | 西尼尔 | senior
哈特西德 | 哈齐德 | hartsid
博伊斯拉根 | 博勒根 | boisragon
雷伯特 | 雷巴特 | rebut
索热 | 索热尔 | saussure
费里比 | 费尔比 | ferebee
科克森 | 考克森 | coxon
斯克鲁塔托 | 斯克鲁泰特 | scrutator
格里泽 | 格赖泽 | griser
哈兹利普 | 黑兹利普 | hazelip
迪文 | 德文 | deven
贝兰尼娅 | 贝拉尼亚 | berania
许尔霍尔兹 | 许霍尔茨 | schuerholz
肖凯尔 | 肖基尔 | showkeir
科尔赫普 | 科尔黑普 | kohlhepp
杰里什 | 格里什 | gerrish
鲁奥科 | 罗科 | ruocco
巴齐莱 | 巴尔齐莱 | barzilay
加纳 | 加诺 | ganor
鲍德施威勒 | 巴尔德施维勒 | baldeschwieler
斯洛尼姆 | 斯洛宁 | slonim
珀塞克 | 佩塞克 | perseck
维伦 | 瓦伊伦 | viron
皮尔森 | 皮尔逊 | pirsson
索尔茨 | 肖尔茨 | soults
埃弗德 | 埃瓦德 | evvard
格鲁尔德 | 杰罗尔德 | gerould
耶格尔 | 耶格 | jaegher
赫雷肖夫 | 赫雷斯霍夫 | herreshoff
加弗 | 盖弗 | gaver
柯兰 | 柯伦 | curran
瓦伦休拉 | 巴伦苏埃拉 | valenzuela
肖尔斯 | 肖沃斯 | showers
阿格伍 | 阿古 | agwu
弗拉克斯 | 弗勒克斯 | flux
考斯利 | 库斯利 | cousley
索勒 | 索莱尔 | sohler
阿达曼 | 阿达姆南 | adamnan
林恩 | 林 | linn
德赖克 | 德里克 | driker
里查德 | 理查德 | richard
罗伯森 | 罗伯逊 | robertson
达肯 | 达坎 | dakan
吉特沙姆 | 吉彻姆 | gitsham
利夫沃克 | 莱夫奥克 | liveoak
普鲁斯曼 | 普拉斯曼 | prusman
基弗 | 凯弗 | keifer
吉恩 | 吉亨 | gehan
施努肯 | 施努克内 | schnukne
阿格尔 | 阿高尔 | argall
温纳斯特伦 | 温纳斯特鲁姆 | wennerstrum
卡布尔 | 凯布尔 | cable
利德克 | 利迪克 | luedecke
乔德 | 乔德尔 | jordre
普卢尼克 | 普伦尼克 | pluenneke
赫希特里特 | 赫什特里特 | hirschtritt
贝拉德 | 贝拉尔 | berard
道宁 | 唐宁 | downing
巴特伦 | 巴特拉姆 | battram
卡莉什 | 卡利什 | kalish
格丽索尼亚 | 格丽索戈尼娅 | grisogonia
豪瑟姆 | 豪萨姆 | howsam
科菲恩 | 科芬 | coffeen
迈伯格 | 迈伯勒 | myburgh
德沃尔金 | 德沃金 | dworkin
阿特尔西 | 阿特莱西 | attlesey
加格宁宾 | 加涅班 | gagnebin
阿克雷斯 | 阿克斯 | acres
布莱克施米特 | 布莱希施米特 | blechschmidt
赫维茨 | 赫威茨 | herwitz
克兰德 | 克兰 | kland
布卢克 | 布劳克 | blouke
梅明格 | 梅明杰 | memminger
德雷斯克 | 德赖斯克 | dreiske
马马杜克 | 马默杜克 | marmaduke
普赖尔 | 普里尔 | preil
奎伦 | 奎林 | quillen
贝思 | 贝丝 | beth
比霍尔特 | 伯霍尔特 | byrholdt
约赫 | 约埃 | yohe
恩格弗 | 恩弗 | engfer
亚特龙 | 亚特隆 | yatron
伊卡德 | 伊查德 | eachard
巴思利 | 布思莱 | buthlay
普伦蒂 | 普朗蒂 | prunty
普特曼 | 帕特曼 | putman
梅约拉斯 | 马约拉斯 | mayoras
埃夫莱 | 伊夫利 | evelegh
维西 | 维齐 | veysey
保伦蒂 | 波伦蒂 | pawlenty
沃尔斯托内克特 | 沃斯通克拉夫特 | wollstonecraft
法夫罗特 | 法夫罗 | favrot
阿曼 | 阿尔曼 | arman
阿德尼 | 埃德尼 | adney
莫勒诺尔 | 莫勒瑙尔 | mollenauer
斯凯尔斯 | 斯基尔斯 | skiles
芬维西 | 芬韦西 | fenvessy
帕赫 | 帕克 | pach
盖尔德 | 格尔德 | gelder
巴查尔 | 巴卡尔 | bachar
福达姆 | 福德姆 | fordham
加米特 | 加梅特 | gamet
雷蒂尤 | 雷图 | rettew
德利吉奥斯 | 德利乔治斯 | deligiorgis
加雷尔 | 加勒尔 | garel
奥尔 | 奥利 | ole
巴德温 | 布德温 | budwine
迪奥 | 戴奥 | dio
塞维尔 | 萨维尔 | savele
莱维 | 利维 | levie
格朗基 | 格朗茨基 | groncki
加康 | 加肯 | garcon
沃梅利 | 沃姆利 | wormeley
丹姆里奇 | 德姆里克 | daemmrich
肖尔德勒 | 斯科德勒 | scholderer
杜比 | 达比 | duby
贝尔比 | 比尔比 | beilby
博斯金德 | 博斯坎德 | boskind
纽内梅克 | 努尼梅克 | nunemaker
阿尼斯 | 安妮斯 | anis
阿布林 | 埃布林 | ablin
班德 | 班德尔 | bander
罗萨尔 | 罗塞尔 | rossall
谢德 | 沙德 | shad
埃奇逊 | 艾奇逊 | etcheson
福塞特 | 福西特 | fawssett
格迪 | 吉迪 | giddy
阿蒂耶 | 阿提耶 | atiyeh
伦芬特 | 朗方 | lenfant
尤夫罗辛 | 尤弗罗西尼 | euphrosyne
里奥赫 | 里奥克 | reoch
艾亚拉 | 阿亚拉 | ayala
佩特里兹 | 佩特里迪斯 | petrides
科德尔 | 科德 | corder
戴文 | 达文 | davern
罗莎娜 | 罗珊 | rozanne
洛格 | 洛奇 | lorge
格林霍 | 格里诺 | greenhow
埃利娜 | 埃琳娜 | elena
杜尤 | 杜韦 | duwe
布雷德 | 布里德 | breder
萨韦尔 | 萨维尔 | savelle
麦加恩 | 麦加亨 | mcgahern
利班 | 莱班 | leban
穆拉尔特 | 缪拉尔持 | muralt
萨洛姆 | 萨洛米 | salome
玛丽萨 | 马里萨 | marisa
肖纳 | 肖娜 | shauna
布尔廷豪斯 | 博尔廷豪斯 | boultinghouse
尤金妮娅 | 尤金妮亚 | eugenia
梅德瓦多斯基 | 梅德瓦多夫斯基 | medwadowski
希厄特 | 海厄特 | hieatt
科德尔 | 科格德尔 | cogdell
惠奇利夫 | 惠特克利夫 | whitchliffe
吉弗里达 | 朱弗里达 | giuffrida
怀森 | 威森 | wison
奥利夫 | 奥利芙 | olive
德夫尼 | 迪夫尼 | deveney
海姆索特 | 海姆塞特 | heimsoth
康斯托克 | 科姆斯托克 | comstock
埃格特 | 埃格伯特 | egbert
塔利亚费罗 | 托利弗 | taliaferro
威廉德 | 威尔海德 | wilhide
莱塞特 | 莱西特 | lycett
莱根 | 利根 | lygon
奥利克西 | 奥莱克休 | oleksiw
阿莱斯 | 阿莱 | allez
卡德瓦拉迪 | 卡德瓦拉德 | cadwaladyr
里代尔 | 里迪尔 | rideal
萨尔温 | 西尔温 | sulwen
法迪安 | 法迪恩 | fadyean
伯克隆 | 伯克伦 | berklund
拜萨特 | 比萨特 | bisat
德雷南 | 德雷宁 | drennen
德彻 | 德谢尔 | decher
巴特伦 | 巴特拉姆 | buttram
特鲁齐 | 特拉齐 | truzzi
阿布迪安 | 阿布迪恩 | abdian
托里 | 托丽 | tori
卡里洛 | 卡里略 | carrillo
比比 | 毕比 | beeby
马特纳 | 马塞纳 | marthena
凯莉 | 卡利 | cali
盖滕拜因 | 盖滕宾 | gaitenbein
