布雷金里奇 | 布雷肯里奇 | breckinridge
塞德 | 切德 | cedd
梅莉 | 马利 | maly
阿西尼加 | 阿西涅加 | arciniega
霍普特 | 豪普特 | houpt
斯特拉西恩 | 斯特拉森 | strathearn
派珀特 | 佩珀特 | peipert
皮内 | 皮奈 | pinay
梅雷斯曼 | 米尔斯曼 | meresman
弗兰岑 | 弗兰曾 | franzon
埃切费斯特 | 埃沙韦斯特 | echaveste
费尔伯恩 | 费尔贝恩 | fairbairn
米尔黑德 | 缪尔黑德 | muirhead
索普 | 肖普 | shoupp
芒斯巴克 | 蒙斯巴克 | maunsbach
沃塞尔 | 瓦塞尔 | wassell
西金特 | 萨金特 | seargent
基布勒 | 库布勒 | kuebler
杰米玛 | 杰迈玛 | jemima
海 | 希 | hie
莫迪特 | 莫德维 | mauduit
惠塔克 | 惠特克 | whitacre
艾特 | 艾厄特 | eyet
耶德利 | 亚德利 | yeardley
博比 | 鲍比 | bobbie
麦基尔文纳 | 麦基尔温纳 | macilvenna
莱因斯 | 赖恩斯 | rines
麦克费伦 | 麦克弗伦 | mcpherren
埃德霍赫 | 埃德尔霍克 | edelhoch
博特尔 | 博索尔 | botsal
科尔雷恩 | 科尔雷因 | coleraine
科克拉姆 | 科克勒姆 | cockrum
瓦恩 | 韦恩 | wagne
多特曼 | 多伊特曼 | deutermann
厄德曼 | 厄尔德曼 | erdman
戈伦贝夫斯基 | 戈伦别夫斯基 | golembiewski
布罗因 | 布罗林 | brorein
查尔迪 | 恰尔迪 | ciardi
格雷戈尔 | 格雷瓜尔 | gregoire
迈卡亚 | 迈凯亚 | micajah
科梅罗夫 | 科梅萨罗夫 | komesaroff
雷梅克斯 | 拉马克斯 | raemakers
拜伦森 | 贝伦森 | beilenson
皮凯弗 | 皮卡弗 | piccaver
苏布林 | 萨布林 | subrin
福图内多 | 福图纳多 | fortunado
斯克拉顿 | 斯克鲁顿 | scrutton
费尔本 | 费尔伯恩 | fairburn
津南 | 津宁 | zinnen
佩莱蒂尔 | 佩尔蒂埃 | pelletier
帕塞尔 | 帕斯尔 | parcel
霍诺里 | 霍诺丽 | honori
艾米希 | 伊梅施 | imesch
埃尔滕黑德 | 埃尔顿黑德 | eltonhead
西明顿 | 赛明顿 | symington
布龙海姆 | 布朗海姆 | bronheim
马霍尔特 | 玛奥 | mahault
法伊克 | 菲克 | fike
奥德斯 | 奥杜斯 | audus
加布尔 | 加伯 | gabbour
韦赫特尔 | 瓦赫特尔 | wachtel
维莉 | 瓦利 | valee
塔利亚里福 | 塔利亚费罗 | tagliaferro
舒格 | 沙格 | shugg
夏维尔 | 希维尔 | shivell
马基南 | 马基嫩 | makinen
拉凯斯 | 拉雪兹 | lachaise
达维格多 | 达维多尔 | d'avigdor
哈巴德 | 哈伯德 | hubbard
曼纳韦 | 马纳韦 | mannaway
韦迪斯科 | 弗迪斯科 | verdisco
艾佐德 | 伊佐德 | izod
托马 | 托伊马 | teuma
奥赫 | 奥 | ough
阿富蒂特 | 阿富尔蒂特 | affourtit
米萨埃尔 | 米赛尔 | misael
赫默里赫 | 亨默里克 | hemmerich
詹宁斯 | 杰宁斯 | jenyns
弗里霍夫 | 弗里德霍夫 | friedhoff
斯坦姆斯 | 斯泰姆斯 | stames
文恩 | 维恩 | venn
安瓦里珀 | 安瓦里普尔 | anvaripour
坎妮夫 | 坎尼夫 | cunniffe
比比 | 毕比 | beebe
考尔德尔 | 考德尔 | caldell
博查特 | 博哈特 | borchardt
卡明 | 卡迈恩 | carmine
巴特伦 | 巴特拉姆 | bartram
佩尔 | 皮尔 | peile
麦康 | 麦肯 | mccon
坦塔基斯 | 坦巴基斯 | tambakis
麦卡里 | 麦凯里 | mccarey
克雷翁 | 克雷恩 | crayon
英万特 | 因方特 | infant
杰罗尔 | 杰拉尔 | gerall
亨内肯斯 | 亨尼肯斯 | hennekens
贾弗 | 贾埃弗 | giaever
贾米 | 杰米 | jamie
鲍尔霍恩 | 巴尔霍恩 | ballhorn
斯廷菲尔德 | 斯廷奇菲尔德 | stinchfield
斯特热斯 | 斯特奇斯 | sturges
莫克萨姆 | 莫克塞姆 | moxam
卡姆 | 卡尔姆 | culme
比克姆 | 比卡姆 | bickham
夏尔曼 | 沙伊尔曼 | shireman
梅索利 | 梅索伊 | meszoly
福伊希特万 | 福伊希特万格 | feuchtwanger
格格拉德 | 古格拉德 | ghugrad
埃森斯 | 埃森丝 | essence
格沃思米 | 格瓦思米 | gwathmey
巴比罗利 | 巴尔比罗利 | barbirolli
利布 | 利比 | luebbe
黑泽尔 | 黑兹尔 | hazell
施蒂宁 | 斯蒂宁 | stiening
克莱农 | 克勒农 | clernon
金德雷德 | 金德里德 | kindred
德鲁夫 | 德鲁伊夫 | druiff
纳索尔 | 纳托尔 | nuthall
佐扎 | 佐尔扎 | zorza
戴格 | 戴伊 | daigh
埃坦 | 埃泰恩 | etain
德尔里戈 | 德尔列戈 | delriego
巴策 | 巴策尔 | batzer
廷肯 | 廷康 | tinkon
德弗雷茨 | 迪弗雷特斯 | defrates
尤勒姆 | 乌拉姆 | ulam
沙德伯格 | 谢德伯格 | schadeberg
比沃特 | 拜沃特 | bywater
米恩斯 | 默恩斯 | mearns
格罗布 | 格罗比 | grobe
塔塔利诺 | 塔尔塔利诺 | tartaglino
兰姆 | 拉姆 | lambe
考德韦尔 | 考德威尔 | caldwell
坎特伯里 | 坎特伯雷 | canterbury
塔肯 | 泰肯 | tacon
基尔施 | 基尔希 | kirsch
弗森 | 费尔森 | ferson
托皮 | 托毕 | torpey
洛多维克 | 洛多威克 | lodowicke
梅拉尼 | 梅拉妮 | melanie
泰奇曼 | 泰克曼 | teichmann
普鲁德霍姆 | 普鲁多姆 | prudhomme
基斯特纳西姆 | 基斯特纳萨米 | kistnasamy
坎比 | 坎贝 | cumbey
赫姆尔 | 赫姆利 | hermle
蒙根 | 蒙贡 | mongon
亨佩尔 | 亨普尔 | hempel
艾罗 | 艾罗尔特 | ayrault
里亚 | 雷 | rea
梅科雷拉 | 默科雷拉 | mercorella
布赖登索尔 | 布赖登塔尔 | breidenthal
德卢吉 | 德路易吉 | deluigi
科希雷斯 | 科克里斯 | cocheres
霍斯伯格 | 霍斯伯勒 | horsburgh
鲁德 | 鲁阿兹 | ruadh
格雷思黑德 | 格雷特黑德 | greathead
巴斯基特 | 巴斯克特 | baskette
马尔特比 | 莫尔特比 | maltby
埃塞雷达 | 埃塞丽达 | ethelreda
巴特韦尔 | 贝特韦尔 | batewell
迪恩娜 | 迪恩纳 | dienna
博里尔 | 博雷尔 | boreel
布雷洪 | 布里恩 | brehon
盖尔 | 圭尔 | guire
尤丘克 | 尤尔丘克 | yurchuck
坦尼肯 | 滕尼肯 | tennican
科佩斯蒂克 | 科普斯蒂克 | copestick
利文 | 莱文 | levene
朱林科 | 祖林科 | dzurinko
索茹纳 | 索杰纳 | sojourner
克努贝尔 | 努贝尔 | knubel
卡诺肯 | 卡诺坎 | carnochan
吉诺 | 吉赫诺 | giheno
罗克辛 | 罗克西娜 | roxinne
伦塞拉尔 | 伦塞勒 | rensselaer
萨尼普 | 萨格尼普 | sagnip
伊登斯 | 埃登斯 | edens
詹米森 | 詹姆森 | jameson
古妮拉 | 古尼拉 | gunilla
比哈里尔 | 贝哈里尔 | beharriell
朗钱普 | 朗香 | longchamp
贝德纳斯基 | 贝德纳尔斯基 | bednarski
卡特切洛 | 卡特鲁费洛 | cutrufello
皮什 | 佩什 | peche
威尔怀特 | 威尔海特 | willhite
瓦德曼 | 沃德曼 | wurdemann
洛伦兹 | 洛伦茨 | lorenz
特普尔 | 蒂普尔 | tepoel
贾莫 | 贾伊莫 | giaimo
库尔吉安 | 库尔金 | kuljian
吉耶特 | 吉利特 | guillet
哈米利恩 | 哈米里恩 | hamilyon
基尔库西 | 基尔科西 | kilcoursie
纽布兰克 | 纽布兰奇 | newbranch
里森诺弗 | 里曾诺弗 | reasonover
查肯 | 查康 | chacon
里布沙门 | 里布萨门 | rebsamen
托菲亨 | 托菲肯 | torphichen
戈特尔斯 | 戈瑟尔斯 | goethals
黑特姆 | 哈特姆 | hatem
瓜尔蒂里 | 瓜尔蒂耶里 | gualtieri
科伊 | 考伊 | cowie
泽伦 | 齐伦 | zeran
比贝尔 | 比布尔 | biebel
奥尔兹蒂尔 | 奥尔德斯泰尔 | oldstyle
西门斯 | 西门子 | siemens
普利本 | 普利邦 | plybon
斯温斯鲁德 | 斯温斯拉德 | swensrud
贝克纳 | 比克纳 | beichner
恩戈姆 | 恩格霍姆 | engholm
惠特洛 | 怀特洛 | whytlaw
兰内伯格 | 兰恩伯格 | ranneberger
桑德威克 | 桑威克 | sandwick
怀思 | 韦思 | wyeth
施韦克希尔德 | 施韦柴尔德 | schweichild
斯坦霍普 | 斯坦诺普 | stanhope
英沃尔斯塔德 | 英沃斯塔德 | ingvoldstad
森霍尔 | 桑戈尔 | senghor
克伦鲍尔 | 克伦巴尔 | krumbhaar
莫拉尔 | 莫勒 | morar
弗里利 | 弗赖利 | friley
赫斯莱普 | 赫斯利普 | heslep
鲍托尔 | 鲍塔尔 | boutall
哈勒尔 | 哈拉尔 | harral
厄文 | 欧文 | ervin
哈扎德 | 哈泽德 | hazard
穆谢特 | 马希特 | mushet
布鲁姆利 | 布伦利 | brumley
比尔特 | 伯特 | birt
菲金杰 | 菲金格 | fickinger
明 | 米恩 | min
菲格雷斯 | 菲格斯 | figures
埃格 | 埃加 | eggar
特库姆什 | 特库姆塞 | tecumseh
伊万杰莉斯塔 | 埃万杰利斯塔 | evangelista
韦布利 | 韦伯利 | webley
帕门蒂尔 | 帕尔芒捷 | parmentier
迪因格利斯 | 迪安杰利斯 | deangelis
格里纳沃特 | 格里纳沃尔特 | greenawalt
麦格拉斯里奇 | 麦格拉斯里克 | macglasrich
索恩顿 | 桑顿 | thornton
芭布 | 巴布 | baab
巴洛克 | 巴洛赫 | balloch
切尔内斯基 | 切尔涅斯基 | chernesky
克龙 | 克朗 | kron
贝尔沃 | 贝尔维 | bellevue
布劳恩 | 布朗 | braun
霍夫 | 豪夫 | hauf
特里利文 | 特里莱文 | treleaven
比内尔 | 比尤内尔 | buesnel
阿迪 | 埃迪 | adye
哈格迈耶 | 哈格迈尔 | hagemeyer
凯希娅 | 凯蒂娅 | katia
西米恩 | 西明 | siemien
罗恩德 | 罗安德 | rowand
普里亚尔 | 普赖尔 | prial
布利萨克 | 布利萨茨 | blisac
马尼斯 | 马内斯 | maness
拜德斯 | 比德兹 | bidez
伊威尔 | 厄维尔 | irwil
威尔梅特 | 薇尔梅特 | wilmett
纳兰乔 | 纳兰霍 | naranjo
布雷兰 | 布里兰 | breland
奥钦迪奇 | 奥金达基 | auchindachie
卡尔 | 卡利 | karle
阿德莉娜 | 阿德利娜 | adelina
斯特尔特 | 斯泰尔特 | stelter
明韦尔 | 米恩韦尔 | meanwell
特雷弗西斯 | 特里富西斯 | trefusis
亚历山森 | 亚历山德森 | alexanderson
朱皮特 | 丘辟特 | jupiter
多特里奇 | 多伊特里希 | deutrich
托厄里 | 托尔里 | towery
马德林 | 马德琳 | madlin
威舍 | 维舍 | wischer
卡莉尔 | 卡利尔 | kalil
弗劳 | 弗劳德 | furlaud
戴加德 | 迪格 | dygard
巴利克 | 巴利奇 | balich
卡比特 | 丘比特 | cubitt
西克雷斯特 | 西克里斯特 | secrest
拉扎 | 拉扎尔 | lazar
麦贡恩 | 麦古恩 | macgoun
佩茨 | 皮特斯 | petes
皮克斯 | 皮尔克斯 | pearkes
费尔哈文 | 费尔黑文 | fairhaven
索恩伯格 | 索恩伯勒 | thornburgh
特里德加 | 特里迪加 | tredegar
艾丽 | 阿利 | alli
马西娅 | 玛西娅 | mathea
费布勒 | 法布勒 | fabler
彼得鲁斯卡 | 彼特鲁斯卡 | petruska
弗恩 | 维恩 | verne
韦姆 | 瓦伊姆 | waim
鲁兰 | 鲁伦 | ruellan
拉赫特 | 拉克特 | lachter
拉哈布 | 雷哈布 | rahab
麦金纳尼 | 麦基纳尼 | macinerney
埃根 | 伊根 | egan
斯蒂格勒 | 施蒂格勒 | stigler
特威宁 | 特文宁 | twining
乌尔夫 | 厄尔夫 | ulph
西达罗斯 | 西达劳斯 | sidarouss
弗洛沃登 | 弗劳尔迪 | flowerdew
盖伦 | 格兰 | gellan
吉梅尼兹 | 希门尼斯 | jimenez
普勒 | 普拉 | pullar
韦尔纳 | 沃尔纳 | woellner
杜因特 | 德温特 | dewint
斯威特曼 | 斯韦特曼 | sweatman
布拉德劳 | 布拉德洛 | bradlaugh
布鲁因 | 布勒因 | bruyn
塔米耶 | 塔米希尔 | tamihere
库劳 | 库罗 | courau
麦格罗瑟 | 麦格鲁瑟 | macgreuther
柯特尼厄斯 | 柯特纽斯 | curtenius
阿斯库思 | 阿斯奎思 | asquith
赫利娜 | 赫莉娜 | helina
伊蒂特拉格 | 伊泰拉格 | itteilag
埃沃伊 | 伊沃伊 | evoy
迪伦富思 | 迪伦弗思 | dyhrenfurth
特鲁塞尔 | 特拉塞尔 | trussel
坦盖 | 坦圭 | tanguay
布里尼希 | 布里尼格 | brinig
拉斯布里奇 | 拉斯布里杰 | rusbridger
米勒森 | 米莱森 | muehleisen
杜布拉斯 | 杜布拉 | dubras
亚兹明 | 亚斯明 | yazmin
劳德代尔 | 劳德戴尔 | lauderdale
伯贝奇 | 伯比奇 | burbage
泽纳 | 策纳 | zaehner
科尔尼特 | 科尔内特 | collnette
波洛斯 | 普洛斯 | poulos
卢万多 | 柳安多 | lewando
查莉诺 | 查利诺 | challenor
克莱恩 | 克莱因 | clyne
弗里岑 | 弗里曾 | fritzen
格尔廷 | 格廷 | guertin
特帕卡 | 特佩卡 | tepaika
比纳吉奥 | 比纳乔 | binaggio
贝尔希 | 贝尔赫 | bailhe
斯科克罗夫特 | 斯考克罗夫特 | scowcroft
金萨特 | 金瑟特 | gensert
麦卡尔 | 麦考尔 | mackal
奥利曼 | 阿利芒 | allemang
赛奇 | 赛什 | saich
皮奥特罗夫斯基 | 彼得罗夫斯基 | piotrowski
贾恩 | 扬 | jahn
康加尔顿 | 康高尔顿 | congalton
杜克斯 | 杜阿克斯 | duax
沙滕克 | 沙滕柯克 | schattenkerk
法隆 | 法伦 | falloon
奥斯怀 | 奥斯威尤 | oswiu
兰德威西 | 兰德沃西 | landwirthy
索蒂 | 索西 | southee
米隆 | 米伦 | millon
艾利 | 艾莉 | eily
埃肯 | 伊肯 | ekern
菲利恩 | 菲利翁 | filion
赞皮略 | 赞皮耶洛 | zampiello
肖珊 | 舒尚 | shooshan
莫普斯 | 莫皮斯 | moppes
菲茨蒙斯 | 菲齐蒙斯 | fitzimons
帕塞尔 | 帕斯尔 | parcell
泰博尔特 | 蒂博尔特 | tybalt
索尔 | 苏尔 | soul
德迪奥 | 戴德奥 | dedeo
麦克里思 | 麦克勒思 | mackereth
布拉夫 | 布洛 | bullough
奥瑟 | 奥泽 | orser
帕珀马斯特 | 佩珀马斯特 | papermaster
贝伦德斯 | 贝伦兹 | berendes
杜布尔迪 | 道布尔迪 | doubleday
施雷德 | 施拉德 | schrade
伯克 | 比尔克 | birck
巴索尔森 | 巴托尔松 | bartholdson
麦克索兰 | 麦克斯波伦 | macsporran
英格林 | 英林 | yingling
波特斯 | 波蒂厄斯 | porteus
查努廷 | 查纽廷 | chanutin
埃塞克 | 伊塞克 | esek
梅耶霍弗 | 迈尔霍费尔 | maierhofer
艾尔莎 | 艾尔萨 | ailsa
德普勒格 | 德普卢格 | derploog
马伦普尔 | 马伦普雷 | malempre
阿尔顿 | 阿里顿 | arreton
贝哈 | 贝亚 | beha
安嫩贝格 | 安嫩伯格 | annenberg
富洛姆 | 富勒姆 | fullom
博尔多 | 波尔多 | bordeaux
德西德里厄斯 | 德西迪里厄斯 | desiderius
马尼尔 | 马尼耶 | magnier
埃纳姆 | 埃努姆 | aernum
麦基尔弗里 | 麦基雷维 | macilrevie
艾肯格伦 | 艾肯格林 | eichengreen
莱夫勒 | 莱弗勒 | leffler
科卡姆 | 科克姆 | corkum
拉文 | 雷文 | raven
黑夫纳 | 哈文纳 | havenner
格威达德斯 | 格威查德斯 | gwychardus
莫布斯比 | 莫布兹比 | mobsby
赛尔斯 | 西尔斯 | cyres
西加尔 | 西格尔 | seegal
泰夫 | 塔夫 | tave
西波洛恩 | 西波隆 | cipollone
阿奎韦 | 阿夸约 | aquayo
弗雷林休森 | 弗里林海森 | frelinghuysen
帕杰利斯 | 帕盖利斯 | pargellis
莱波尔 | 勒普尔 | lepoer
布雷斯洛夫斯基 | 布雷斯拉夫斯基 | breslawsky
达夫尼 | 达夫妮 | daphne
里加利亚 | 雷加利亚 | regalia
麦克莱夫 | 麦克拉夫 | mcclave
麦康基 | 麦康希 | macconchy
桑德姆 | 桑达姆 | sandham
马宁 | 曼宁 | maning
布莱赫特 | 布拉胡特 | blachut
赫明 | 亨明 | hemming
特文加德姆 | 蒂文加杜姆 | tirvengadum
马米 | 玛米 | mami
杰内罗 | 吉尼罗 | genero
比斯特 | 比伊斯特 | buist
拉拉莫尔 | 拉腊莫尔 | laramore
福韦尔 | 福尔韦尔 | faulwell
哈克 | 黑克 | hake
哈沙根 | 哈舍根 | hashagen
赖奥尔斯 | 赖亚尔斯 | ryalls
梅伦 | 默龙 | merron
安克鲁姆 | 安克拉姆 | ancrum
斯托沃尔 | 斯托瓦尔 | stovall
蒂克尼斯 | 西克尼斯 | thicknesse
贝基 | 巴基 | bakey
格鲁科特 | 格劳科特 | groucott
鲁伊斯 | 吕埃 | ruez
拉德布罗克 | 拉德布鲁克 | ladbroke
卢伊斯蒂格 | 卢斯蒂格 | luistig
昂斯莱格 | 奥恩斯莱格 | oenslager
哈加丁 | 哈格丁 | hargadine
利基姆 | 利克希姆 | leikhim
沃茨哈特 | 沃特沙夫特 | wirtschafter
伊默斯 | 伊穆斯 | imus
托赫 | 托克 | toch
杜恩特 | 德温特 | dewenter
加瓦尔特 | 加沃尔特 | gawalt
哈雷尔 | 哈勒尔 | harrel
斯普勒 | 施普勒 | spuhler
阿马尼 | 阿尔马尼 | armani
弗莱布 | 弗莱比 | flebbe
汤布斯 | 图姆斯 | tombs
达夫隆 | 杜弗隆 | duflon
梅罗维奇 | 迈罗维奇 | meirovitch
谢里克 | 谢雷克 | sherek
泰伊 | 赛伊 | thye
塞内克斯 | 塞兹内克 | seznec
贝恩 | 本 | benn
麦基利肯 | 麦基利坎 | mackillican
多里 | 多丽 | dorrie
费内夫 | 法纳夫 | faneuf
罗伯斯顿 | 罗伯茨顿 | robertston
索隆 | 索伦 | solon
雷德斯克 | 拉德斯克 | radesk
罗赫 | 罗奇 | roch
多勒 | 多拉夫 | dorough
巴尔尼尔 | 巴尼尔 | balniel
菲林 | 法尔林 | firing
克莱姆 | 克莱米 | klemme
费尔 | 费雷 | ferre
安娜贝尔 | 安娜贝勒 | annabelle
博瓦因 | 博伊文 | boivin
西特龙 | 西特伦 | citron
福伊西 | 福西 | feusi
曾伯格 | 宗伯格 | zumberg
萨加 | 塞格尔 | sagar
恩格兰 | 英格兰 | england
科朗吉 | 科隆吉 | colonghi
基劳森 | 西劳森 | cilawson
艾德斯莫 | 艾兹莫 | eidsmoe
阿布 | 阿贝 | abbe
博伊斯通坦 | 博伊斯方丹 | boisfontaine
麦卡尔哈蒂 | 麦克哈蒂 | mccahearty
麦克芒 | 麦克蒙 | mcmunn
塞弗里 | 萨弗里 | savery
伯格哈德 | 伯格哈特 | burghard
施赖纳 | 施里纳 | shriner
弗皮利厄 | 韦皮勒 | verpilleux
迪安门特 | 迪亚门特 | diament
汤嫩德 | 汤恩德 | townend
杰彭 | 杰波恩 | jepoen
伯肯霍尔茨 | 伯肯霍尔兹 | birkenholtz
默蒂斯 | 默特斯 | mertes
勒克特 | 勒基特 | luckett
埃德 | 伊德尔 | eader
维诺格拉德 | 维诺格勒 | vinograd
安纳格莫尔 | 安纳克莫尔 | annaghmore
斯图德曼 | 斯蒂德曼 | studeman
勒利恩 | 勒林 | lelean
布里德森 | 布赖森 | bridson
蒂林赫斯特 | 蒂林哈斯特 | tillinghast
皮里斯廷 | 皮里斯坦 | pearistine
马达维奇 | 马达维赫 | mhadavikh
杜拉克 | 杜拉奇 | dullach
肖尔德 | 索尔德 | szold
杜普卡克 | 杜普恰克 | dupcak
布雷登 | 布拉顿 | bradon
奥西 | 奥齐 | orczy
贝姆 | 巴姆 | bame
普利马尔 | 普莱梅尔 | plymale
布罗梅特 | 布罗米特 | bromet
皮乔瓦克 | 皮乔维亚克 | piechowiak
马利耶 | 马利尔 | mallier
奥尔斯坎 | 奥雷斯坎 | orescan
惠特伯格 | 惠特伯勒 | whitburgh
霍莫尔卡 | 霍穆尔卡 | homolka
海斯博格 | 海斯堡 | heisborg
费尔德里尔 | 费德布里尔 | feldbrill
杰农 | 热农 | gernon
斯顿特 | 斯坦特 | stunt
埃利斯 | 埃莉丝 | elyse
伦格利 | 伦利 | lungley
克勒勒 | 克雷勒 | kroehler
舍米宁特 | 切米宁特 | cheminint
克丽扎 | 克里扎 | kryza
克罗梅 | 克罗米 | cromey
法斯纳特 | 法斯纳克特 | fasnacht
布根 | 巴根 | bugan
马福德 | 马格福德 | mugford
施瓦姆 | 施万布 | schwamb
奥里 | 奥赖 | ory
艾尔弗里克 | 阿尔弗里克 | aelfric
艾尔加 | 艾尔格 | eylgar
耶 | 伊 | yee
黑赞 | 哈赞 | hazan
索纳曼 | 索恩曼 | sonnemann
奥赞妮 | 奥赞 | ozanne
沙普尔斯 | 沙普利斯 | sharpless
德汉 | 德哈恩 | dehaan
雷诺 | 雷纳 | raynor
贝克哈特 | 贝克哈德 | beckhard
松塔格 | 桑塔格 | sontag
梅赞 | 马赞 | mazan
塔利奥 | 图利奥 | tullio
麦康 | 梅肯 | macon
戴维 | 达维 | davee
戈希 | 戈伊 | gohey
克莱弗 | 克拉弗 | claver
桑萨姆 | 桑森 | sansum
吉吉 | 吉盖 | giggey
达科姆 | 戴科姆 | dacombe
邦廷 | 邦坦 | bontein
多本 | 多宾 | doben
杰穆特 | 格穆思 | germuth
泰恩什 | 坦什 | tainsh
克雷斯皮尼 | 克雷皮尼 | crespigny
赫梅尔辛 | 休梅尔辛 | humelsine
马夸里 | 麦夸里 | maquarie
比尔基 | 伯基 | buerki
斯韦德什 | 斯沃德什 | swadesh
巴贝尔 | 贝布尔 | babell
博德温 | 博德瓦恩 | bordwine
布朗塔斯 | 布龙塔斯 | brountas
梅耶森 | 迈耶森 | mayerson
麦科姆 | 麦库姆 | mccombe
德雷沃尔吉拉 | 德沃尔吉拉 | drevorguilla
奥弗拉伯蒂 | 奥弗莱厄蒂 | o'flahertie
塞维 | 西维 | sevey
博克尔 | 博克 | boker
埃休 | 埃舒 | eshoo
马辛库斯 | 马辛克斯 | marcinkus
佩雷兹 | 佩雷斯 | perez
西塔罗 | 塞塔罗 | setaro
蒂利 | 蒂莉 | tillie
赖格 | 里格 | riger
道德 | 多德 | dowd
阿利森 | 艾莉森 | alyson
德雷塞尔 | 德雷斯尔 | dressel
朱利 | 朱莉 | julie
芬格胡特 | 芬格赫特 | fingerhut
埃杰利 | 埃奇利 | edgley
丹尼恩 | 达尼恩 | danyon
希克 | 舍克 | shirk
马休伦 | 马胡兰 | mahuran
派耶 | 派尔 | peyer
波兰 | 普兰 | poulain
齐赫 | 切赫 | czeh
西尔瓦纳斯 | 西尔维纳斯 | silvanus
埃克斯坦斯 | 埃克斯滕斯 | exstance
艾因斯 | 安斯 | aines
普萨得里 | 普萨泰里 | pusateri
尼亨 | 奈恩 | nyhen
霍雷舍斯 | 霍雷修斯 | horatius
韦克特 | 瓦克特 | wackett
罗巴蒂斯 | 罗巴茨 | robartes
阿格内洛 | 阿涅洛 | agnello
格拉齐亚多 | 格拉齐亚迪奥 | graziadio
伊莱 | 艾莱 | ilay
纳蒂尤 | 纳休 | nathiew
斯蒂格利茨 | 施蒂格利茨 | stiglitz
塞西利厄斯 | 塞西莉厄斯 | cecilius
沃纳科特 | 旺纳科特 | wonnacott
纳登 | 内登 | naden
哈姆斯 | 黑姆斯 | hammes
查格尔斯 | 查格利斯 | chagles
格里比诺 | 格里布诺 | griebenow
加纳吉安 | 加南吉扬 | ganangiyan
古拉德 | 戈拉德 | goulard
格罗杰 | 格罗格 | grogger
布里斯 | 布赖斯 | brise
怀特利思 | 怀特莱瑟 | whiteleather
埃夫勒 | 埃弗勒 | effler
罗亚代尔 | 罗亚尔 | royale
惠特塞特 | 惠特西特 | whitsett
赫克 | 赫德基 | hedke
瓦斯默 | 沃斯默 | wasmer
布雷斯纳安 | 布雷斯纳汉 | bresnahan
波 | 鲍 | pow
拉克歇尔 | 拉克斯尔 | wraxhall
曼柳斯 | 曼利厄斯 | manlius
鲍夫曼 | 鲍曼 | baughman
布里梅科姆 | 布里马科姆 | brimacombe
莱托克 | 勒托克 | letocq
里瑟斯 | 雷瑟斯 | rethers
乔弗里翁 | 乔夫里翁 | joffrion
罗克特 | 罗基特 | rockett
伯恩 | 贝尼 | boehne
格鲁尔 | 格劳尔 | grouer
德沃拉克 | 德沃夏克 | dvorak
梅约斯 | 梅杰斯 | majors
福伊弗克 | 福伊尔沃克 | feuerwerker
塔吉 | 塔姬 | taggy
蒂姆韦尔 | 泰姆韦尔 | timewell
巴克纳 | 巴赫纳 | bachner
图德霍 | 塔杜 | tudhoe
邦格 | 邦奇 | bunge
蒂格雷特 | 泰格雷特 | tigrett
卡迪奥 | 卡迪厄 | cadieux
托莱斯特拉普 | 托尔斯特拉普 | tollestrup
德普特克 | 德普塔克 | deptuck
迪特 | 迪特尔 | dieter
格尔 | 吉尔 | gehl
迪斯特伯格 | 杜斯特伯格 | duesterberg
利德福 | 利德福德 | lydford
希彻尔 | 希切尔 | hitchell
菲恩 | 费恩 | feane
格雷博 | 格里博 | grebow
弗里斯 | 弗雷斯 | frece
朗莱因 | 朗莱恩 | longhlein
埃尔斯 | 埃利斯 | elles
德斯巴拉茨 | 德巴拉茨 | desbarats
沃拉克 | 沃勒克 | wallack
克兰多尔 | 克兰德尔 | crandall
蒂兰纳 | 蒂拉纳 | tirana
卡纳尼 | 卡奈尔尼 | carnearney
特嫩鲍姆 | 特南鲍姆 | tennenbaum
霍奇根 | 霍根 | hodgan
卡基亚 | 卡夏 | cachia
莫尔桑 | 莫桑 | morsan
阿杰里斯 | 阿吉里斯 | argeris
明内特 | 明妮特 | minnette
福尔加 | 福加 | forga
里尔 | 雷哈尔 | rehal
安斯帕彻 | 安斯帕赫尔 | anspacher
贾西诺夫斯基 | 贾西诺斯基 | jasinowski
克雷弗 | 克里弗 | crever
沃尔特霍夫 | 瓦尔塞奥夫 | waltheof
拉保诺 | 拉普阿诺 | rapuano
泰雷尔 | 蒂雷尔 | tyrell
安德雷斯 | 安德烈斯 | andress
埃尔斯皮 | 伊丽莎白 | elspie
利德 | 莱德 | leider
哈根 | 黑根 | hagan
维特拉吉尔 | 维特拉西尔 | vytlacil
麦卡拉克 | 麦柯拉克 | maccurrach
卡特林塔克 | 卡特林萨克 | katrinsak
托普尔 | 托佩尔 | topple
撒姆斯 | 泰晤士 | thames
肯奈尔德 | 肯奈德 | kennaird
莱克拉斯 | 勒克拉 | lecras
斯普赖尔 | 斯普雷耶 | spreyer
艾克纳 | 艾希纳 | eichner
费拉奥 | 费劳 | ferrao
杜雷 | 杜里 | durey
奥弗拉伯蒂 | 奥弗莱厄蒂 | o'flaherty
萨马罗 | 萨马鲁 | samaroo
梅西格 | 米西格 | muessig
赫格 | 霍格 | hoegh
伯杰文 | 伯格文 | bergevin
皮克 | 珀基 | pyrke
恩布林 | 恩布琳 | emblin
卡尔索普 | 考尔索普 | calthorpe
西森 | 特森 | thesen
吉尔德豪姆 | 吉尔多姆 | guildhaume
埃维 | 埃维尤 | evjue
威尔科夫斯基 | 维尔科夫斯基 | wilkowski
法尼埃尔 | 法纳尔 | faneuil
雷塔 | 里塔 | rheta
波 | 普 | poo
赖查特 | 理查特 | richart
朗尼加 | 朗内加 | runnegar
安托尔兹 | 安索尔兹 | ahntholz
卡莎 | 卡撒 | cartha
麦克莱恩 | 麦克林 | mcclean
多尔杰 | 德尔格 | dolger
赫贝斯特里特 | 赫布斯特雷特 | herbestreit
赫尔斯顿 | 赫尔斯特恩 | hellstern
普莱斯顿 | 普利斯顿 | puleston
埃杰曼 | 埃格曼 | egerman
科森 | 科瑟恩 | cothern
埃尔韦斯 | 埃尔威斯 | elwes
塔弗 | 塔沃尔 | tavor
韦赫 | 韦伊尔 | weiher
维特 | 维特尔 | vetter
赫米恩 | 赫米奥娜 | hermione
斯维尔 | 斯维沃 | svewar
杭德里奇 | 杭德里克 | honderich
利伯廷 | 利伯蒂娜 | libertine
达莱佩塞 | 达莱佩泽 | dallepezze
迈尔斯特拉普 | 迈尔斯特勒普 | meilstrup
朗塞莱修斯 | 朗斯利特斯 | launceletus
埃德利 | 埃德尔 | ederle
阿迪奥 | 阿德奥 | addeo
米杰利 | 米奇利 | midgley
科莫尼亚克 | 科莫尼亚雷克 | komoniarek
格恩斯巴克 | 根斯巴克 | gernsback
比尔 | 伯尔 | birr
邓坎森 | 邓肯森 | duncanson
高迪安 | 高迪恩 | gaudian
迪尔 | 代尔 | diel
维多尔 | 维多 | vidor
迪思里希 | 迪特里希 | diethrich
克里斯坦 | 克里斯廷 | kristine
布拉梅尔斯 | 布拉迈尔斯 | blamires
迈斯利希 | 迈斯利奇 | meislich
当西 | 当齐 | dauntsey
沃索 | 瓦索 | wasow
列昂蒂耶夫 | 列昂季耶夫 | leontiev
贾亚迪 | 吉亚尔迪 | ghiardi
艾勒姆 | 奥勒姆 | allam
博迪科姆 | 博迪库姆 | bodycombe
施韦布尔 | 施韦布 | schwelb
伊泽纳 | 艾泽努尔 | izenour
雅科布斯坦 | 雅各布斯坦 | jacobstein
特里尔斯 | 特里赖斯 | trerise
帕尼特 | 帕内特 | panet
罗恩 | 龙尼 | ronne
平乔特 | 平肖 | pinchot
范热 | 范格特 | fanget
伊尔格 | 伊尔克 | ilg
查森 | 蔡森 | chasen
科佩拉 | 科皮拉 | coppela
朱拉比安 | 朱拉布奇安 | joorabchian
斯拉特里 | 斯莱特里 | slattery
耶尔马思 | 厄马思 | earmarth
希拉克 | 希莱克 | shillaker
博尔迪克 | 博尔达克 | bolduc
梅约 | 梅奥 | mayo
安蒂维尔 | 安特维尔 | antevil
里辛 | 赖辛 | rising
达纳文特 | 杜纳万特 | dunavant
基珀斯 | 凯珀斯 | kuipers
梅恩唐纳德 | 梅因唐纳德 | maindonald
麦卡勒里 | 麦卡利里 | mcalery
黑兹尔廷 | 黑兹尔坦 | hazeltine
尤卡赖斯塔 | 尤卡里斯塔 | eucharista
迈格希尔 | 迈伊尔 | mighill
赫曼 | 希曼 | heman
布罗瑟 | 布拉泽 | brother
金索林 | 金索尔文 | kinsolving
廷恩 | 锡恩 | thynne
弗里斯 | 弗里亚斯 | freas
皮尼 | 派尼 | piney
布里安 | 布赖恩 | brian
莱滕德尔 | 勒滕德 | letendre
杰斯 | 杰西 | jesse
格温福 | 格温弗 | gwynfor
莱夫斯丘 | 莱韦斯克 | levesque
奥德里 | 奥德丽 | audrey
约瓦诺维奇 | 约万诺维奇 | yovanovitch
派尤什 | 皮尤什 | piyush
斯马比 | 斯梅比 | smaby
英奇坎 | 英奇昆 | inchiquin
津巴尔多 | 津巴多 | zimbardo
多南费尔德 | 多宁费尔德 | donenfeld
沃尔德雷普 | 沃尔德里普 | waldrep
德马西奥 | 德马肖 | demascio
穆科夫斯基 | 穆科斯基 | mukowski
泽凯拉 | 泽克拉 | zechella
卡莉 | 凯莉 | kallie
斯凯特 | 斯卡特 | skate
麦吉尔弗 | 麦吉尔伍尔 | macgillvoor
鲍古德 | 布古尔 | bougourd
塞文 | 西文 | sevin
内姆谢克 | 内姆泽克 | nemzek
尤曼斯基 | 乌曼斯基 | umansky
欣恩 | 希恩 | shinn
庞南穆拉 | 庞南佩鲁马 | ponnamperuma
米曾 | 迈曾 | mizen
洛梅尔 | 隆梅尔 | lommel
马赫 | 马奇 | much
金尼弗 | 珍妮弗 | gennifer
查萨尼斯 | 沙萨涅 | chassagnes
厄尔利 | 厄利 | earley
艾托 | 阿尤托 | aiuto
鲍夫鲁德 | 鲍赫鲁德 | boughrood
吉隆 | 吉伦 | gillon
道沃德 | 道尔德 | doward
基尔里 | 基里 | kearey
瓦克 | 瓦克尔 | wacker
卢易佐 | 路易祖 | louizou
弗兰兹 | 弗朗兹 | franz
米泽尔 | 米泽勒 | mizelle
托雷斯 | 托里斯 | torres
沃利本 | 沃莱本 | wohlleben
普法格拉夫罗夫 | 法尔茨格拉夫 | pfaltzgraff
沃申科 | 瓦申科 | washenko
博尼特 | 博内特 | bonett
伊利特 | 艾利特 | ilett
马库斯 | 马库塞 | marcuse
艾明格 | 艾尔明格 | irminger
阿伦 | 艾伦 | allen
乔瑟姆 | 乔撒姆 | jotham
斯坦拉克 | 斯坦莱克 | stanlake
温切尔塞 | 温切尔西 | winchelsea
古卡斯 | 古奥卡斯 | guokas
迪特尔特 | 迪泰特 | dittert
克里维利 | 克里韦利 | crivelli
菲策尔文 | 菲茨艾尔温 | fitzailwyn
埃迪生 | 埃迪森 | eddison
希金博瑟姆 | 希金博特姆 | higinbotham
登宁 | 丹宁 | denning
比尔若 | 比利厄 | bilyeu
马格 | 马季 | marj
布加斯 | 巴加斯 | bugas
埃奇达尔 | 埃奇代尔 | edgedal
凯伊 | 基 | key
林德斯滕 | 林斯滕 | lindsten
贝罗尔 | 伯罗尔 | berall
施威默 | 施维默 | schwimmer
图里基安 | 图雷基安 | turekian
凯特伦 | 卡特伦 | catron
斯威特基 | 斯威凯 | switkay
索布洛夫 | 索贝洛夫 | sobeloff
贝格尔 | 贝尔 | beighle
麦卡利基 | 麦卡利克西 | mcaliksey
肖弗勒 | 肖夫勒 | schauffler
休利尔 | 特威利尔 | thuillier
德加格里迪安 | 德加拉贝迪安 | dergarabedian
戈特蕾托 | 戈特格特鲁 | gottgetereu
诺森顿 | 诺桑普顿 | northampton
布罗瓦斯 | 布罗斯 | broas
赫伦布兰德 | 海伦布兰德 | hellenbrand
埃布 | 厄尔布 | erb
格瓦特金 | 格沃特金 | gwatkin
鲍尔丹齐 | 巴尔丹齐 | baldanzi
索姆森 | 汤姆森 | thomsen
茜茜 | 锡西 | cissie
莱兰 | 利兰 | lelland
温泽尔 | 温策尔 | wenzel
杜格 | 杜奇 | dooge
巴蒙特 | 贝蒙特 | bamont
加利亚多 | 加利亚尔多 | galiardo
奥尔德齐尔 | 奥尔迪泽 | aldhizer
卡洛格罗 | 卡洛杰罗 | calogero
纳吉恩 | 纳金 | nagean
姆林纳奇克 | 姆利纳奇克 | mlinarchik
鲍兹韦尔 | 多德斯韦尔 | dowdeswell
达尔 | 杜尔 | durr
米齐 | 梅齐 | meazey
格鲁乔 | 格劳乔 | groucho
迪伦福思 | 迪伦弗思 | dhyrenfurth
扬克威奇 | 扬克维奇 | yankwich
萨格曼 | 塞奇曼 | sageman
克奇维尔 | 克切维尔 | kercheville
施韦特德 | 施韦蒂德 | schwetid
德西雷 | 德西蕾 | desiree
凯利 | 丘利 | kewley
卡德拉 | 夸德拉 | cuadra
休什 | 休伊什 | huish
德波米尔 | 德波米耶 | depommier
加哈根 | 加黑根 | gahagen
麦金特夫夫 | 麦金塔夫 | mcinturff
莫福德 | 莫维兹 | morfudd
桑克利 | 尚克利 | sankley
罗梅因 | 罗曼 | romaine
塞马拉 | 赛马拉 | saemala
怀斯坦 | 威斯坦 | wystan
吉尔休利 | 吉尔胡利 | gilhuly
博德温 | 鲍德温 | bodwine
勒斯 | 卢斯 | luss
鲍科姆 | 鲍库姆 | bawcombe
莱因斯 | 莱恩斯 | lines
莱苏夫 | 勒瑟夫 | lesurf
查伦格 | 查林杰 | challenger
泰特 | 撒特 | thaete
约基尔森 | 约克尔森 | yochelson
赛赫 | 西赫 | sih
布龙温 | 布朗温 | bronwyn
亨特雷斯 | 亨特里斯 | huntress
蒂奥桑 | 蒂乌萨宁 | tiusanen
特里布 | 特赖布 | tribe
米尔德万 | 米尔德文 | mildvan
金卡尔尼 | 金凯尼 | kincairney
阿尼尼 | 阿内尼 | aneny
马斯曼 | 穆斯曼 | mussman
恩德斯 | 恩德雷斯 | endres
沃伦德 | 沃尔龙德 | walrond
蒙塔文 | 蒙塔冯 | montavon
阿韦尔 | 奥尔韦尔 | alwell
萨特 | 萨特杰 | satge
蒂瑟 | 泰瑟 | tysser
贾尼斯 | 贾尼西 | janisse
比基特 | 比克特 | bicket
杜蒂 | 达西 | duthie
加亨 | 加恩 | gahan
德拉波 | 德拉珀 | drapeau
巴里克 | 巴威克 | barwick
霍奇加特 | 霍贾特 | hodgart
桑比 | 桑德比 | saundby
蒂贝特 | 特贝特 | tebet
德斯博伊斯 | 德布瓦 | desbois
格罗斯克利克 | 格罗斯尼克尔 | grossnickle
斯威布 | 斯韦比 | swaebe
格雷巴尔 | 格拉巴 | grabar
弗鲁伊特 | 弗鲁特 | fruit
伊利恩 | 伊尔伦 | illearn
阿布洛姆 | 阿布隆 | ablom
博尔加塔 | 博加塔 | borgatta
埃斯梅尔 | 伊斯梅尔 | esmail
沃滕伯格 | 瓦滕伯格 | wattenberg
安东尼斯 | 安图尼斯 | antunes
阿迪内特 | 阿迪尼特 | adinet
吉尔克雷斯特 | 吉尔克里斯特 | gilchrest
迪克 | 迪克尔 | dicker
佩得金 | 彼得金 | peterkin
霍伊尔贝克 | 胡尔贝克 | houiellebecq
布希 | 布舍 | busche
比伊 | 布伊 | buie
费多希克 | 费多奇克 | fedochik
埃斯特哈 | 埃斯特海 | esterhai
马尔欣 | 马尔夏恩 | mulshine
埃莱克特拉 | 伊莱克特拉 | electra
查费茨 | 查菲茨 | chafetz
塞米厄斯 | 瑟缪斯 | sermeus
艾克瑟 | 伊克瑟 | ixer
安杰尔斯 | 安杰利斯 | angeles
伊卡恩 | 伊坎 | icahn
罗伊尔 | 鲁埃尔 | reuel
海森 | 希森 | hyson
布龙森 | 布朗森 | bronson
沃姆索 | 沃姆泽 | wormsor
格诺尔 | 格瑙尔 | genauer
克莱夫 | 克拉夫 | clave
蒙东纳 | 蒙顿纳 | montonna
卡莎 | 卡沙 | kasha
利多姆 | 利德姆 | leedom
马拉布尔 | 梅拉伯 | malabre
玛比 | 梅比 | mabie
利希特沃特 | 利希特瓦尔特 | lichtwardt
加恩斯 | 加农斯 | garnons
奥费罗尔 | 奥费拉尔 | o'ferrall
马琴 | 梅琴 | machen
赫登 | 黑登 | headon
塔斯罗 | 塔什罗 | taschereau
埃廷杰 | 埃廷格 | ettinger
安娜尼 | 阿纳尼 | anany
福尔维 | 法尔维 | falvey
查普恩 | 沙蓬 | chapone
林迪 | 琳迪 | lynndie
多诺霍尔 | 多诺莫尔 | donoughmore
奇德尔 | 切德尔 | chedell
甘博阿 | 甘博亚 | gamboa
康伯 | 库默 | comber
赫施 | 胡希 | husch
阿克利 | 埃克利 | akeley
奥拉 | 奥尔拉 | orla
卡丹 | 卡登 | kadane
金格莱克 | 金莱克 | kinglake
斯特罗哈尔 | 斯特罗萨尔 | strohsahl
阿夫伯里 | 埃夫伯里 | avebury
维利博洛斯 | 比利亚洛沃斯 | villalobos
拉什 | 勒什 | lush
迪达姆 | 迪德姆 | deedham
古特沃思 | 格特沃思 | gutwirth
斯特朗伯格 | 斯特龙伯格 | stromberg
格维茨 | 格威茨 | gurwitz
德梅特 | 德梅特尔 | demaitre
马加万 | 马加芬 | magafan
汤姆兰 | 汤姆林 | tomline
贝尔里 | 比尔里 | beary
斯沃斯特林 | 斯韦思林 | swaythling
达姆勒 | 杜姆勒 | dumler
海因菲尔德 | 汉费尔德 | hainfeld
沃拉 | 瓦拉 | walla
伊尔德赫姆 | 埃尔德姆 | ealdhelm
斯塔尔内克 | 斯托尔内克 | stalnecker
马杰里 | 马格丽 | margery
贝沃尔德 | 贝瓦尔德 | baerwald
盖伊 | 贾伊 | ghey
莱姆斯 | 里姆斯 | rheims
布鲁斯 | 布劳斯 | brous
费罗泽德 | 费罗祖德 | ferozud
普拉格 | 普拉奇 | plugge
基奥 | 凯乔 | kejoa
博斯顿 | 波士顿 | boston
费克特蒂 | 费克特库蒂 | feketekuty
赫芬 | 赫法恩 | huffine
瑟希 | 塞希 | sershey
拉克斯里思 | 拉克斯弗里思 | laxfrith
埃诺 | 伊诺 | eno
塞利格曼 | 塞利希曼 | seligmann
加韦德 | 加维德 | gaved
科奇尼希 | 科奇尼格 | kotschnig
斯特雷姆劳 | 斯特里姆劳 | stremlau
佩洛贝特 | 佩卢贝特 | peloubet
盖尔曼 | 格尔曼 | gellman
拜尔 | 贝耶尔 | beier
马卡洛尼斯 | 马查洛尼斯 | marchalonis
瑟瓦克 | 瑟瓦奇 | serwach
阿塞林 | 阿斯林 | acelin
阿菲 | 埃菲 | afee
西德博特姆 | 赛德博特姆 | sidebotham
格德 | 格尔德 | gerd
埃克洛夫 | 埃克勒夫 | eklof
博格泰尔 | 博格蒂尔 | boghatyr
芬格勒 | 芬勒 | fengler
尤因 | 约恩 | eoin
索 | 托 | thau
图里曼 | 图尔曼 | tureman
法克托 | 法克特 | factor
德西德拉塔 | 德西德蕾塔 | desiderata
乔埃特 | 朱厄特 | jouett
班顿 | 贝恩顿 | baynton
塞格尔 | 西格尔 | seigel
约克威廉斯 | 约克威廉 | yorkwilliams
弗拉利克 | 弗雷利克 | fralick
塞尔娜 | 塞尔纳 | serna
伦嫩 | 伦南 | lennen
罗吉特 | 罗热 | roget
弗雷格 | 弗雷 | frej
伊登 | 艾登 | idden
杰瑟里奇 | 杰塞里克 | jeserich
杜庞特 | 杜邦 | dupont
克利姆克 | 克利姆基 | klimcke
赫尔布尔 | 赫布尔 | helble
伦德罗 | 伦德弗罗 | rendfrow
昂布赖特 | 昂布里特 | umbreit
布劳恩 | 布朗 | browne
凯格罗 | 凯加鲁 | caegarw
劳恩特 | 朗特 | launt
胡沃斯 | 休沃斯 | huvos
勒热 | 利热 | leasure
萨姆斯塔格 | 扎姆斯塔格 | samstag
贾格斯 | 贾格尔斯 | jaggers
赛克 | 西克 | cyker
凯斯 | 基斯 | keys
萨基纳 | 萨金娜 | sakinah
勒丰 | 勒方 | lefaune
拉夫松 | 拉夫肖恩 | rafshoon
贝曼 | 比曼 | beman
森弗特 | 索伊弗特 | seufert
斯坦纳姆 | 斯塔纳姆 | stanham
阿基翁 | 埃克申 | action
梅因沙因 | 梅恩沙因 | maienschein
齐默曼 | 齐梅曼 | zimmeman
桑兹 | 桑德斯 | sondes
菲奇 | 富奇 | fudge
穆普森 | 马普森 | mupson
埃尔利 | 埃尔勒 | ehrle
勒克赫斯特 | 卢克赫斯特 | luckhurst
卡罗尔 | 卡萝尔 | carole
埃丁杰 | 埃丁格 | edinger
德维尔 | 德韦尔 | deveulle
麦高兰 | 麦戈兰 | mcgauran
登帕赛 | 登帕西 | dempasay
马格尼 | 马格内 | magnay
福尔克布里奇 | 福尔肯布里奇 | falconbridge
马库斯 | 马克斯 | marcuss
穆恩 | 穆安 | muan
格林斯特德 | 格林斯蒂德 | grinstead
阿尔文 | 奥尔文 | allvine
特鲁特 | 特拉特 | trutter
莱因尼斯 | 莱因德尼斯 | rhindness
米多斯 | 梅多斯 | meadows
帕德西 | 帕齐 | pudsey
罗尔夫斯 | 罗卢夫斯 | rolufs
切诺维奇 | 切尔诺维奇 | cernovitch
奈斯利 | 尼斯利 | knisely
尼科拉迪斯 | 尼古拉迪斯 | nikolaidis
贝特拉 | 伯特拉 | bertera
戈利特利 | 戈莱特利 | golightly
芒尼克森 | 芒尼克海森 | munnikhuysen
奇尔德 | 蔡尔德 | child
朱尔科威茨 | 尤尔科维茨 | jurkowitz
鲁宾斯坦 | 鲁本斯坦 | rubenstein
肖 | 舍韦 | schewe
麦琼金 | 麦克琼金 | mcjunkin
高蒂耶 | 高蒂尔 | gauthier
拉贝特 | 拉贝 | rabet
吉格雷尔 | 吉格尔 | giguere
麦克法迪安 | 麦克法迪恩 | mcfadyean
卢尼德 | 莉内德 | luned
乔马 | 肖莫 | chomeau
科克兰 | 科克伦 | cochrane
布扎纳 | 布尔扎纳 | brzana
莫尔霍尔特 | 莫霍尔特 | molholt
阿加西亚 | 阿加西娅 | agacia
克里茨 | 克赖茨 | crites
布兰特里 | 布伦特里 | braintree
钱伯林 | 钱伯辛 | chamberlsin
格青格 | 格青杰 | getsinger
英格尔比 | 英吉尔比 | ingilby
欧维特 | 艾尔薇特 | irvette
德尼奥 | 迪奈欧 | denio
基尔 | 基利 | kille
奥思内尔 | 奥塞内尔 | othenel
坦迪恩 | 坦丁 | tandien
马尼奥利亚 | 马格诺利娅 | magnolia
埃莱斯米尔 | 埃尔斯米尔 | ellesmere
戴西 | 黛西 | daisy
沃瑟姆 | 沃特海姆 | wertheim
蒙泰罗 | 蒙蒂罗 | monteiro
克里斯托 | 克里斯戈 | christgau
奥科因 | 奥库安 | aucoin
佩内思 | 帕内思 | paneth
休尔塔 | 许尔塔 | huerta
彼得罗 | 佩特罗 | petro
亨萨克 | 亨塞克 | hunsaker
诺尔科伊 | 诺基 | norquoy
马克厄姆 | 梅卡姆 | makeham
齐默 | 泽默 | zemmer
斯托兹伯格 | 斯托尔兹伯格 | stolzberg
希肯洛普 | 希肯卢珀 | hickenlooper
杜克 | 杜凯 | duque
海尔凯 | 海尔基 | heilkay
弗利金格 | 弗利金杰 | flickinger
泽比娜 | 泽拜纳 | zebina
麦卡尼尼 | 麦卡内尼 | mcaneney
布拉夫 | 布劳 | blough
格拉斯戈 | 格拉斯哥 | glasgow
赫钦格 | 赫金杰 | hechinger
哈恩迪 | 哈内迪 | harnedy
布拉斯内特 | 布拉斯尼特 | brasnett
斯梅杰 | 斯梅奇 | smaje
奥利文特 | 奥利万特 | ollivant
戈洛文科 | 戈洛夫琴科 | golovchenko
麦克费德兰 | 麦克费德伦 | macphedran
奥迪吉尔 | 奥迪吉耶 | audigier
伯特胡德 | 伯绍德 | berthoud
阿尔卡尔德 | 阿尔卡德 | alcalde
比奥利 | 比利 | beoley
比塔 | 比塔尔 | bitar
姆莱卡 | 姆拉卡 | mlakar
耶登 | 伊登 | yeadon
麦克帕伦 | 麦克斯帕伦 | mcsparran
达尔维奇 | 达利奇 | dulwich
格罗塞斯特 | 格罗斯泰特 | grosseteste
施蒂布林 | 斯蒂贝林 | stiebeling
洛克希尔 | 洛希尔 | lochiel
弗赖尔 | 弗雷耶 | freyere
斯芬菲尔德 | 舍恩菲尔德 | schonfield
斯托尔普曼 | 施托尔普曼 | stolpman
弗兰普欣 | 弗兰普申 | framption
博雷特 | 博里特 | borrett
迈克尔约翰 | 米克尔约翰 | meiklejohn
拉肯迈耶 | 拉肯米尔 | lackenmier
费切姆 | 费克姆 | feachem
拉坎彭 | 拉康帕涅 | lacampagne
索维奇 | 索瓦热 | sauvage
埃尔丝 | 埃尔斯 | else
赫曼 | 赫尔曼 | herman
科帕德 | 科珀德 | coppard
巴思 | 巴特 | barthe
埃斯科菲 | 伊斯科菲 | escoffey
吉利亚姆 | 吉列姆 | gilliam
皮尔 | 皮埃尔 | pierre
博施威茨 | 博希威茨 | boschwitz
哈德格里 | 哈迪格里 | hardegree
弗利克拉夫特 | 弗利特克拉夫特 | flitcraft
皮尔 | 珀尔 | pearl
维拉雷尔 | 维拉里尔 | villarreal
比福德 | 拜福德 | byford
劳西安 | 洛西恩 | lowthian
多姆甘 | 多米扬 | domjan
阿利斯 | 阿莱斯 | allies
许泽 | 哈伊泽 | huyser
科马杰 | 康马杰 | commager
卡拉佩泰安 | 卡拉佩琴 | carapetyan
费尔富尔 | 费尔福尔 | fairfoull
布里宁 | 布赖宁 | bryning
格利多尔 | 格利德尔 | gleadall
麦奇恩 | 麦克钦 | mccheane
克拉布里 | 克拉布特里 | crabtree
埃里特 | 埃雷特 | ehret
特洛 | 特略 | tello
威克斯蒂德 | 威克斯第德 | wicksteed
维斯科利斯基 | 维斯克洛斯基 | visclosky
斯科格伦 | 斯科格隆 | skoglund
海尔兹 | 希尔兹 | hilds
拉萨尔 | 拉萨 | lassar
温塔尔 | 温特尔 | weintal
贾夫 | 贾菲 | jaffe
斯塔姆 | 施塔姆 | stamm
普朗 | 弗朗 | pfrang
法扎 | 法扎尔 | fazar
马塞尔 | 玛塞勒 | marcelle
尤因斯 | 尤温斯 | uwins
尤列维奇 | 乌莱维奇 | ulevich
达尔斯特龙 | 达尔斯特伦 | dahlstrom
希拉 | 夏伊拉 | shyla
比恩 | 比汉 | beehan
法尔肯海姆 | 福尔肯海姆 | falkenheim
洛恩 | 洛温 | lowen
德弗勒 | 德夫勒 | doerfler
伯默赛德 | 比默赛德 | bemersyde
米姆诺 | 明诺 | mimno
罗明 | 罗梅因 | romeyn
扬斯本德 | 扬哈斯本 | younghusband
沙皮 | 沙比 | sharpey
勒西奇 | 勒萨热 | lesage
杰普瑟 | 杰普撒 | jeptha
巴布利斯 | 布勃利斯 | bublys
辛皮克 | 辛皮奇 | simpich
特德福 | 塞德福德 | thedford
伯特霍尔夫 | 伯索夫 | bertholf
塞迪亚 | 切迪亚 | ceddia
戴文波特 | 达文波特 | davenport
舒特利夫 | 舒特莱夫 | shurtleff
斯波特德 | 斯波蒂德 | spotted
乔齐 | 乔茜 | jozy
赞布鲁姆 | 赞布勒姆 | zambrum
马霍恩 | 马洪 | mahone
劳克赫夫 | 劳卡夫 | laukhuff
米尔希 | 米尔海 | milhy
卡德根 | 卡杜根 | cadwgan
博希尔 | 博舍尔 | boshier
托伊恩 | 托因 | toyne
博维 | 博韦 | bovee
赫克顿 | 赫克通 | hektoen
利维 | 利瓦伊 | levi
克里亚 | 克雷 | crea
卡佐雷卡 | 库佐克雷亚 | cuzzocrea
韦德伍德 | 韦奇伍德 | wedgwood
克拉茨 | 克卢茨 | clutz
阿德基森 | 阿基森 | adkisson
施莱 | 施利 | schlie
伊菲奇妮 | 伊菲吉妮 | iphigene
泽费雷利 | 泽菲雷利 | zeffirelli
泰菲恩 | 泰维恩 | teifion
亚历克西斯 | 亚历克西丝 | alexys
本贾明 | 本杰明 | benjamin
拉罗姆 | 拉勒姆 | larom
坎帕因 | 坎佩恩 | campaigne
古茨威勒 | 古茨维勒 | gutzwiller
勒金 | 勒德金 | ludgin
阿尔皮娜 | 阿尔皮纳 | alpina
韦勒尔 | 沃雷尔 | werrell
福尔兹 | 福尔茨 | folz
德福德 | 德福特 | deford
博比萨德 | 博比苏德 | bobisud
图尔 | 特尔 | tourle
图利特 | 塔利特 | tulett
斯塔克 | 斯图克 | stucke
申伯格 | 舍恩伯格 | schonberger
兰利特 | 兰伯利特 | lambelet
盖伊 | 贾伊 | gye
利希滕斯坦 | 利克滕斯坦 | liechtenstein
安德拉斯维奇 | 安德鲁斯克维奇 | andruskevich
托德里亚斯 | 托德雷亚斯 | todreas
泰林厄姆 | 蒂林厄姆 | tyringham
比 | 布埃 | bue
埃维斯 | 阿维丝 | aveis
黑吉斯 | 海吉斯 | haigis
基珀 | 凯珀 | kuiper
阿伦 | 阿龙 | aaron
马尔克斯 | 马尔库斯 | malkus
杜奇 | 杜格 | dhooge
齐恩 | 蔡恩 | zion
格尔巴赫 | 盖尔博 | gelbach
布雷克兰 | 布里克兰 | brekland
布卡拉 | 布阿哈拉 | buachalla
里丁斯 | 赖丁斯 | ridings
沃尔克 | 沃克 | walke
库特尼 | 考特妮 | kourtney
库尔 | 屈尔 | kuehl
比利埃 | 比埃 | billiere
埃尔杰 | 埃尔格 | elger
曼恩 | 曼 | mann
埃尔坎 | 埃尔肯 | elkan
施纳克 | 施努克 | schnuck
普钦斯基 | 普辛斯基 | pucinski
贾拉特 | 贾勒特 | jarratt
尼科利 | 尼古拉 | nicolay
威尔茜 | 威尔西 | willsie
弗雷塔格 | 弗赖塔格 | freytag
撒尔肯 | 萨尔肯 | thalken
基米特 | 金米特 | kimmitt
莱撒特 | 利撒特 | leathart
赖津 | 里津 | ryzin
考德韦尔 | 库尔德韦尔 | couldwell
索利斯 | 索莱 | saulez
斯坦齐克 | 斯坦奇克 | stanczyk
巴尔索利缪 | 巴托洛缪 | bartholemeu
西克 | 瑟克 | cirker
妮科尔 | 尼科尔 | nicolle
恩德科特 | 恩迪科特 | endecott
阿尔文 | 阿尔温 | alwin
拉瑟姆 | 莱瑟姆 | lathom
休伊塞尔 | 休塞尔 | heusel
莱夫勒 | 莱弗拉尔 | leflar
罗萨佩 | 罗萨皮普 | rosapepe
赫宁伯格 | 赫宁堡 | heningburg
巴萨德 | 巴萨德雷 | basadre
福伊斯莱格 | 福伊尔齐格 | feuerzeig
塞勒斯 | 塞拉斯 | sellars
梅卢普斯 | 梅拉普斯 | mellups
马拉赫 | 马拉克 | malach
巴尔西格 | 巴尔西杰 | balsiger
希拉伯 | 希莱伯 | shillaber
布兰达斯 | 布兰德法斯 | brandfas
斯特夫斯 | 斯特弗斯 | steffes
卡斯特尔伯里 | 卡斯尔伯里 | castelberry
吉尔鲍 | 吉尔博 | guillebaud
贝切特 | 贝谢 | bechet
梅利奥 | 梅莉奥尔 | melior
鲁马塞特 | 罗马塞特 | roumasset
比特里夏 | 比阿特丽西娅 | beatricia
梅努欣 | 梅纽因 | menuhin
凯格 | 基格 | keig
菲阿尔卡 | 菲亚尔卡 | fialka
赫米斯 | 赫姆斯 | hemmes
伊萨科 | 伊萨科夫 | isakow
兹沃 | 兹瓦尔 | zwar
克伦西克 | 赫伦奇克 | chrencik
彭沃尔特 | 佩恩沃尔特 | pennwalt
库塞维茨基 | 科乌谢维茨基 | koussevitzky
伊尔特德 | 伊尔蒂德 | illtud
弗罗斯 | 弗勒泽 | froese
阿什利 | 阿什莉 | ashleigh
弗拉赫蒂 | 弗莱厄蒂 | flaherty
诺克斯 | 努克斯 | nokes
恰鲁奇 | 基亚鲁奇 | chiarucci
休尔默 | 瑟默 | thuermer
舍格尔斯 | 舍加尔斯 | shergals
福基恩 | 福金 | fokine
杜克诺伊 | 迪克努瓦 | duquenoy
波特努伊德 | 波特诺伊德 | portnoid
柯彻 | 基尔舍 | kircher
斯托岑巴赫 | 斯托曾巴赫 | stolzenbach
马德里德 | 马德里 | madrid
唐恩 | 唐 | donn
凯特尔比 | 基特尔比 | ketelbey
怀根特 | 威甘特 | wygant
博弗里 | 博韦里 | boverie
贝勒 | 贝利 | behle
阿莱格拉 | 阿利格拉 | allegra
赖克沃特 | 里克沃特 | rykwert
奥弗雷尔 | 奥法雷 | o'farrell
卢宁 | 吕宁 | luening
特金 | 图尔金 | turkin
西尔里 | 蒂里 | thierry
乔西 | 约瑟 | josee
施赖伯 | 施里伯 | shriber
迈斯兰 | 迈斯拉恩 | meislahn
利昂内尔 | 莱昂内尔 | lionel
森西尼奇 | 森塞尼奇 | sensenich
塞克斯尔 | 塞克索尔 | sexauer
比斯林霍夫 | 比斯普林霍夫 | bisplinghoff
亨尼卡特 | 亨尼克特 | hunnicutt
科斯 | 库斯 | coes
舍内曼 | 舍尼曼 | schoeneman
韦内斯 | 维内斯 | veness
哈威布斯罗克 | 哈维克斯布罗克 | hawixbrock
冈希利 | 贡希利 | goonhilly
哈里尔 | 哈丽尔 | harriel
奎恩 | 奎因 | queen
塞塞尔 | 塞斯尔 | sessel
霍金森 | 霍奇金森 | hodgkinson
阿尔奇弗龙 | 阿尔西弗龙 | alciphron
达纳根 | 杜纳根 | dunagan
特雷西 | 特蕾西 | tracey
贾克 | 吉奥克 | giauque
库蒂斯 | 柯蒂斯 | kurtis
乌斯勒 | 奥斯勒 | oursler
埃尼德 | 伊妮德 | enid
萨金特 | 瑟金特 | searjeant
拉金 | 莱金 | laging
申伯格 | 舍恩伯格 | schonberg
米特谢夫 | 米采夫 | mitseff
范格 | 范杰 | fanger
布兰钦 | 布兰昌 | blanchan
霍尔迪曼德 | 哈尔迪曼德 | haldimand
吉利亚姆斯 | 吉利亚姆 | guilliams
多奇 | 道奇 | dodge
梅莉娅 | 米利亚 | melia
斯威恩 | 斯温 | sween
弗赖赖克 | 弗赖雷克 | freireich
戈姆斯普拉塔 | 戈梅斯普拉塔 | gomezplata
布杰伊斯 | 布儒瓦 | bourgeois
安东尼奥 | 安东尼乌 | antoniou
罗伊巴尔 | 罗伊鲍尔 | roybal
布沙夫 | 布舒夫 | bushueff
萨吉特里厄斯 | 萨吉泰里厄斯 | sagittarius
比克 | 贝克 | beek
根塔 | 金塔 | genta
凯茨 | 卡茨 | katz
贝根特 | 贝金特 | baigent
雷诺埃德 | 伦瓦尔 | renouard
希拉斯 | 希勒斯 | heelas
卡尔德卢 | 考尔德克拉夫 | caldcleugh
克拉格 | 克莱格 | clague
贾西纳 | 杰西纳 | jacyna
切谢尔 | 切斯希尔 | chesshyre
朗斯伯格 | 劳恩斯伯格 | lounsburg
布雷钦 | 布里金 | brechin
古德勒姆 | 古德哈姆 | gooderham
耶格 | 耶格尔 | yager
赫普 | 霍伊普 | heup
富尔哈姆 | 富勒姆 | fulham
伯苏克 | 博苏克 | borsook
希曼娜 | 希曼纳 | sheemanna
阿德哈尼奇 | 阿德查尼克 | ardcharnich
贝迪利恩 | 贝迪利翁 | bedillion
里道特 | 赖德奥特 | rideout
麦考斯兰 | 麦考斯伦 | mcauslan
尼思代尔 | 尼斯代尔 | nithsdale
多罗西 | 多萝西 | dorothy
斯陶布 | 斯托布 | staub
斯塔宾 | 斯图宾 | stubbing
奥尔弗森 | 阿尔弗森 | alverson
索洛茨 | 索尔特斯 | solotesz
坦普拉 | 坦普勒 | templar
伦 | 莱恩 | len
德马斯托 | 德马尔托 | desmarteau
特雷索韦 | 特雷撒韦 | trethaway
谢尔普 | 谢普 | shairp
伯兹尔 | 伯塞尔 | birdsell
克洛德纳 | 科洛德纳 | kolodner
普雷彻 | 普里彻 | preacher
索恩代克 | 桑代克 | thorndike
马沙姆 | 马香 | marsham
奥伯尔曼 | 奥伯黑尔曼 | oberhelman
多尼赫 | 多尼休 | donehue
帕特里亚克 | 佩特里亚克 | patriach
利兹 | 莱什 | leisz
赖查兹 | 理查兹 | richards
艾奇森 | 艾奇逊 | eytchison
布里安特 | 布赖恩特 | briant
科尔菲亚托 | 科菲亚托 | corfiato
丹罗瑟 | 丹罗伊特 | dannreuther
巴恩比 | 巴恩贝 | barnebey
梅林达 | 梅琳达 | melinda
弗伦泽 | 弗伦策 | frenzer
康西尔 | 康斯尔 | council
沙因鲍姆 | 欣鲍姆 | sheinbaum
泰雷 | 泰里 | tyree
尚顿 | 桑顿 | szanton
赫马尼奥克 | 赫马纽克 | hermaniuk
拉曾 | 拉津 | razeen
巴塔格尔 | 巴塔杰尔 | battagel
厄勒克 | 埃厄克 | earwaker
格林达尔 | 格林德尔 | grindal
塞弗林豪斯 | 塞夫林豪斯 | sevringhaus
贾科特 | 贾科泰 | jacottet
布里利 | 布里厄利 | brealey
麦科撒奈格 | 麦科尚奈格 | maco'shannaig
麦克廷格 | 马赫廷格 | machtinger
南内曼 | 南尼曼 | nenneman
马米特 | 马梅特 | mamet
卡塞尔 | 卡瑟尔 | cuthell
迪尤斯 | 德威斯 | dewees
基茨哈伯 | 基察伯 | kitzhaber
布雷齐尔 | 布雷热 | brazier
芬尼 | 菲尼 | phinney
奥尔迪 | 阿尔迪 | alday
阿曼德斯 | 阿曼达斯 | amandus
赛纳 | 西纳尔 | synar
康查拉尔 | 康科勒 | concholar
卢娜 | 卢纳 | luna
杜纳利 | 达纳利 | dunalley
德莱奥 | 德利奥 | deleo
斯库勒 | 朔伊勒 | scheuler
特鲁曼 | 杜鲁门 | truman
惠伦 | 惠兰 | whelan
达奇 | 达基 | dachi
迪奥 | 德奥 | deo
拉思 | 雷思 | rathe
哈尔巴克 | 哈尔巴赫 | halbach
鲁特 | 鲁尔特 | rurt
克罗嫩贝格 | 克罗嫩伯格 | kronenberg
乌斯顿 | 奥斯顿 | ouston
克里奇顿 | 克赖顿 | crichton
格温德德 | 格威内思 | gwynedd
道伊 | 杜伊 | douie
沃姆尔多夫 | 沃梅尔多夫 | womeldorph
布奇 | 布谢 | bouchey
鲍尔斯 | 鲍威尔斯 | powels
罗雷姆 | 罗勒姆 | rorem
沃蒂埃 | 沃捷 | vautier
安德里奥 | 安德里厄 | andrieux
阿莱恩 | 阿林 | alleine
贝克 | 贝克尔 | becker
纳赫纳诺夫 | 纳赫马诺夫 | nachmanoff
怀索基 | 维索茨基 | wysocki
杜克 | 迪克 | duecker
扎赫曼 | 扎克曼 | zachmann
海斯洛普 | 希斯洛普 | hyslop
诺伦 | 诺伦德 | norlund
里夫尔 | 里弗尔 | riffle
杜克罗 | 迪克罗 | ducrow
沃尔克 | 沃克 | walk
沃尔克 | 沃克 | walker
巴里厄斯 | 巴里奥斯 | barrios
麦科拉姆 | 麦科勒姆 | mccollam
斯坦达洛夫特 | 斯坦德洛夫特 | standaloft
厄尔克伦茨 | 厄克伦茨 | ercklentz
德沃查克 | 德沃夏克 | dvorchak
科赫兰 | 库格伦 | coughran
多克特 | 多克托 | docktor
卢尔 | 勒尔 | lull
希尔茨 | 希尔兹 | shields
菲内尔 | 芬内尔 | feennell
皮克普 | 皮卡普 | pickup
塞门扎 | 西门扎 | semenza
汤明森 | 托明森 | tominson
蔡恩 | 夏恩 | cheyenne
彼得龙 | 佩特龙 | petrone
格里桑蒂 | 格里桑迪 | grisanti
马尔斯 | 马雷斯 | mares
安奈林 | 阿内林 | aneirin
劳比克 | 鲁比克 | roubik
冈利 | 高恩利 | gownley
劳本戴尔 | 劳本盖耶 | laubengayer
阿图鲁斯 | 阿图罗斯 | arturous
拉腊比 | 拉勒比 | larabee
埃斯卡德安安 | 伊斯坎达里安 | eskandarian
贾洛伦西 | 贾洛伦齐 | giallorenzi
特穆多 | 塞穆多 | themudo
科尔奎特 | 科尔基特 | colquitt
贝松 | 贝森 | bessone
苏伊代尔 | 舍代尔 | suirdale
哈莫尔 | 哈默 | hamor
博索沃思 | 博索姆沃思 | bosomworth
普普 | 普珀 | puppe
施米德 | 施密德 | schmid
塔默格尔 | 塔穆格尔 | tarmugl
黑尔 | 海尔 | haire
哈克威尔 | 黑克威尔 | hakewill
冈扎莱亚 | 冈萨雷斯 | gonzalez
莫纳 | 莫娜 | mona
格雷纳 | 格兰妮 | grainne
布里霍尔特 | 布赖霍尔特 | bryholdt
兹韦德林 | 兹沃德林 | zwerdling
特鲁埃特 | 特鲁哈特 | trueheart
麦克斯托扬 | 麦克斯蒂奥芬 | macstiofain
亚里莫维奇 | 雅里莫维奇 | yarymovych
塞尼奥尔 | 西尼尔 | senior
哈特赛德 | 哈齐德 | hartsid
博伊斯拉根 | 博勒根 | boisragon
里伯特 | 雷巴特 | rebut
梅特罗波尔斯 | 梅特罗波利斯 | metropolis
索热 | 索热尔 | saussure
伦拉戈托克 | 兰加托克 | llangattock
科克森 | 考克森 | coxon
斯克拉塔 | 斯克鲁泰特 | scrutator
格丽泽 | 格赖泽 | griser
贝拉妮娅 | 贝拉尼亚 | berania
戈尔德史蒙 | 戈德西蒙 | goldsymon
许尔霍尔兹 | 许霍尔茨 | schuerholz
肖凯尔 | 肖基尔 | showkeir
科尔海普 | 科尔黑普 | kohlhepp
希纳汉 | 赫纳汉 | henahan
鲁科 | 罗科 | ruocco
巴齐利 | 巴尔齐莱 | barzilay
加诺尔 | 加诺 | ganor
鲍德施韦勒 | 巴尔德施维勒 | baldeschwieler
斯洛尼姆 | 斯洛宁 | slonim
马萨 | 玛莎 | martha
福内斯 | 福尼斯 | forness
卡斯特莱恩 | 卡斯特兰 | castellain
珀塞克 | 佩塞克 | perseck
维伦 | 瓦伊伦 | viron
索尔茨 | 肖尔茨 | soults
乔西亚斯 | 乔赛亚斯 | josias
热罗尔德 | 杰罗尔德 | gerould
耶尔 | 耶格 | jaegher
加弗 | 盖弗 | gaver
西金 | 西尔金 | sirkin
瓦伦祖拉 | 巴伦苏埃拉 | valenzuela
肖尔斯 | 肖沃斯 | showers
弗卢克斯 | 弗勒克斯 | flux
特劳布里奇 | 特鲁布里奇 | troubridge
亚达曼 | 阿达姆南 | adamnan
林恩 | 林 | linn
里查德 | 理查德 | richard
罗伯森 | 罗伯逊 | robertson
利沃克 | 莱夫奥克 | liveoak
普鲁斯曼 | 普拉斯曼 | prusman
基弗 | 凯弗 | keifer
吉安 | 吉亨 | gehan
施努克恩 | 施努克内 | schnukne
阿加尔 | 阿高尔 | argall
比特勒 | 博伊特勒 | beuttler
温纳斯特伦 | 温纳斯特鲁姆 | wennerstrum
利德克 | 利迪克 | luedecke
普卢内基 | 普伦尼克 | pluenneke
赫希特里特 | 赫什特里特 | hirschtritt
贝拉德 | 贝拉尔 | berard
马尔夫农 | 马尔韦农 | mulvenon
皮珀 | 派珀 | piper
卡莉什 | 卡利什 | kalish
格丽索戈尼 | 格丽索戈尼娅 | grisogonia
豪瑟姆 | 豪萨姆 | howsam
科菲恩 | 科芬 | coffeen
迈伯格 | 迈伯勒 | myburgh
阿特尔西 | 阿特莱西 | attlesey
加格宾宾 | 加涅班 | gagnebin
埃克斯 | 阿克斯 | acres
布莱希米特 | 布莱希施米特 | blechschmidt
赫维茨 | 赫威茨 | herwitz
布卢克 | 布劳克 | blouke
德雷斯克 | 德赖斯克 | dreiske
马马杜克 | 马默杜克 | marmaduke
普雷尔 | 普里尔 | preil
贝丘克 | 贝尤克 | bayuk
科尼罗 | 科内罗 | corneiro
奎伦 | 奎林 | quillen
斯托夫蒂斯 | 斯托克维斯 | stokvis
贝思 | 贝丝 | beth
比霍尔特 | 伯霍尔特 | byrholdt
普罗文克 | 普罗文彻 | provencher
约赫 | 约埃 | yohe
恩杰 | 恩弗 | engfer
亚特伦 | 亚特隆 | yatron
格瓦托斯基 | 格瓦尔托夫斯基 | gewartowski
伊卡德 | 伊查德 | eachard
加特谢特 | 加切特 | gatschet
里奥塔 | 里乌塔 | riutta
普伦蒂 | 普朗蒂 | prunty
诺特恩 | 诺滕 | naughten
奥洛克林 | 奥劳克林 | o'laughlin
梅约拉斯 | 马约拉斯 | mayoras
维西 | 维齐 | veysey
沃尔斯特纳夫特 | 沃斯通克拉夫特 | wollstonecraft
奥肯 | 奥凯恩 | o'kane
法夫罗特 | 法夫罗 | favrot
阿曼 | 阿尔曼 | arman
阿米欧 | 阿米奥特 | amiot
阿德尼 | 埃德尼 | adney
波克 | 普克 | poock
莫莱瑙尔 | 莫勒瑙尔 | mollenauer
斯凯尔斯 | 斯基尔斯 | skiles
芬维西 | 芬韦西 | fenvessy
帕奇 | 帕克 | pach
萨森 | 萨瑟恩 | southern
巴查尔 | 巴卡尔 | bachar
奥尔博 | 阿尔博 | allbaugh
加米特 | 加梅特 | gamet
凯尼斯 | 基尼斯 | kiness
德利戈里斯 | 德利乔治斯 | deligiorgis
艾森赫特 | 艾森哈特 | eisenhart
加雷尔 | 加勒尔 | garel
奥尔 | 奥利 | ole
巴德温 | 布德温 | budwine
迪奥 | 戴奥 | dio
莱维 | 利维 | levie
格朗基 | 格朗茨基 | groncki
加尔肯 | 加肯 | garcon
沃米利 | 沃姆利 | wormeley
拉克伦 | 洛克伦 | loughran
埃芬蒙 | 埃菲门科 | efimenco
戴姆里克 | 德姆里克 | daemmrich
肖尔德勒 | 斯科德勒 | scholderer
迪比 | 达比 | duby
贝尔比 | 比尔比 | beilby
博斯金德 | 博斯坎德 | boskind
瑟维尔 | 瑟维耶 | surveyer
缪伊尔 | 缪尔 | muille
纽尼梅克 | 努尼梅克 | nunemaker
阿尼斯 | 安妮斯 | anis
阿布林 | 埃布林 | ablin
班德 | 班德尔 | bander
罗索尔 | 罗塞尔 | rossall
福塞特 | 福西特 | fawssett
阿加斯 | 阿加丝 | agase
阿蒂亚 | 阿提耶 | atiyeh
伦芬特 | 朗方 | lenfant
尤弗罗西恩 | 尤弗罗西尼 | euphrosyne
艾娅拉 | 阿亚拉 | ayala
卡尔卡诺 | 卡尔卡尼奥 | calcagno
梅因威林 | 梅因沃林 | mainwaring
彼特里兹 | 佩特里迪斯 | petrides
科德尔 | 科德 | corder
戴文 | 达文 | davern
罗珊妮 | 罗珊 | rozanne
格林霍 | 格里诺 | greenhow
格利摩 | 格利穆尔 | glymour
戈歇尔 | 戈查尔 | gotshal
埃利娜 | 埃琳娜 | elena
杜 | 杜韦 | duwe
布雷德 | 布里德 | breder
萨韦尔 | 萨维尔 | savelle
麦加恩 | 麦加亨 | mcgahern
勒班 | 莱班 | leban
温特罗普 | 温思罗普 | winthrop
穆拉尔特 | 缪拉尔持 | muralt
萨洛梅 | 萨洛米 | salome
利克曼 | 莱克曼 | likeman
玛丽萨 | 马里萨 | marisa
肖纳 | 肖娜 | shauna
克鲁什 | 克鲁伊什 | kerruish
沙帕 | 沙帕尔 | shapar
布尔滕豪斯 | 博尔廷豪斯 | boultinghouse
尤金尼亚 | 尤金妮亚 | eugenia
梅德沃多斯基 | 梅德瓦多夫斯基 | medwadowski
希厄特 | 海厄特 | hieatt
法茨 | 菲茨 | fites
科格代尔 | 科格德尔 | cogdell
特里贝瑟 | 特里布沃瑟 | triebwasser
惠奇利夫 | 惠特克利夫 | whitchliffe
怀森 | 威森 | wison
德彻特 | 德克特 | dechert
奥利夫 | 奥利芙 | olive
德弗尼 | 迪夫尼 | deveney
海姆索特 | 海姆塞特 | heimsoth
弗德里 | 维德里 | verdery
希伯德 | 希巴德 | hibbard
盖斯特菲尔德 | 盖斯特费尔德 | geistfeld
埃格特 | 埃格伯特 | egbert
塔利亚里福 | 托利弗 | taliaferro
利塞特 | 莱西特 | lycett
莱贡 | 利根 | lygon
奥莱克西 | 奥莱克休 | oleksiw
阿莱斯 | 阿莱 | allez
卡德瓦拉迪 | 卡德瓦拉德 | cadwaladyr
萨尔温 | 西尔温 | sulwen
坦克蕾托 | 坦克雷托 | tancreto
伯克隆 | 伯克伦 | berklund
拜萨特 | 比萨特 | bisat
德雷南 | 德雷宁 | drennen
德彻 | 德谢尔 | decher
巴特伦 | 巴特拉姆 | buttram
特鲁齐 | 特拉齐 | truzzi
蒙特莫罗诺 | 蒙特莫雷诺 | montemoreno
托里 | 托丽 | tori
卡里洛 | 卡里略 | carrillo
比比 | 毕比 | beeby
马瑟纳 | 马塞纳 | marthena
杰内森 | 吉尼森 | genesen
卡莉 | 卡利 | cali
盖滕拜因 | 盖滕宾 | gaitenbein
