布雷金里奇 | 布雷肯里奇 | breckinridge
塞德 | 切德 | cedd
哈格森 | 哈根森 | haagensen
梅利 | 马利 | maly
阿西尼加 | 阿西涅加 | arciniega
霍普特 | 豪普特 | houpt
西恩 | 西根 | seaghan
斯特拉瑟恩 | 斯特拉森 | strathearn
派珀特 | 佩珀特 | peipert
皮内 | 皮奈 | pinay
梅雷斯曼 | 米尔斯曼 | meresman
弗兰宗 | 弗兰曾 | franzon
伊兹比基 | 伊兹比茨基 | izbicky
伊卡维斯特 | 埃沙韦斯特 | echaveste
米尔黑德 | 缪尔黑德 | muirhead
舒普 | 肖普 | shoupp
普安 | 普汉 | puhan
沃塞尔 | 瓦塞尔 | wassell
西金特 | 萨金特 | seargent
亨巴克 | 亨巴赫 | heimbach
纳尔迪 | 纳迪 | nardi
杰米马 | 杰迈玛 | jemima
莫杜伊特 | 莫德维 | mauduit
惠塔克 | 惠特克 | whitacre
艾特 | 艾厄特 | eyet
耶德利 | 亚德利 | yeardley
欣奇利夫 | 欣奇克利夫 | hinchcliffe
博比 | 鲍比 | bobbie
麦基尔文娜 | 麦基尔温纳 | macilvenna
莱因斯 | 赖恩斯 | rines
麦克费伦 | 麦克弗伦 | mcpherren
博特尔 | 博索尔 | botsal
科尔伦 | 科尔雷因 | coleraine
厄德曼 | 厄尔德曼 | erdman
戈伦比斯基 | 戈伦别夫斯基 | golembiewski
格雷戈伊尔 | 格雷瓜尔 | gregoire
米卡贾 | 迈凯亚 | micajah
莱德洛 | 莱德劳 | laidlaw
科姆萨罗夫 | 科梅萨罗夫 | komesaroff
雷梅克斯 | 拉马克斯 | raemakers
皮凯弗 | 皮卡弗 | piccaver
苏布林 | 萨布林 | subrin
斯克拉顿 | 斯克鲁顿 | scrutton
哈兹利特 | 黑兹利特 | hazlitt
津嫩 | 津宁 | zinnen
布盖兹 | 布尔盖兹 | bourgaize
佩莱蒂尔 | 佩尔蒂埃 | pelletier
帕塞尔 | 帕斯尔 | parcel
霍诺里 | 霍诺丽 | honori
西明顿 | 赛明顿 | symington
布龙海姆 | 布朗海姆 | bronheim
马霍尔特 | 玛奥 | mahault
法伊克 | 菲克 | fike
奥德斯 | 奥杜斯 | audus
沃伊蒂克 | 沃伊蒂奇 | woytych
韦克特尔 | 瓦赫特尔 | wachtel
夏维尔 | 希维尔 | shivell
拉蔡斯 | 拉雪兹 | lachaise
达维格多 | 达维多尔 | d'avigdor
加莱夫 | 加利夫 | galef
玛吉 | 马吉 | magi
曼纳韦 | 马纳韦 | mannaway
梅恩 | 米恩 | meighen
维尔迪斯科 | 弗迪斯科 | verdisco
艾佐德 | 伊佐德 | izod
特马 | 托伊马 | teuma
奥格 | 奥 | ough
阿富蒂特 | 阿富尔蒂特 | affourtit
米萨尔 | 米赛尔 | misael
赫默里赫 | 亨默里克 | hemmerich
黑伍德 | 希伍德 | heawood
詹宁斯 | 杰宁斯 | jenyns
斯塔姆斯 | 斯泰姆斯 | stames
安瓦里波尔 | 安瓦里普尔 | anvaripour
莱伯恩 | 利伯恩 | liburn
比布 | 毕比 | beebe
考尔德尔 | 考德尔 | caldell
博查特 | 博哈特 | borchardt
卡明 | 卡迈恩 | carmine
巴特伦 | 巴特拉姆 | bartram
派尔 | 皮尔 | peile
麦康 | 麦肯 | mccon
舒克伯格 | 舒克伯勒 | schuckburgh
麦卡里 | 麦凯里 | mccarey
英范特 | 因方特 | infant
亨内基斯 | 亨尼肯斯 | hennekens
吉弗 | 贾埃弗 | giaever
贾米 | 杰米 | jamie
鲍尔霍恩 | 巴尔霍恩 | ballhorn
莫克萨姆 | 莫克塞姆 | moxam
卡姆 | 卡尔姆 | culme
比克姆 | 比卡姆 | bickham
夏伊尔曼 | 沙伊尔曼 | shireman
梅索利 | 梅索伊 | meszoly
埃森斯 | 埃森丝 | essence
格沃思米 | 格瓦思米 | gwathmey
巴比罗利 | 巴尔比罗利 | barbirolli
利布 | 利比 | luebbe
黑泽尔 | 黑兹尔 | hazell
施蒂宁 | 斯蒂宁 | stiening
金德雷德 | 金德里德 | kindred
纳索尔 | 纳托尔 | nuthall
佐扎 | 佐尔扎 | zorza
戴格 | 戴伊 | daigh
伊坦 | 埃泰恩 | etain
勒罗伊德 | 利罗伊德 | learoyd
巴策 | 巴策尔 | batzer
廷肯 | 廷康 | tinkon
德弗雷特斯 | 迪弗雷特斯 | defrates
奥尔文厄姆 | 阿尔文厄姆 | alvingham
尤拉姆 | 乌拉姆 | ulam
沙德伯格 | 谢德伯格 | schadeberg
格罗布 | 格罗比 | grobe
塔塔利诺 | 塔尔塔利诺 | tartaglino
兰布 | 拉姆 | lambe
卡德韦尔 | 考德威尔 | caldwell
泽米娜 | 泽米纳 | zemina
希莉 | 赫利 | helie
坎特伯里 | 坎特伯雷 | canterbury
塔肯 | 泰肯 | tacon
弗森 | 费尔森 | ferson
托皮 | 托毕 | torpey
泰奇曼 | 泰克曼 | teichmann
普鲁德霍姆 | 普鲁多姆 | prudhomme
基斯特纳米 | 基斯特纳萨米 | kistnasamy
祖格 | 佐格 | zeug
坎比 | 坎贝 | cumbey
赫姆尔 | 赫姆利 | hermle
蒙冈 | 蒙贡 | mongon
亨佩尔 | 亨普尔 | hempel
艾罗 | 艾罗尔特 | ayrault
赖蒂娜 | 赖蒂纳 | rytina
雷亚 | 雷 | rea
富加特 | 富盖特 | fugate
德卢伊吉 | 德路易吉 | deluigi
科切雷斯 | 科克里斯 | cocheres
霍斯伯格 | 霍斯伯勒 | horsburgh
鲁德 | 鲁阿兹 | ruadh
埃塞雷达 | 埃塞丽达 | ethelreda
迪恩娜 | 迪恩纳 | dienna
博里尔 | 博雷尔 | boreel
布雷恩 | 布里恩 | brehon
吉尔 | 圭尔 | guire
尤丘克 | 尤尔丘克 | yurchuck
坦尼肯 | 滕尼肯 | tennican
麦金泰尔 | 麦金太尔 | mcintire
利文 | 莱文 | levene
克拉尔斯 | 克拉雷斯 | clares
杜林科 | 祖林科 | dzurinko
林利戈 | 林利思戈 | linlithgow
切普林斯基 | 西普林斯基 | cieplinski
索朱纳 | 索杰纳 | sojourner
布鲁赫豪森 | 布鲁克豪森 | bruchhausen
纽贝尔 | 努贝尔 | knubel
卡诺钱 | 卡诺坎 | carnochan
吉亨 | 吉赫诺 | giheno
罗克辛 | 罗克西娜 | roxinne
伦塞莱尔 | 伦塞勒 | rensselaer
伊登斯 | 埃登斯 | edens
贾姆森 | 詹姆森 | jameson
比哈里尔 | 贝哈里尔 | beharriell
朗查普 | 朗香 | longchamp
贝德纳斯基 | 贝德纳尔斯基 | bednarski
库特鲁费洛 | 卡特鲁费洛 | cutrufello
威尔希特 | 威尔海特 | willhite
洛伦兹 | 洛伦茨 | lorenz
特普尔 | 蒂普尔 | tepoel
贾莫 | 贾伊莫 | giaimo
海因斯 | 海恩斯 | hains
库尔吉安 | 库尔金 | kuljian
哈米利恩 | 哈米里恩 | hamilyon
基尔库西 | 基尔科西 | kilcoursie
里索诺弗 | 里曾诺弗 | reasonover
查肯 | 查康 | chacon
雷布萨门 | 里布萨门 | rebsamen
托菲琴 | 托菲肯 | torphichen
沃格斯塔夫 | 瓦格斯塔夫 | wagstaffe
戈特尔斯 | 戈瑟尔斯 | goethals
黑特姆 | 哈特姆 | hatem
瓜尔蒂里 | 瓜尔蒂耶里 | gualtieri
泽兰 | 齐伦 | zeran
比贝尔 | 比布尔 | biebel
奥德斯泰尔 | 奥尔德斯泰尔 | oldstyle
西门斯 | 西门子 | siemens
普利本 | 普利邦 | plybon
贝克纳 | 比克纳 | beichner
恩霍尔姆 | 恩格霍姆 | engholm
兰尼伯格 | 兰恩伯格 | ranneberger
桑德威克 | 桑威克 | sandwick
威思 | 韦思 | wyeth
施韦基尔德 | 施韦柴尔德 | schweichild
斯坦霍普 | 斯坦诺普 | stanhope
英沃尔兹塔德 | 英沃斯塔德 | ingvoldstad
森厄 | 桑戈尔 | senghor
布赖豪斯 | 布里格豪斯 | brighouse
克伦布哈尔 | 克伦巴尔 | krumbhaar
斯彭塞 | 斯潘塞 | spenser
莫拉尔 | 莫勒 | morar
弗里利 | 弗赖利 | friley
赖兰斯 | 赖伦斯 | rylance
贝尔兹 | 比尔兹 | beards
哈扎德 | 哈泽德 | hazard
穆谢特 | 马希特 | mushet
菲尔金斯 | 弗金斯 | firkins
布鲁姆利 | 布伦利 | brumley
比尔特 | 伯特 | birt
明 | 米恩 | min
菲格雷斯 | 菲格斯 | figures
特库姆西 | 特库姆塞 | tecumseh
伊万杰莉斯塔 | 埃万杰利斯塔 | evangelista
韦布利 | 韦伯利 | webley
帕门蒂尔 | 帕尔芒捷 | parmentier
迪安吉利斯 | 迪安杰利斯 | deangelis
泰克斯通 | 西克斯通 | theakstone
格里纳尔特 | 格里纳沃尔特 | greenawalt
麦格拉斯里奇 | 麦格拉斯里克 | macglasrich
芭布 | 巴布 | baab
巴洛克 | 巴洛赫 | balloch
切尔内斯基 | 切尔涅斯基 | chernesky
克龙 | 克朗 | kron
贝莱沃 | 贝尔维 | bellevue
西博恩 | 西伯恩 | seaborn
里斯伯格 | 赖斯伯格 | riseberg
布劳恩 | 布朗 | braun
赫卡尼克 | 赫雷查尼克 | hrechanyk
特里利文 | 特里莱文 | treleaven
肖沃尔顿 | 肖维尔顿 | shovelton
比内尔 | 比尤内尔 | buesnel
阿迪 | 埃迪 | adye
哈格迈耶 | 哈格迈尔 | hagemeyer
凯蒂亚 | 凯蒂娅 | katia
阿拉蒙 | 阿拉芒 | allamong
西米恩 | 西明 | siemien
罗恩德 | 罗安德 | rowand
普里亚尔 | 普赖尔 | prial
布利萨克 | 布利萨茨 | blisac
马尼斯 | 马内斯 | maness
拜德斯 | 比德兹 | bidez
厄威尔 | 厄维尔 | irwil
威尔梅特 | 薇尔梅特 | wilmett
尼迪 | 内迪 | neddy
纳拉乔 | 纳兰霍 | naranjo
布雷兰 | 布里兰 | breland
卡尔 | 卡利 | karle
勒尔克 | 罗尔克 | roelker
阿德莉娜 | 阿德利娜 | adelina
斯特尔特 | 斯泰尔特 | stelter
明韦尔 | 米恩韦尔 | meanwell
沙克伯格 | 沙克伯勒 | shuckburgh
亚历山森 | 亚历山德森 | alexanderson
保斯 | 波斯 | paus
朱皮特 | 丘辟特 | jupiter
多伊特里奇 | 多伊特里希 | deutrich
托厄里 | 托尔里 | towery
马德林 | 马德琳 | madlin
威舍 | 维舍 | wischer
戴加 | 迪格 | dygard
库比特 | 丘比特 | cubitt
西克雷斯特 | 西克里斯特 | secrest
拉扎 | 拉扎尔 | lazar
蒂里克 | 泰里克 | tyriq
麦高恩 | 麦古恩 | macgoun
佩茨 | 皮特斯 | petes
皮克斯 | 皮尔克斯 | pearkes
费尔哈文 | 费尔黑文 | fairhaven
索恩伯格 | 索恩伯勒 | thornburgh
特里德加 | 特里迪加 | tredegar
埃瑟 | 阿瑟 | acer
阿丽 | 阿利 | alli
阿蒂盖尔 | 阿蒂格尔 | attygalle
马西娅 | 玛西娅 | mathea
佩得鲁斯卡 | 彼特鲁斯卡 | petruska
弗恩 | 维恩 | verne
尤迪切洛 | 尤迪塞洛 | iudicello
韦姆 | 瓦伊姆 | waim
鲁兰 | 鲁伦 | ruellan
拉赫特 | 拉克特 | lachter
拉哈 | 雷哈布 | rahab
麦金纳尼 | 麦基纳尼 | macinerney
斯蒂格勒 | 施蒂格勒 | stigler
特威宁 | 特文宁 | twining
西达鲁斯 | 西达劳斯 | sidarouss
弗洛尔迪尤 | 弗劳尔迪 | flowerdew
盖兰 | 格兰 | gellan
吉梅尼兹 | 希门尼斯 | jimenez
韦尔纳 | 沃尔纳 | woellner
加米齐 | 加梅齐 | garmezy
布拉德劳 | 布拉德洛 | bradlaugh
尼斯克恩 | 尼斯肯 | kniskern
布鲁因 | 布勒因 | bruyn
塔米赫尔 | 塔米希尔 | tamihere
库劳 | 库罗 | courau
麦格罗伊瑟 | 麦格鲁瑟 | macgreuther
柯蒂尼厄斯 | 柯特纽斯 | curtenius
赫利娜 | 赫莉娜 | helina
伊特拉格 | 伊泰拉格 | itteilag
斯特朗奇 | 斯特朗 | stronge
戴伦弗思 | 迪伦弗思 | dyhrenfurth
麦克努尔蒂 | 麦克纳尔蒂 | macenulty
沃塞斯 | 沃西斯 | wathes
杜布拉斯 | 杜布拉 | dubras
亚兹明 | 亚斯明 | yazmin
劳德代尔 | 劳德戴尔 | lauderdale
伯贝奇 | 伯比奇 | burbage
扎纳 | 策纳 | zaehner
科尔尼特 | 科尔内特 | collnette
波洛斯 | 普洛斯 | poulos
莱万多 | 柳安多 | lewando
克莱恩 | 克莱因 | clyne
弗里岑 | 弗里曾 | fritzen
特佩凯 | 特佩卡 | tepaika
贝尔希 | 贝尔赫 | bailhe
斯科克罗夫特 | 斯考克罗夫特 | scowcroft
金泽特 | 金瑟特 | gensert
麦卡尔 | 麦考尔 | mackal
赛奇 | 赛什 | saich
皮奥特罗夫斯基 | 彼得罗夫斯基 | piotrowski
贾恩 | 扬 | jahn
康加尔顿 | 康高尔顿 | congalton
杜瓦克斯 | 杜阿克斯 | duax
沙滕克 | 沙滕柯克 | schattenkerk
盖尔特纳 | 盖特纳 | gaertner
法隆 | 法伦 | falloon
奥斯威 | 奥斯威尤 | oswiu
兰德威西 | 兰德沃西 | landwirthy
索锡 | 索西 | southee
米隆 | 米伦 | millon
艾利 | 艾莉 | eily
埃克恩 | 伊肯 | ekern
菲利恩 | 菲利翁 | filion
舒恩 | 舒尚 | shooshan
莫佩斯 | 莫皮斯 | moppes
阿莱维 | 阿利维 | alevey
帕塞尔 | 帕斯尔 | parcell
泰巴尔特 | 蒂博尔特 | tybalt
索尔 | 苏尔 | soul
德多 | 戴德奥 | dedeo
塞达 | 西达 | theda
布拉夫 | 布洛 | bullough
帕珀马斯特 | 佩珀马斯特 | papermaster
贝伦德斯 | 贝伦兹 | berendes
施雷德 | 施拉德 | schrade
安格尔 | 安杰尔 | angel
伯克 | 比尔克 | birck
巴托尔森 | 巴托尔松 | bartholdson
英格林 | 英林 | yingling
查努廷 | 查纽廷 | chanutin
埃塞克 | 伊塞克 | esek
迈尔霍弗 | 迈尔霍费尔 | maierhofer
马伦普尔 | 马伦普雷 | malempre
斯拉克 | 斯莱克 | slack
阿尔顿 | 阿里顿 | arreton
莫尔菲 | 莫菲 | morfee
贝哈 | 贝亚 | beha
法尔布伦斯 | 法尔布兰斯 | firebrance
肯尼 | 森尼 | cenni
博尔多 | 波尔多 | bordeaux
德西德里厄斯 | 德西迪里厄斯 | desiderius
撒尔戈特 | 索尔戈特 | thalgott
舍恩巴克 | 舍恩巴赫 | schoenbach
马格尼尔 | 马尼耶 | magnier
奥尔特林赫姆 | 奥特林厄姆 | altrincham
艾尔纳姆 | 埃努姆 | aernum
麦基尔维 | 麦基雷维 | macilrevie
莱夫勒 | 莱弗勒 | leffler
科卡姆 | 科克姆 | corkum
哈夫纳 | 哈文纳 | havenner
格威卡德斯 | 格威查德斯 | gwychardus
莫布斯比 | 莫布兹比 | mobsby
赛尔斯 | 西尔斯 | cyres
泰夫 | 塔夫 | tave
阿奎约 | 阿夸约 | aquayo
弗雷林休森 | 弗里林海森 | frelinghuysen
帕杰利斯 | 帕盖利斯 | pargellis
莱普尔 | 勒普尔 | lepoer
布雷斯劳斯基 | 布雷斯拉夫斯基 | breslawsky
达夫恩 | 达夫妮 | daphne
恩德烈尼 | 恩德雷尼 | endrenyi
麦克莱夫 | 麦克拉夫 | mcclave
麦康基 | 麦康希 | macconchy
桑德姆 | 桑达姆 | sandham
里穆斯基 | 里莫斯基 | rimouski
马宁 | 曼宁 | maning
布莱胡特 | 布拉胡特 | blachut
赫明 | 亨明 | hemming
蒂文加德姆 | 蒂文加杜姆 | tirvengadum
格内罗 | 吉尼罗 | genero
比斯特 | 比伊斯特 | buist
拉拉莫尔 | 拉腊莫尔 | laramore
哈克 | 黑克 | hake
哈什哈根 | 哈舍根 | hashagen
里尔斯 | 赖亚尔斯 | ryalls
梅伦 | 默龙 | merron
斯托沃尔 | 斯托瓦尔 | stovall
贝基 | 巴基 | bakey
鲁兹 | 吕埃 | ruez
怀曼 | 威曼 | wiman
拉德布罗克 | 拉德布鲁克 | ladbroke
卢斯蒂希 | 卢斯蒂格 | luistig
昂斯莱格 | 奥恩斯莱格 | oenslager
哈加丁 | 哈格丁 | hargadine
莱克希姆 | 利克希姆 | leikhim
沃茨哈夫特 | 沃特沙夫特 | wirtschafter
伊默斯 | 伊穆斯 | imus
托赫 | 托克 | toch
杜温特 | 德温特 | dewenter
皮得菲尔德 | 彼得菲尔德 | peterfield
加瓦尔特 | 加沃尔特 | gawalt
斯普勒 | 施普勒 | spuhler
马诺赫 | 马诺克 | marnoch
阿马尼 | 阿尔马尼 | armani
弗莱布 | 弗莱比 | flebbe
汤姆斯 | 图姆斯 | tombs
达夫伦 | 杜弗隆 | duflon
本恩 | 本 | benn
梅纳姆 | 梅纳汉 | menaham
麦基利肯 | 麦基利坎 | mackillican
多里 | 多丽 | dorrie
法尼夫 | 法纳夫 | faneuf
科克拉泽 | 科尔克拉泽 | colclaser
罗赫 | 罗奇 | roch
勒温克龙 | 洛温克伦 | lowenkron
多罗 | 多拉夫 | dorough
巴尔尼尔 | 巴尼尔 | balniel
菲林 | 法尔林 | firing
克莱姆 | 克莱米 | klemme
费尔 | 费雷 | ferre
安娜贝尔 | 安娜贝勒 | annabelle
贝瓦因 | 博伊文 | boivin
西特龙 | 西特伦 | citron
福伊西 | 福西 | feusi
江伯格 | 宗伯格 | zumberg
萨加 | 塞格尔 | sagar
恩格兰 | 英格兰 | england
科伦吉 | 科隆吉 | colonghi
利弗塞奇 | 利弗西奇 | liverseidge
阿布 | 阿贝 | abbe
博瓦万坦 | 博伊斯方丹 | boisfontaine
麦卡厄蒂 | 麦克哈蒂 | mccahearty
塞弗里 | 萨弗里 | savery
布赖滕菲尔德 | 布赖滕费尔德 | breitenfeld
伯格哈德 | 伯格哈特 | burghard
厄尔普 | 厄普 | earp
蒙多尔 | 蒙多 | mondor
施赖纳 | 施里纳 | shriner
斯塔布尔菲尔德 | 斯塔布菲尔德 | stubblefield
维皮勒 | 韦皮勒 | verpilleux
汤南 | 汤恩德 | townend
杰普恩 | 杰波恩 | jepoen
伯肯霍尔茨 | 伯肯霍尔兹 | birkenholtz
默茨 | 默特斯 | mertes
勒克特 | 勒基特 | luckett
伊德 | 伊德尔 | eader
维诺格拉德 | 维诺格勒 | vinograd
安纳莫尔 | 安纳克莫尔 | annaghmore
斯图德曼 | 斯蒂德曼 | studeman
勒安 | 勒林 | lelean
布里森 | 布赖森 | bridson
马达维克 | 马达维赫 | mhadavikh
戈勒布 | 戈卢布 | golub
达拉克 | 杜拉奇 | dullach
肖尔德 | 索尔德 | szold
杜普卡克 | 杜普恰克 | dupcak
布雷登 | 布拉顿 | bradon
奥西 | 奥齐 | orczy
贝姆 | 巴姆 | bame
普利马尔 | 普莱梅尔 | plymale
布罗梅特 | 布罗米特 | bromet
皮科维亚克 | 皮乔维亚克 | piechowiak
阿查博尔 | 阿查巴尔 | archabal
惠特伯格 | 惠特伯勒 | whitburgh
迪伯曼 | 杜伯曼 | duberman
霍莫尔卡 | 霍穆尔卡 | homolka
海斯伯格 | 海斯堡 | heisborg
费尔德里尔 | 费德布里尔 | feldbrill
杰农 | 热农 | gernon
斯顿特 | 斯坦特 | stunt
埃利斯 | 埃莉丝 | elyse
克勒勒 | 克雷勒 | kroehler
谢米宁 | 切米宁特 | cheminint
迪本 | 德本 | deben
克丽扎 | 克里扎 | kryza
法斯纳赫特 | 法斯纳克特 | fasnacht
赫姆霍尔特 | 赫尔姆霍尔特 | helmholdt
布根 | 巴根 | bugan
佩奇 | 皮奇 | pechey
施瓦姆 | 施万布 | schwamb
奥里 | 奥赖 | ory
艾尔弗里克 | 阿尔弗里克 | aelfric
艾尔加 | 艾尔格 | eylgar
伊伊 | 伊 | yee
桑内曼 | 索恩曼 | sonnemann
奥赞妮 | 奥赞 | ozanne
沙普尔斯 | 沙普利斯 | sharpless
德黑 | 德哈恩 | dehaan
雷诺 | 雷纳 | raynor
弗西瓦尔 | 费西瓦尔 | fercival
松塔格 | 桑塔格 | sontag
麦康 | 梅肯 | macon
德拉丰斯 | 德拉方斯 | delafons
戴维 | 达维 | davee
戈希 | 戈伊 | gohey
克莱弗 | 克拉弗 | claver
桑萨姆 | 桑森 | sansum
吉吉 | 吉盖 | giggey
达科姆 | 戴科姆 | dacombe
邦廷 | 邦坦 | bontein
多本 | 多宾 | doben
格穆特 | 格穆思 | germuth
泰恩什 | 坦什 | tainsh
克雷斯皮尼 | 克雷皮尼 | crespigny
赫梅尔辛 | 休梅尔辛 | humelsine
布尔基 | 伯基 | buerki
巴贝尔 | 贝布尔 | babell
克拉丽达 | 克拉里达 | clarida
博德温 | 博德瓦恩 | bordwine
布朗塔斯 | 布龙塔斯 | brountas
梅耶森 | 迈耶森 | mayerson
德雷沃尔吉拉 | 德沃尔吉拉 | drevorguilla
奥弗拉海蒂 | 奥弗莱厄蒂 | o'flahertie
塞维 | 西维 | sevey
克拉恩 | 克拉汉 | crahan
博克尔 | 博克 | boker
马辛库斯 | 马辛克斯 | marcinkus
蒂利 | 蒂莉 | tillie
赖格 | 里格 | riger
道德 | 多德 | dowd
阿利森 | 艾莉森 | alyson
德雷塞尔 | 德雷斯尔 | dressel
朱利 | 朱莉 | julie
达尼翁 | 达尼恩 | danyon
马休伦 | 马胡兰 | mahuran
波兰 | 普兰 | poulain
谢伊 | 切赫 | czeh
西尔瓦纳斯 | 西尔维纳斯 | silvanus
埃克斯坦斯 | 埃克斯滕斯 | exstance
普萨特里 | 普萨泰里 | pusateri
奈亨 | 奈恩 | nyhen
沃基特 | 瓦克特 | wackett
罗巴蒂斯 | 罗巴茨 | robartes
阿格内洛 | 阿涅洛 | agnello
伊莱 | 艾莱 | ilay
内西厄 | 纳休 | nathiew
休达克 | 赫达克 | hudak
斯蒂格利茨 | 施蒂格利茨 | stiglitz
塞西利厄斯 | 塞西莉厄斯 | cecilius
纳登 | 内登 | naden
哈米斯 | 黑姆斯 | hammes
查格尔斯 | 查格利斯 | chagles
麦凯肯 | 麦凯琴 | maceachen
格里贝诺 | 格里布诺 | griebenow
缪里诺 | 穆里诺 | murino
加纳吉安 | 加南吉扬 | ganangiyan
古拉德 | 戈拉德 | goulard
格罗杰 | 格罗格 | grogger
布里斯 | 布赖斯 | brise
埃夫勒 | 埃弗勒 | effler
惠特塞特 | 惠特西特 | whitsett
瓦斯默 | 沃斯默 | wasmer
布雷斯纳安 | 布雷斯纳汉 | bresnahan
波 | 鲍 | pow
拉克歇尔 | 拉克斯尔 | wraxhall
曼勒斯 | 曼利厄斯 | manlius
谢拉 | 希拉 | shelagh
内格尔 | 尼格尔 | negel
巴吉特 | 巴杰特 | bardgett
罗克特 | 罗基特 | rockett
伯恩 | 贝尼 | boehne
德沃拉克 | 德沃夏克 | dvorak
梅约斯 | 梅杰斯 | majors
福伊尔弗克 | 福伊尔沃克 | feuerwerker
塔吉 | 塔姬 | taggy
麦科克 | 麦科奇 | mccoch
蒂姆韦尔 | 泰姆韦尔 | timewell
巴克纳 | 巴赫纳 | bachner
塔德霍 | 塔杜 | tudhoe
蒂格雷特 | 泰格雷特 | tigrett
埃金 | 伊金 | eking
纳蒂 | 克努蒂 | knutti
凯宁 | 凯南 | kainen
德普特克 | 德普塔克 | deptuck
格尔 | 吉尔 | gehl
迪斯特伯格 | 杜斯特伯格 | duesterberg
利德福 | 利德福德 | lydford
菲恩 | 费恩 | feane
科宁 | 科奈恩 | conein
巴尔诺 | 巴诺 | barno
格雷博 | 格里博 | grebow
弗里斯 | 弗雷斯 | frece
朗莱因 | 朗莱恩 | longhlein
埃尔斯 | 埃利斯 | elles
德斯巴拉茨 | 德巴拉茨 | desbarats
沃拉克 | 沃勒克 | wallack
胡迪尼 | 霍迪尼 | houdini
克兰多尔 | 克兰德尔 | crandall
卡纳尼 | 卡奈尔尼 | carnearney
坦嫩鲍姆 | 特南鲍姆 | tennenbaum
卡奇亚 | 卡夏 | cachia
莫尔桑 | 莫桑 | morsan
阿杰里斯 | 阿吉里斯 | argeris
明内特 | 明妮特 | minnette
安斯帕彻 | 安斯帕赫尔 | anspacher
贾西诺夫斯基 | 贾西诺斯基 | jasinowski
沃尔西奥夫 | 瓦尔塞奥夫 | waltheof
拉普瓦诺 | 拉普阿诺 | rapuano
托比特 | 托贝特 | torbett
泰雷尔 | 蒂雷尔 | tyrell
安德雷斯 | 安德烈斯 | andress
卡尔戈 | 卡戈 | cargo
埃尔斯皮 | 伊丽莎白 | elspie
托普尔 | 托佩尔 | topple
塞姆斯 | 泰晤士 | thames
斯维克 | 斯韦克 | svec
斯坦布勒 | 斯坦伯勒 | stanbrough
肯奈尔德 | 肯奈德 | kennaird
勒克拉斯 | 勒克拉 | lecras
安德琳 | 安德林 | andelin
斯普雷尔 | 斯普雷耶 | spreyer
艾克纳 | 艾希纳 | eichner
费拉 | 费劳 | ferrao
奥弗拉赫蒂 | 奥弗莱厄蒂 | o'flaherty
克里恩 | 克林 | crean
伯杰文 | 伯格文 | bergevin
皮克 | 珀基 | pyrke
恩布林 | 恩布琳 | emblin
卡尔索普 | 考尔索普 | calthorpe
塞森 | 特森 | thesen
吉尔德豪姆 | 吉尔多姆 | guildhaume
法纽伊尔 | 法纳尔 | faneuil
蕾塔 | 里塔 | rheta
里查特 | 理查特 | richart
朗尼格 | 朗内加 | runnegar
卡萨 | 卡撒 | cartha
麦克莱恩 | 麦克林 | mcclean
曼丘西 | 曼库西 | mancusi
扬格尔 | 扬格 | younger
多尔格 | 德尔格 | dolger
希史密斯 | 希尔史密斯 | shearsmith
赫布斯特赖特 | 赫布斯特雷特 | herbestreit
赫尔斯滕 | 赫尔斯特恩 | hellstern
迪林 | 迪尔林 | deerlin
埃尔韦斯 | 埃尔威斯 | elwes
塔弗 | 塔沃尔 | tavor
韦赫 | 韦伊尔 | weiher
维特 | 维特尔 | vetter
赫米恩 | 赫米奥娜 | hermione
斯维尔 | 斯维沃 | svewar
约翰森 | 约翰逊 | johnson
杭德里奇 | 杭德里克 | honderich
利伯丁 | 利伯蒂娜 | libertine
达尔佩泽 | 达莱佩泽 | dallepezze
迈尔斯特拉普 | 迈尔斯特勒普 | meilstrup
朗斯莱特斯 | 朗斯利特斯 | launceletus
埃德利 | 埃德尔 | ederle
格恩斯巴克 | 根斯巴克 | gernsback
比尔 | 伯尔 | birr
邓坎森 | 邓肯森 | duncanson
迪尔 | 代尔 | diel
金格 | 金奇 | kynge
迪思里克 | 迪特里希 | diethrich
迪海 | 德海 | dehay
克里斯坦 | 克里斯廷 | kristine
布拉米尔斯 | 布拉迈尔斯 | blamires
迈斯利克 | 迈斯利奇 | meislich
沃索 | 瓦索 | wasow
阿勒姆 | 奥勒姆 | allam
博迪科姆 | 博迪库姆 | bodycombe
施韦尔布 | 施韦布 | schwelb
伊泽努尔 | 艾泽努尔 | izenour
雅科布斯坦 | 雅各布斯坦 | jacobstein
特雷里斯 | 特里赖斯 | trerise
帕尼特 | 帕内特 | panet
平科特 | 平肖 | pinchot
范热 | 范格特 | fanget
伊尔格 | 伊尔克 | ilg
科佩拉 | 科皮拉 | coppela
茹拉布奇安 | 朱拉布奇安 | joorabchian
斯拉特里 | 斯莱特里 | slattery
厄尔马思 | 厄马思 | earmarth
赫金斯 | 哈金斯 | hugghins
梅约 | 梅奥 | mayo
达纳文特 | 杜纳万特 | dunavant
基珀斯 | 凯珀斯 | kuipers
梅因多纳德 | 梅因唐纳德 | maindonald
麦卡勒里 | 麦卡利里 | mcalery
哈兹尔坦 | 黑兹尔坦 | hazeltine
尤卡丽斯塔 | 尤卡里斯塔 | eucharista
迈吉尔 | 迈伊尔 | mighill
赫曼 | 希曼 | heman
恩斯拉德 | 恩斯鲁德 | ensrud
布罗泽 | 布拉泽 | brother
赛恩 | 锡恩 | thynne
弗里斯 | 弗里亚斯 | freas
勒滕德尔 | 勒滕德 | letendre
杰斯 | 杰西 | jesse
莱韦斯库 | 莱韦斯克 | levesque
奥德里 | 奥德丽 | audrey
约瓦诺维奇 | 约万诺维奇 | yovanovitch
派尤什 | 皮尤什 | piyush
丹尼罗 | 达尼罗 | daniero
英奇金 | 英奇昆 | inchiquin
津巴尔多 | 津巴多 | zimbardo
多嫩菲尔德 | 多宁费尔德 | donenfeld
沃尔德雷普 | 沃尔德里普 | waldrep
德马西奥 | 德马肖 | demascio
穆科夫斯基 | 穆科斯基 | mukowski
泽凯拉 | 泽克拉 | zechella
科莉 | 凯莉 | kallie
斯凯特 | 斯卡特 | skate
麦吉尔伍 | 麦吉尔伍尔 | macgillvoor
布古尔德 | 布古尔 | bougourd
塞文 | 西文 | sevin
欣恩 | 希恩 | shinn
庞纳佩拉马 | 庞南佩鲁马 | ponnamperuma
米曾 | 迈曾 | mizen
洛梅尔 | 隆梅尔 | lommel
马赫 | 马奇 | much
甘尼弗 | 珍妮弗 | gennifer
查萨涅斯 | 沙萨涅 | chassagnes
艾尤托 | 阿尤托 | aiuto
布罗德 | 鲍赫鲁德 | boughrood
吉隆 | 吉伦 | gillon
道沃德 | 道尔德 | doward
基尔里 | 基里 | kearey
瓦克 | 瓦克尔 | wacker
路易苏 | 路易祖 | louizou
弗兰兹 | 弗朗兹 | franz
米泽尔 | 米泽勒 | mizelle
托雷斯 | 托里斯 | torres
沃尔本 | 沃莱本 | wohlleben
普法尔茨格拉夫 | 法尔茨格拉夫 | pfaltzgraff
沃申科 | 瓦申科 | washenko
博尼特 | 博内特 | bonett
马库斯 | 马库塞 | marcuse
阿伦 | 艾伦 | allen
布贾克 | 布亚克 | bujake
乔瑟姆 | 乔撒姆 | jotham
斯坦拉克 | 斯坦莱克 | stanlake
温切尔西亚 | 温切尔西 | winchelsea
古卡斯 | 古奥卡斯 | guokas
迪特特 | 迪泰特 | dittert
德尔菲 | 德菲 | durfee
菲查尔温 | 菲茨艾尔温 | fitzailwyn
埃迪生 | 埃迪森 | eddison
希金博瑟姆 | 希金博特姆 | higinbotham
毛尔 | 莫尔 | maule
玛奇 | 马季 | marj
布加斯 | 巴加斯 | bugas
埃奇达尔 | 埃奇代尔 | edgedal
凯 | 基 | key
林德斯滕 | 林斯滕 | lindsten
贝罗尔 | 伯罗尔 | berall
施威默 | 施维默 | schwimmer
凯特伦 | 卡特伦 | catron
斯威特凯 | 斯威凯 | switkay
斯巴斯基 | 兹巴尔斯基 | zbarskiy
贝格尔 | 贝尔 | beighle
西利耶 | 特威利尔 | thuillier
科德 | 科尔德 | coard
戈特盖特 | 戈特格特鲁 | gottgetereu
诺萨普顿 | 诺桑普顿 | northampton
尼迪 | 内迪 | neddie
赫伦布兰德 | 海伦布兰德 | hellenbrand
厄布 | 厄尔布 | erb
锡茜 | 锡西 | cissie
莱兰 | 利兰 | lelland
弗雷德丽卡 | 弗雷德里卡 | fredrica
奇瓦托罗 | 奇瓦特罗 | chivatero
温泽尔 | 温策尔 | wenzel
杜格 | 杜奇 | dooge
巴蒙特 | 贝蒙特 | bamont
加利亚多 | 加利亚尔多 | galiardo
奥尔德希泽 | 奥尔迪泽 | aldhizer
道兹韦尔 | 多德斯韦尔 | dowdeswell
达尔 | 杜尔 | durr
米齐 | 梅齐 | meazey
尤特 | 尤思 | uthe
斯坦纳 | 斯蒂纳 | stiner
诺托尔 | 纳托尔 | nuttall
戴伦弗思 | 迪伦弗思 | dhyrenfurth
扬克威奇 | 扬克维奇 | yankwich
萨奇曼 | 塞奇曼 | sageman
库达希 | 卡达希 | cudahy
克尔奇维尔 | 克切维尔 | kercheville
德西里 | 德西蕾 | desiree
柯利 | 丘利 | kewley
乔瑟林 | 乔斯林 | josselyn
卡德拉 | 夸德拉 | cuadra
休什 | 休伊什 | huish
德波米尔 | 德波米耶 | depommier
比昂 | 拜昂 | bion
麦金图夫 | 麦金塔夫 | mcinturff
莫福德 | 莫维兹 | morfudd
桑克利 | 尚克利 | sankley
罗梅因 | 罗曼 | romaine
谢马拉 | 赛马拉 | saemala
怀斯坦 | 威斯坦 | wystan
吉尔休利 | 吉尔胡利 | gilhuly
博德温 | 鲍德温 | bodwine
勒斯 | 卢斯 | luss
鲍科姆 | 鲍库姆 | bawcombe
莱因斯 | 莱恩斯 | lines
勒苏夫 | 勒瑟夫 | lesurf
查伦杰 | 查林杰 | challenger
塞特 | 撒特 | thaete
约基尔森 | 约克尔森 | yochelson
西伊 | 西赫 | sih
弗兰西娅 | 弗朗西亚 | francia
亨特雷斯 | 亨特里斯 | huntress
蒂尤森 | 蒂乌萨宁 | tiusanen
米尔德万 | 米尔德文 | mildvan
金卡尼 | 金凯尼 | kincairney
阿尼尼 | 阿内尼 | aneny
马斯曼 | 穆斯曼 | mussman
蒙塔文 | 蒙塔冯 | montavon
萨特奇 | 萨特杰 | satge
泰泽 | 泰瑟 | tysser
贾尼斯 | 贾尼西 | janisse
杜西 | 达西 | duthie
加汉 | 加恩 | gahan
德拉波 | 德拉珀 | drapeau
巴里克 | 巴威克 | barwick
迪利 | 杜利 | duley
霍奇特 | 霍贾特 | hodgart
桑比 | 桑德比 | saundby
德斯博瓦 | 德布瓦 | desbois
斯韦贝 | 斯韦比 | swaebe
格拉巴尔 | 格拉巴 | grabar
弗鲁伊特 | 弗鲁特 | fruit
伊利恩 | 伊尔伦 | illearn
阿布洛姆 | 阿布隆 | ablom
博尔加塔 | 博加塔 | borgatta
埃斯梅尔 | 伊斯梅尔 | esmail
沃滕伯格 | 瓦滕伯格 | wattenberg
阿迪内特 | 阿迪尼特 | adinet
吉尔克雷斯特 | 吉尔克里斯特 | gilchrest
霍耶莱贝克 | 胡尔贝克 | houiellebecq
布希 | 布舍 | busche
卡梅尔福德 | 卡姆尔福德 | camelford
勒金比尔 | 卢金比尔 | lukingbeal
拜伊 | 布伊 | buie
费多基克 | 费多奇克 | fedochik
埃斯特黑 | 埃斯特海 | esterhai
马尔欣 | 马尔夏恩 | mulshine
迈哈拉克 | 迈克拉克 | michalak
埃莱克特拉 | 伊莱克特拉 | electra
查费茨 | 查菲茨 | chafetz
塞米厄斯 | 瑟缪斯 | sermeus
艾克瑟 | 伊克瑟 | ixer
耶曼斯 | 伊曼斯 | yeamans
伊卡恩 | 伊坎 | icahn
鲁伊尔 | 鲁埃尔 | reuel
桑恩 | 图恩 | thun
泰瑟 | 特瑟 | tether
克利安德 | 克林德 | cleander
海森 | 希森 | hyson
沃姆索 | 沃姆泽 | wormsor
吉诺尔 | 格瑙尔 | genauer
克莱夫 | 克拉夫 | clave
蒙东纳 | 蒙顿纳 | montonna
利多姆 | 利德姆 | leedom
马拉布尔 | 梅拉伯 | malabre
苏里纳 | 苏雷纳 | surena
利希特沃特 | 利希特瓦尔特 | lichtwardt
奥弗拉尔 | 奥费拉尔 | o'ferrall
马琴 | 梅琴 | machen
塔谢罗 | 塔什罗 | taschereau
埃廷杰 | 埃廷格 | ettinger
查庞 | 沙蓬 | chapone
林迪 | 琳迪 | lynndie
卡兰 | 卡莱恩 | carline
甘博厄 | 甘博亚 | gamboa
康伯 | 库默 | comber
赫施 | 胡希 | husch
阿克利 | 埃克利 | akeley
尤泽 | 尤伊泽 | ueyser
奥拉 | 奥尔拉 | orla
卡丹 | 卡登 | kadane
阿夫伯里 | 埃夫伯里 | avebury
图伊希 | 图伊 | tuohey
维拉亚洛斯 | 比利亚洛沃斯 | villalobos
迪达姆 | 迪德姆 | deedham
弗朗岑 | 弗兰岑 | frantzen
斯特朗伯格 | 斯特龙伯格 | stromberg
格维茨 | 格威茨 | gurwitz
德梅特 | 德梅特尔 | demaitre
马加法恩 | 马加芬 | magafan
汤姆兰 | 汤姆林 | tomline
贝尔里 | 比尔里 | beary
斯韦特林 | 斯韦思林 | swaythling
达姆勒 | 杜姆勒 | dumler
海因菲尔德 | 汉费尔德 | hainfeld
沃拉 | 瓦拉 | walla
伊尔德姆 | 埃尔德姆 | ealdhelm
斯塔恩克 | 斯托尔内克 | stalnecker
马杰里 | 马格丽 | margery
贝沃尔德 | 贝瓦尔德 | baerwald
盖伊 | 贾伊 | ghey
赖姆斯 | 里姆斯 | rheims
普拉格 | 普拉奇 | plugge
基乔 | 凯乔 | kejoa
博斯顿 | 波士顿 | boston
费克特基蒂 | 费克特库蒂 | feketekuty
赫芬 | 赫法恩 | huffine
梅雷韦瑟 | 梅里韦瑟 | mereweather
塞利格曼 | 塞利希曼 | seligmann
加韦德 | 加维德 | gaved
斯特雷姆劳 | 斯特里姆劳 | stremlau
佩洛贝特 | 佩卢贝特 | peloubet
贝尔 | 贝耶尔 | beier
马卡洛尼斯 | 马查洛尼斯 | marchalonis
瑟瓦克 | 瑟瓦奇 | serwach
阿塞林 | 阿斯林 | acelin
阿菲 | 埃菲 | afee
西德博特姆 | 赛德博特姆 | sidebotham
格德 | 格尔德 | gerd
埃克洛夫 | 埃克勒夫 | eklof
博格泰特 | 博格蒂尔 | boghatyr
芬格勒 | 芬勒 | fengler
豪恩谢尔 | 霍恩谢尔 | hounshell
伊因 | 约恩 | eoin
索 | 托 | thau
图雷曼 | 图尔曼 | tureman
法克托 | 法克特 | factor
德西德拉塔 | 德西德蕾塔 | desiderata
朱埃特 | 朱厄特 | jouett
班顿 | 贝恩顿 | baynton
塞格尔 | 西格尔 | seigel
沃伊格特 | 沃伊特 | voigt
约奎廉斯 | 约克威廉 | yorkwilliams
伍尔斯泰特 | 沃尔斯泰特 | wohlstetter
弗拉利克 | 弗雷利克 | fralick
瑟娜 | 塞尔纳 | serna
伦嫩 | 伦南 | lennen
阿伯恩 | 阿本 | abern
伊登 | 艾登 | idden
杰瑟里克 | 杰塞里克 | jeserich
希格内特 | 希格尼特 | hignett
杜庞特 | 杜邦 | dupont
克利姆克 | 克利姆基 | klimcke
赫尔布尔 | 赫布尔 | helble
比尔布勒 | 比尔伯勒 | bilbrough
斯温托 | 斯温特 | swintor
昂布赖特 | 昂布里特 | umbreit
布劳恩 | 布朗 | browne
凯加 | 凯加鲁 | caegarw
赫沃斯 | 休沃斯 | huvos
萨姆斯塔格 | 扎姆斯塔格 | samstag
贾格斯 | 贾格尔斯 | jaggers
格伦巴克 | 格伦巴赫 | grumbach
凯斯 | 基斯 | keys
萨基纳 | 萨金娜 | sakinah
勒福恩 | 勒方 | lefaune
贝曼 | 比曼 | beman
苏弗特 | 索伊弗特 | seufert
斯特里文斯 | 斯特雷文斯 | strevens
斯坦纳姆 | 斯塔纳姆 | stanham
阿克申 | 埃克申 | action
梅因沙因 | 梅恩沙因 | maienschein
桑兹 | 桑德斯 | sondes
穆普森 | 马普森 | mupson
奥钦克洛斯 | 奥金克洛斯 | auchincloss
埃尔 | 埃尔勒 | ehrle
勒克赫斯特 | 卢克赫斯特 | luckhurst
范迪维耶 | 范迪维尔 | vandivier
卡罗尔 | 卡萝尔 | carole
埃丁杰 | 埃丁格 | edinger
德沃尔 | 德韦尔 | deveulle
麦高兰 | 麦戈兰 | mcgauran
登帕萨 | 登帕西 | dempasay
马格奈 | 马格内 | magnay
法尔肯布里奇 | 福尔肯布里奇 | falconbridge
格林斯特德 | 格林斯蒂德 | grinstead
内奇曼 | 纳奇曼 | nacheman
阿尔文 | 奥尔文 | allvine
米多斯 | 梅多斯 | meadows
帕德西 | 帕齐 | pudsey
罗勒夫斯 | 罗卢夫斯 | rolufs
切诺维奇 | 切尔诺维奇 | cernovitch
奈斯利 | 尼斯利 | knisely
莱加特 | 莱格特 | legatt
尼科拉迪斯 | 尼古拉迪斯 | nikolaidis
戈利特利 | 戈莱特利 | golightly
芒尼克休森 | 芒尼克海森 | munnikhuysen
朱科威茨 | 尤尔科维茨 | jurkowitz
肖伊 | 舍韦 | schewe
麦金金 | 麦克琼金 | mcjunkin
拉贝特 | 拉贝 | rabet
吉格雷 | 吉格尔 | giguere
麦克法迪安 | 麦克法迪恩 | mcfadyean
卢内德 | 莉内德 | luned
科克兰 | 科克伦 | cochrane
布赞纳 | 布尔扎纳 | brzana
莫尔霍尔特 | 莫霍尔特 | molholt
阿加西亚 | 阿加西娅 | agacia
塞蒙 | 瑟蒙 | sermon
克里茨 | 克赖茨 | crites
布雷恩特里 | 布伦特里 | braintree
钱伯尔辛 | 钱伯辛 | chamberlsin
格青格 | 格青杰 | getsinger
欧维特 | 艾尔薇特 | irvette
德尼奥 | 迪奈欧 | denio
基尔 | 基利 | kille
奥西内尔 | 奥塞内尔 | othenel
坦迪恩 | 坦丁 | tandien
萨尔特 | 索尔特 | salter
马尼奥利亚 | 马格诺利娅 | magnolia
索瑟登 | 萨瑟登 | southerden
戴西 | 黛西 | daisy
戈迪夫 | 戈德夫 | godefe
沃泰姆 | 沃特海姆 | wertheim
克里斯特高 | 克里斯戈 | christgau
奥科因 | 奥库安 | aucoin
休尔塔 | 许尔塔 | huerta
彼得罗 | 佩特罗 | petro
亨萨克 | 亨塞克 | hunsaker
诺尔奎伊 | 诺基 | norquoy
梅克厄姆 | 梅卡姆 | makeham
齐默 | 泽默 | zemmer
斯托尔兹弗格 | 斯托尔兹伯格 | stolzberg
斯特罗布里奇 | 斯特劳布里奇 | strawbridge
希肯洛普 | 希肯卢珀 | hickenlooper
巴尔塔萨 | 巴尔塔泽 | baltassar
杜克 | 杜凯 | duque
海尔凯 | 海尔基 | heilkay
弗利金格 | 弗利金杰 | flickinger
泽比纳 | 泽拜纳 | zebina
布拉夫 | 布劳 | blough
格拉斯戈 | 格拉斯哥 | glasgow
赫琴格 | 赫金杰 | hechinger
斯梅 | 斯梅奇 | smaje
奥利文特 | 奥利万特 | ollivant
戈洛切科 | 戈洛夫琴科 | golovchenko
麦克莱莫尔 | 麦克勒莫尔 | mclemore
麦克费德兰 | 麦克费德伦 | macphedran
奥迪吉尔 | 奥迪吉耶 | audigier
赫蒙 | 哈蒙 | hummon
伯特豪德 | 伯绍德 | berthoud
贝奥利 | 比利 | beoley
古比托什 | 古比托西 | gubitoshi
耶登 | 伊登 | yeadon
达尔维奇 | 达利奇 | dulwich
格罗塞斯特 | 格罗斯泰特 | grosseteste
施蒂贝林 | 斯蒂贝林 | stiebeling
洛克希尔 | 洛希尔 | lochiel
弗里尔 | 弗雷耶 | freyere
斯康菲尔德 | 舍恩菲尔德 | schonfield
斯托普曼 | 施托尔普曼 | stolpman
弗兰普欣 | 弗兰普申 | framption
博雷特 | 博里特 | borrett
菲彻姆 | 费克姆 | feachem
拉坎潘 | 拉康帕涅 | lacampagne
索维奇 | 索瓦热 | sauvage
赫曼 | 赫尔曼 | herman
科帕德 | 科珀德 | coppard
埃尔齐 | 埃尔扎伊 | elzay
巴思 | 巴特 | barthe
埃斯科菲 | 伊斯科菲 | escoffey
吉利亚姆 | 吉列姆 | gilliam
皮尔 | 皮埃尔 | pierre
博施威茨 | 博希威茨 | boschwitz
哈德格里 | 哈迪格里 | hardegree
皮尔 | 珀尔 | pearl
多姆詹 | 多米扬 | domjan
阿巴斯特尼亚 | 阿巴斯蒂尼亚 | abastenia
阿利斯 | 阿莱斯 | allies
海泽 | 哈伊泽 | huyser
卡拉佩蒂安 | 卡拉佩琴 | carapetyan
布里宁 | 布赖宁 | bryning
格利多尔 | 格利德尔 | gleadall
麦凯恩 | 麦克钦 | mccheane
丹尼斯 | 德尼斯 | deneys
特洛 | 特略 | tello
纽伯勒 | 纽伯格 | newburgh
博特塞特 | 博塞特 | botset
托尔梅奇 | 塔尔梅奇 | tallmadge
威克斯蒂德 | 威克斯第德 | wicksteed
斯科格伦 | 斯科格隆 | skoglund
海尔兹 | 希尔兹 | hilds
万诺伊 | 范诺伊 | vannoy
温塔尔 | 温特尔 | weintal
贾夫 | 贾菲 | jaffe
斯塔姆 | 施塔姆 | stamm
法扎 | 法扎尔 | fazar
道恩 | 杜恩 | doune
萨西妮 | 萨西尼 | sassienie
马塞尔 | 玛塞勒 | marcelle
尤因斯 | 尤温斯 | uwins
尤莱维奇 | 乌莱维奇 | ulevich
康尼利 | 康奈利 | conneally
德黑斯 | 德海斯 | dehayes
马顿 | 梅顿 | maton
希拉 | 夏伊拉 | shyla
比恩 | 比汉 | beehan
法尔肯海姆 | 福尔肯海姆 | falkenheim
伊尔森 | 艾尔森 | eielson
凯西米尔 | 卡西米尔 | kasimir
洛恩 | 洛温 | lowen
德弗勒 | 德夫勒 | doerfler
伊利希 | 伊利格 | illig
贝默赛德 | 比默赛德 | bemersyde
米诺 | 明诺 | mimno
布平达 | 布平达尔 | bhupindar
罗明 | 罗梅因 | romeyn
扬斯班德 | 扬哈斯本 | younghusband
夏皮 | 沙比 | sharpey
莱西奇 | 勒萨热 | lesage
巴布利斯 | 布勃利斯 | bublys
辛皮克 | 辛皮奇 | simpich
伯特霍尔夫 | 伯索夫 | bertholf
舒特尔夫 | 舒特莱夫 | shurtleff
斯波特德 | 斯波蒂德 | spotted
乔齐 | 乔茜 | jozy
黛安 | 戴安 | dian
赞布鲁姆 | 赞布勒姆 | zambrum
劳克休夫 | 劳卡夫 | laukhuff
米尔希 | 米尔海 | milhy
卡德根 | 卡杜根 | cadwgan
博希尔 | 博舍尔 | boshier
博维 | 博韦 | bovee
赫克顿 | 赫克通 | hektoen
莱维 | 利瓦伊 | levi
克里 | 克雷 | crea
乔尔万 | 朱尔万 | joulwan
卡佐克里亚 | 库佐克雷亚 | cuzzocrea
韦德伍德 | 韦奇伍德 | wedgwood
克拉茨 | 克卢茨 | clutz
阿德基森 | 阿基森 | adkisson
伊菲根 | 伊菲吉妮 | iphigene
泰菲恩 | 泰维恩 | teifion
格里弗尔 | 格里费尔 | griffel
本贾明 | 本杰明 | benjamin
拉罗姆 | 拉勒姆 | larom
坎帕因 | 坎佩恩 | campaigne
古茨威勒 | 古茨维勒 | gutzwiller
斯特芬斯 | 斯蒂芬斯 | steffens
勒金 | 勒德金 | ludgin
阿尔皮娜 | 阿尔皮纳 | alpina
韦雷尔 | 沃雷尔 | werrell
福尔兹 | 福尔茨 | folz
德福德 | 德福特 | deford
博比萨德 | 博比苏德 | bobisud
图尔 | 特尔 | tourle
图利特 | 塔利特 | tulett
斯塔克 | 斯图克 | stucke
肖伯格 | 舍恩伯格 | schonberger
兰贝利特 | 兰伯利特 | lambelet
盖伊 | 贾伊 | gye
布卢梅菲尔德 | 布卢姆菲尔德 | blumefield
利希滕斯坦 | 利克滕斯坦 | liechtenstein
安德鲁斯凯维奇 | 安德鲁斯克维奇 | andruskevich
托德雷斯 | 托德雷亚斯 | todreas
布金 | 布尔金 | bourgin
泰林厄姆 | 蒂林厄姆 | tyringham
兰迈德 | 兰梅德 | langmaid
比 | 布埃 | bue
阿韦斯 | 阿维丝 | aveis
黑吉斯 | 海吉斯 | haigis
基珀 | 凯珀 | kuiper
斯特兰格 | 斯特兰杰 | stranger
阿伦 | 阿龙 | aaron
齐恩 | 蔡恩 | zion
盖尔巴赫 | 盖尔博 | gelbach
布雷克兰 | 布里克兰 | brekland
布卡拉 | 布阿哈拉 | buachalla
沃尔克 | 沃克 | walke
考特尼 | 考特妮 | kourtney
库尔 | 屈尔 | kuehl
麦克雷迪 | 麦克拉迪 | mccrady
比利尔 | 比埃 | billiere
埃尔杰 | 埃尔格 | elger
施纳克 | 施努克 | schnuck
佩金 | 帕金 | pagin
贾拉特 | 贾勒特 | jarratt
尼科利 | 尼古拉 | nicolay
弗雷塔格 | 弗赖塔格 | freytag
撒尔肯 | 萨尔肯 | thalken
赖津 | 里津 | ryzin
卡德韦尔 | 库尔德韦尔 | couldwell
伯娜 | 伯纳 | berna
索利兹 | 索莱 | saulez
斯坦齐克 | 斯坦奇克 | stanczyk
保林 | 波林 | paulin
巴托尔缪 | 巴托洛缪 | bartholemeu
西克 | 瑟克 | cirker
恩德科特 | 恩迪科特 | endecott
阿尔文 | 阿尔温 | alwin
拉索姆 | 莱瑟姆 | lathom
霍泽尔 | 休塞尔 | heusel
莱夫拉 | 莱弗拉尔 | leflar
罗萨佩普 | 罗萨皮普 | rosapepe
巴萨德 | 巴萨德雷 | basadre
派约特 | 派奥特 | pyott
塞勒斯 | 塞拉斯 | sellars
梅勒普斯 | 梅拉普斯 | mellups
巴尔西格 | 巴尔西杰 | balsiger
希拉伯 | 希莱伯 | shillaber
休马森 | 赫马森 | humason
斯特费斯 | 斯特弗斯 | steffes
卡斯特尔伯里 | 卡斯尔伯里 | castelberry
贝切特 | 贝谢 | bechet
梅利奥尔 | 梅莉奥尔 | melior
鲁马塞特 | 罗马塞特 | roumasset
克奇弗 | 克切弗 | kerchever
比阿特丽夏 | 比阿特丽西娅 | beatricia
梅努欣 | 梅纽因 | menuhin
凯格 | 基格 | keig
菲阿尔卡 | 菲亚尔卡 | fialka
赫米斯 | 赫姆斯 | hemmes
兹沃 | 兹瓦尔 | zwar
克伦西克 | 赫伦奇克 | chrencik
彭沃尔特 | 佩恩沃尔特 | pennwalt
库塞维茨基 | 科乌谢维茨基 | koussevitzky
米尼奥 | 米内奥 | mineo
布勒宁 | 布罗宁 | broening
普尔特 | 波尔特 | poulter
伊尔特德 | 伊尔蒂德 | illtud
弗罗兹 | 弗勒泽 | froese
阿什利 | 阿什莉 | ashleigh
斯图扎 | 斯图尔扎 | stoorza
弗莱赫蒂 | 弗莱厄蒂 | flaherty
诺克斯 | 努克斯 | nokes
恰鲁奇 | 基亚鲁奇 | chiarucci
图尔默 | 瑟默 | thuermer
杜克诺伊 | 迪克努瓦 | duquenoy
托里乔斯 | 托里霍斯 | torrijos
柯彻 | 基尔舍 | kircher
斯托尔森巴赫 | 斯托曾巴赫 | stolzenbach
杰格尔 | 杰格 | jeger
马德里德 | 马德里 | madrid
多恩 | 唐 | donn
凯特尔比 | 基特尔比 | ketelbey
古利克森 | 格利克森 | gulliksen
怀恩特 | 威甘特 | wygant
博弗里 | 博韦里 | boverie
贝勒 | 贝利 | behle
洛伦曾 | 洛伦岑 | lorenzen
阿莱格拉 | 阿利格拉 | allegra
赖克沃特 | 里克沃特 | rykwert
奥法雷尔 | 奥法雷 | o'farrell
卢宁 | 吕宁 | luening
特金 | 图尔金 | turkin
乔西 | 约瑟 | josee
施赖伯 | 施里伯 | shriber
迈斯兰 | 迈斯拉恩 | meislahn
格尔纳 | 盖尔纳 | gellner
西克索尔 | 塞克索尔 | sexauer
高因 | 高英 | gowing
亨尼卡特 | 亨尼克特 | hunnicutt
本尼 | 贝恩 | benne
科斯 | 库斯 | coes
穆斯 | 缪斯 | muse
霍伊斯布罗克 | 哈维克斯布罗克 | hawixbrock
霍尔廷万格 | 霍尔蒂万格 | haltiwanger
哈里尔 | 哈丽尔 | harriel
塞塞尔 | 塞斯尔 | sessel
费尔马纳 | 费尔曼纳 | fairmaner
霍金森 | 霍奇金森 | hodgkinson
里迪福 | 里迪福德 | riddiford
阿尔奇弗伦 | 阿尔西弗龙 | alciphron
达纳根 | 杜纳根 | dunagan
特雷西 | 特蕾西 | tracey
若克 | 吉奥克 | giauque
库蒂斯 | 柯蒂斯 | kurtis
乌斯勒 | 奥斯勒 | oursler
伊尼德 | 伊妮德 | enid
西金特 | 瑟金特 | searjeant
拉金 | 莱金 | laging
莫尼尔 | 莫内尔 | monell
斯康伯格 | 舍恩伯格 | schonberg
米特切夫 | 米采夫 | mitseff
范格 | 范杰 | fanger
杰舒阿 | 杰舒亚 | jeshua
布兰钱 | 布兰昌 | blanchan
霍尔迪曼德 | 哈尔迪曼德 | haldimand
吉廉斯 | 吉利亚姆 | guilliams
多奇 | 道奇 | dodge
麦克尼拉奇 | 麦克尼利奇 | macneilage
梅莉娅 | 米利亚 | melia
斯威恩 | 斯温 | sween
戈梅兹帕塔 | 戈梅斯普拉塔 | gomezplata
布尔乔伊斯 | 布儒瓦 | bourgeois
安东尼奥 | 安东尼乌 | antoniou
罗伊巴尔 | 罗伊鲍尔 | roybal
布谢夫 | 布舒夫 | bushueff
比克 | 贝克 | beek
雷努 | 伦瓦尔 | renouard
希拉斯 | 希勒斯 | heelas
卡尔德克卢 | 考尔德克拉夫 | caldcleugh
克拉格 | 克莱格 | clague
贾西娜 | 杰西纳 | jacyna
切希尔 | 切斯希尔 | chesshyre
布雷钦 | 布里金 | brechin
古德勒姆 | 古德哈姆 | gooderham
巴恩 | 鲍恩 | balne
休普 | 霍伊普 | heup
施雷尔 | 施赖尔 | schreyer
阿德查尼奇 | 阿德查尼克 | ardcharnich
贝迪利恩 | 贝迪利翁 | bedillion
斯迈思 | 史密斯 | smyth
赖道特 | 赖德奥特 | rideout
麦考斯兰 | 麦考斯伦 | mcauslan
尼思代尔 | 尼斯代尔 | nithsdale
皮阿罗斯 | 皮特罗斯 | peatross
马特奥 | 马泰奥 | matteo
多罗西 | 多萝西 | dorothy
斯塔宾 | 斯图宾 | stubbing
奥尔弗森 | 阿尔弗森 | alverson
索洛泰斯 | 索尔特斯 | solotesz
坎普沙罗 | 坎普施罗尔 | kampschror
布姆斯特德 | 巴姆斯特德 | bumstead
坦普拉 | 坦普勒 | templar
伦 | 莱恩 | len
谢尔普 | 谢普 | shairp
伯兹尔 | 伯塞尔 | birdsell
普雷彻 | 普里彻 | preacher
索恩代克 | 桑代克 | thorndike
马沙姆 | 马香 | marsham
奥伯赫尔曼 | 奥伯黑尔曼 | oberhelman
帕特里亚克 | 佩特里亚克 | patriach
利斯 | 莱什 | leisz
海内曼 | 海涅曼 | heinemann
里查兹 | 理查兹 | richards
艾奇森 | 艾奇逊 | eytchison
布里恩特 | 布赖恩特 | briant
丹罗瑟瑟 | 丹罗伊特 | dannreuther
巴恩比 | 巴恩贝 | barnebey
梅林达 | 梅琳达 | melinda
弗伦泽 | 弗伦策 | frenzer
康西尔 | 康斯尔 | council
沙因鲍姆 | 欣鲍姆 | sheinbaum
桑东 | 桑顿 | szanton
埃尔万 | 埃尔温 | elwane
厄尔韦克 | 埃厄克 | earwaker
格林达尔 | 格林德尔 | grindal
西弗林豪斯 | 塞夫林豪斯 | sevringhaus
贾科特 | 贾科泰 | jacottet
布里利 | 布里厄利 | brealey
麦科斯海奈格 | 麦科尚奈格 | maco'shannaig
麦克廷格 | 马赫廷格 | machtinger
特里斯特伦 | 特里斯特雷姆 | tristrem
康杰 | 康格 | conger
克尼格 | 凯尼格 | koernig
卡思尔 | 卡瑟尔 | cuthell
迪威斯 | 德威斯 | dewees
奥琳达 | 奥林达 | orinda
基茨哈伯 | 基察伯 | kitzhaber
布雷齐尔 | 布雷热 | brazier
芬尼 | 菲尼 | phinney
里维特 | 里韦特 | rivet
奥尔迪 | 阿尔迪 | alday
阿曼德斯 | 阿曼达斯 | amandus
赛纳 | 西纳尔 | synar
康乔拉 | 康科勒 | concholar
斯丘勒 | 朔伊勒 | scheuler
特鲁曼 | 杜鲁门 | truman
达奇 | 达基 | dachi
哈尔巴克 | 哈尔巴赫 | halbach
戈德温 | 戈尔德温 | goldwyn
鲁特 | 鲁尔特 | rurt
赫利 | 赫尔利 | hurleigh
克罗嫩贝格 | 克罗嫩伯格 | kronenberg
克里奇顿 | 克赖顿 | crichton
格威内德 | 格威内思 | gwynedd
特罗蒂埃 | 特罗蒂尔 | trottier
沃默尔多夫 | 沃梅尔多夫 | womeldorph
卡勒 | 凯勒 | cuyler
鲍厄尔斯 | 鲍威尔斯 | powels
罗雷姆 | 罗勒姆 | rorem
沃蒂埃 | 沃捷 | vautier
安德里欧 | 安德里厄 | andrieux
阿莱恩 | 阿林 | alleine
贝克 | 贝克尔 | becker
怀索基 | 维索茨基 | wysocki
比弗 | 贝弗 | bever
扎赫曼 | 扎克曼 | zachmann
海斯洛普 | 希斯洛普 | hyslop
希尼 | 赫尼 | henie
诺伦 | 诺伦德 | norlund
里夫尔 | 里弗尔 | riffle
唐西娅 | 唐西亚 | donsia
达克罗 | 迪克罗 | ducrow
格里甘蒂 | 格雷甘蒂 | greganti
沃尔克 | 沃克 | walk
沃尔克 | 沃克 | walker
梅迪森 | 麦迪逊 | madison
斯坦达洛夫特 | 斯坦德洛夫特 | standaloft
莱恩斯 | 莱昂斯 | lyons
德沃查克 | 德沃夏克 | dvorchak
科赫伦 | 库格伦 | coughran
多克特 | 多克托 | docktor
卢尔 | 勒尔 | lull
菲内尔 | 芬内尔 | feennell
塞门扎 | 西门扎 | semenza
哈森富斯 | 哈森弗斯 | hasenfus
加托夫 | 加特霍夫 | garthoff
沃尔拉特 | 沃尔拉思 | walrath
阿夫雷特 | 阿夫里特 | avrett
彼得龙 | 佩特龙 | petrone
格里桑蒂 | 格里桑迪 | grisanti
梅尔斯 | 马雷斯 | mares
安奈林 | 阿内林 | aneirin
冈利 | 高恩利 | gownley
卡萨桑特 | 卡萨森特 | casasent
阿图鲁斯 | 阿图罗斯 | arturous
布兰肯巴克 | 布兰肯贝克 | blankenbaker
拉拉比 | 拉勒比 | larabee
埃斯卡兰达 | 伊斯坎达里安 | eskandarian
盖格 | 盖杰 | gager
科尔奎特 | 科尔基特 | colquitt
达什曼 | 杜什曼 | dushman
贝索恩 | 贝森 | bessone
基西 | 凯西 | kesey
塞科夫斯基 | 赛科夫斯基 | saikowski
塞格雷夫 | 西格雷夫 | segrave
苏伊代尔 | 舍代尔 | suirdale
哈莫尔 | 哈默 | hamor
普普 | 普珀 | puppe
施米德 | 施密德 | schmid
黑尔 | 海尔 | haire
哈克威尔 | 黑克威尔 | hakewill
冈扎莱兹 | 冈萨雷斯 | gonzalez
莫纳 | 莫娜 | mona
格雷恩 | 格兰妮 | grainne
特鲁赫特 | 特鲁哈特 | trueheart
库米什 | 卡米什 | cumish
亚里莫维奇 | 雅里莫维奇 | yarymovych
登尼斯顿 | 丹尼斯顿 | denniston
塞尼奥尔 | 西尼尔 | senior
哈特西德 | 哈齐德 | hartsid
布伊斯拉根 | 博勒根 | boisragon
雷伯特 | 雷巴特 | rebut
索热 | 索热尔 | saussure
费里比 | 费尔比 | ferebee
科克森 | 考克森 | coxon
斯克鲁塔托 | 斯克鲁泰特 | scrutator
格里泽 | 格赖泽 | griser
戈尔赛蒙 | 戈德西蒙 | goldsymon
许尔霍尔兹 | 许霍尔茨 | schuerholz
威克泽 | 威克瑟 | wichser
科尔赫普 | 科尔黑普 | kohlhepp
鲁奥 | 罗科 | ruocco
巴齐莱 | 巴尔齐莱 | barzilay
加诺尔 | 加诺 | ganor
鲍尔兹怀勒 | 巴尔德施维勒 | baldeschwieler
斯洛尼姆 | 斯洛宁 | slonim
马萨 | 玛莎 | martha
福内斯 | 福尼斯 | forness
鲍杜因 | 鲍德温 | bauduin
珀塞克 | 佩塞克 | perseck
维伦 | 瓦伊伦 | viron
珀森 | 皮尔逊 | pirsson
索尔茨 | 肖尔茨 | soults
乔西亚斯 | 乔赛亚斯 | josias
杰鲁尔德 | 杰罗尔德 | gerould
耶尔 | 耶格 | jaegher
赫雷肖夫 | 赫雷斯霍夫 | herreshoff
西金 | 西尔金 | sirkin
康诺米 | 科诺米 | conomy
柯兰 | 柯伦 | curran
瓦伦苏拉 | 巴伦苏埃拉 | valenzuela
肖尔斯 | 肖沃斯 | showers
阿格伍 | 阿古 | agwu
弗拉克斯 | 弗勒克斯 | flux
阿达曼 | 阿达姆南 | adamnan
林恩 | 林 | linn
德赖克 | 德里克 | driker
里查德 | 理查德 | richard
罗伯森 | 罗伯逊 | robertson
吉查姆 | 吉彻姆 | gitsham
利奥亚克 | 莱夫奥克 | liveoak
普鲁斯曼 | 普拉斯曼 | prusman
基弗 | 凯弗 | keifer
吉恩 | 吉亨 | gehan
施努克恩 | 施努克内 | schnukne
温纳斯特伦 | 温纳斯特鲁姆 | wennerstrum
利德克 | 利迪克 | luedecke
普伦内克 | 普伦尼克 | pluenneke
赫希特里特 | 赫什特里特 | hirschtritt
贝拉德 | 贝拉尔 | berard
麦吉恩蒂 | 麦金蒂 | mcguinty
皮珀 | 派珀 | piper
斯温伯勒 | 斯旺伯勒 | swanborough
阿文代尔 | 埃文代尔 | avondale
德保 | 德波 | depauw
罗斯布鲁 | 罗斯伯勒 | rosebrough
格劳尔 | 格罗尔 | grower
豪瑟姆 | 豪萨姆 | howsam
米伯勒 | 迈伯勒 | myburgh
德沃尔金 | 德沃金 | dworkin
阿特尔西 | 阿特莱西 | attlesey
加格南 | 加涅班 | gagnebin
阿克雷斯 | 阿克斯 | acres
布莱克施米特 | 布莱希施米特 | blechschmidt
赫维茨 | 赫威茨 | herwitz
克兰德 | 克兰 | kland
德雷斯克 | 德赖斯克 | dreiske
马马杜克 | 马默杜克 | marmaduke
普赖尔 | 普里尔 | preil
比勒姆 | 比鲁姆 | biroum
克伦 | 克兰 | kerlan
贝思 | 贝丝 | beth
拜霍尔特 | 伯霍尔特 | byrholdt
约赫 | 约埃 | yohe
恩格弗 | 恩弗 | engfer
亚特伦 | 亚特隆 | yatron
埃查德 | 伊查德 | eachard
安杰莉娜 | 安杰利娜 | angelina
鲁乌塔 | 里乌塔 | riutta
普伦蒂 | 普朗蒂 | prunty
平杰 | 平格 | pinger
奥拉克林 | 奥劳克林 | o'laughlin
梅约拉斯 | 马约拉斯 | mayoras
维西 | 维齐 | veysey
施塔尔 | 斯塔尔 | stahl
沃尔斯托内夫特 | 沃斯通克拉夫特 | wollstonecraft
法夫罗特 | 法夫罗 | favrot
阿曼 | 阿尔曼 | arman
阿米欧 | 阿米奥特 | amiot
贝德尔 | 比德尔 | bedel
阿德尼 | 埃德尼 | adney
莫利诺尔 | 莫勒瑙尔 | mollenauer
斯凯尔斯 | 斯基尔斯 | skiles
芬维西 | 芬韦西 | fenvessy
帕赫 | 帕克 | pach
盖尔德 | 格尔德 | gelder
巴查尔 | 巴卡尔 | bachar
盖米特 | 加梅特 | gamet
雷特 | 雷图 | rettew
加雷尔 | 加勒尔 | garel
奥尔 | 奥利 | ole
巴德温 | 布德温 | budwine
迪奥 | 戴奥 | dio
塞夫尔 | 萨维尔 | savele
莱维 | 利维 | levie
格龙基 | 格朗茨基 | groncki
加尔康 | 加肯 | garcon
沃梅利 | 沃姆利 | wormeley
埃姆里克 | 德姆里克 | daemmrich
肖尔德勒 | 斯科德勒 | scholderer
迪比 | 达比 | duby
贝尔比 | 比尔比 | beilby
米道 | 米多 | middaugh
博斯金德 | 博斯坎德 | boskind
米尔 | 缪尔 | muille
阿尼斯 | 安妮斯 | anis
阿布林 | 埃布林 | ablin
班德 | 班德尔 | bander
罗索尔 | 罗塞尔 | rossall
谢德 | 沙德 | shad
埃奇逊 | 艾奇逊 | etcheson
福塞特 | 福西特 | fawssett
梅维蒂 | 马维蒂 | mavity
阿加斯 | 阿加丝 | agase
阿蒂耶 | 阿提耶 | atiyeh
伦芬特 | 朗方 | lenfant
尤夫罗辛 | 尤弗罗西尼 | euphrosyne
杰雷迈亚 | 杰里迈亚 | jeremiah
里奥赫 | 里奥克 | reoch
卡尔卡诺 | 卡尔卡尼奥 | calcagno
彼特里兹 | 佩特里迪斯 | petrides
科德尔 | 科德 | corder
戴文 | 达文 | davern
罗赞妮 | 罗珊 | rozanne
洛格 | 洛奇 | lorge
格林肖 | 格里诺 | greenhow
格利莫尔 | 格利穆尔 | glymour
埃利娜 | 埃琳娜 | elena
杜尤 | 杜韦 | duwe
布雷德 | 布里德 | breder
萨韦尔 | 萨维尔 | savelle
麦加恩 | 麦加亨 | mcgahern
勒班 | 莱班 | leban
穆拉尔特 | 缪拉尔持 | muralt
萨洛姆 | 萨洛米 | salome
玛丽萨 | 马里萨 | marisa
尤吉尼亚 | 尤金妮亚 | eugenia
梅德瓦多斯基 | 梅德瓦多夫斯基 | medwadowski
希厄特 | 海厄特 | hieatt
惠奇利夫 | 惠特克利夫 | whitchliffe
怀森 | 威森 | wison
德赫特 | 德克特 | dechert
奥利夫 | 奥利芙 | olive
德夫尼 | 迪夫尼 | deveney
厄彻博尔德 | 厄奇博尔德 | erchebald
海姆索特 | 海姆塞特 | heimsoth
弗德里 | 维德里 | verdery
希伯德 | 希巴德 | hibbard
盖斯特菲尔德 | 盖斯特费尔德 | geistfeld
塔利亚费罗 | 托利弗 | taliaferro
埃道斯 | 埃多斯 | eddowes
埃博罗尔 | 埃博拉尔 | eborall
莱塞特 | 莱西特 | lycett
莱根 | 利根 | lygon
奥历克西 | 奥莱克休 | oleksiw
阿莱兹 | 阿莱 | allez
卡德瓦拉杰 | 卡德瓦拉德 | cadwaladyr
赖德尔 | 里迪尔 | rideal
苏尔温 | 西尔温 | sulwen
汉利 | 汉布利 | hambley
坦克蕾托 | 坦克雷托 | tancreto
法迪安 | 法迪恩 | fadyean
伯克隆 | 伯克伦 | berklund
德雷南 | 德雷宁 | drennen
德彻 | 德谢尔 | decher
特鲁齐 | 特拉齐 | truzzi
阿布迪安 | 阿布迪恩 | abdian
蒙特莫伦诺 | 蒙特莫雷诺 | montemoreno
托里 | 托丽 | tori
卡里洛 | 卡里略 | carrillo
比比 | 毕比 | beeby
马西纳 | 马塞纳 | marthena
盖尼森 | 吉尼森 | genesen
凯莉 | 卡利 | cali
盖滕拜因 | 盖滕宾 | gaitenbein
